"year","state","county","D","O","R","total"
"2000","ALABAMA","AUTAUGA",4942,273,11993,17208
"2000","ALABAMA","BALDWIN",13997,1611,40872,56480
"2000","ALABAMA","BARBOUR",5188,111,5096,10395
"2000","ALABAMA","BIBB",2710,118,4273,7101
"2000","ALABAMA","BLOUNT",4977,329,12667,17973
"2000","ALABAMA","BULLOCK",3395,76,1433,4904
"2000","ALABAMA","BUTLER",3606,70,4127,7803
"2000","ALABAMA","CALHOUN",15781,822,22306,38909
"2000","ALABAMA","CHAMBERS",5616,181,6037,11834
"2000","ALABAMA","CHEROKEE",3497,172,4154,7823
"2000","ALABAMA","CHILTON",4806,220,10066,15092
"2000","ALABAMA","CHOCTAW",3707,67,3600,7374
"2000","ALABAMA","CLARKE",4679,85,5988,10752
"2000","ALABAMA","CLAY",2045,119,3719,5883
"2000","ALABAMA","CLEBURNE",1664,95,3333,5092
"2000","ALABAMA","COFFEE",5220,276,9938,15434
"2000","ALABAMA","COLBERT",10543,471,10518,21532
"2000","ALABAMA","CONECUH",2783,69,2699,5551
"2000","ALABAMA","COOSA",2104,81,2382,4567
"2000","ALABAMA","COVINGTON",4440,212,8961,13613
"2000","ALABAMA","CRENSHAW",1934,68,2793,4795
"2000","ALABAMA","CULLMAN",9758,610,19157,29525
"2000","ALABAMA","DALE",4906,307,10593,15806
"2000","ALABAMA","DALLAS",10967,137,7360,18464
"2000","ALABAMA","DEKALB",7056,402,12827,20285
"2000","ALABAMA","ELMORE",6652,375,16777,23804
"2000","ALABAMA","ESCAMBIA",4523,162,6975,11660
"2000","ALABAMA","ETOWAH",17433,828,21087,39348
"2000","ALABAMA","FAYETTE",3064,162,4582,7808
"2000","ALABAMA","FRANKLIN",4793,191,6119,11103
"2000","ALABAMA","GENEVA",2769,202,6588,9559
"2000","ALABAMA","GREENE",3504,42,850,4396
"2000","ALABAMA","HALE",4652,95,2984,7731
"2000","ALABAMA","HENRY",2782,96,4054,6932
"2000","ALABAMA","HOUSTON",9412,495,22150,32057
"2000","ALABAMA","JACKSON",9066,365,8475,17906
"2000","ALABAMA","JEFFERSON",129889,5383,138491,273763
"2000","ALABAMA","LAMAR",2653,126,4470,7249
"2000","ALABAMA","LAUDERDALE",13875,784,17478,32137
"2000","ALABAMA","LAWRENCE",6296,218,5671,12185
"2000","ALABAMA","LEE",14574,1257,22433,38264
"2000","ALABAMA","LIMESTONE",8992,438,14204,23634
"2000","ALABAMA","LOWNDES",4557,48,1638,6243
"2000","ALABAMA","MACON",7665,75,1091,8831
"2000","ALABAMA","MADISON",48199,2968,62151,113318
"2000","ALABAMA","MARENGO",4841,77,4690,9608
"2000","ALABAMA","MARION",4600,246,6910,11756
"2000","ALABAMA","MARSHALL",10381,524,17084,27989
"2000","ALABAMA","MOBILE",58640,2943,78162,139745
"2000","ALABAMA","MONROE",3741,57,5153,8951
"2000","ALABAMA","MONTGOMERY",40371,1130,38827,80328
"2000","ALABAMA","MORGAN",16060,847,25774,42681
"2000","ALABAMA","PERRY",4020,35,1732,5787
"2000","ALABAMA","PICKENS",4143,91,4306,8540
"2000","ALABAMA","PIKE",4357,129,6058,10544
"2000","ALABAMA","RANDOLPH",3094,159,4666,7919
"2000","ALABAMA","RUSSELL",8396,181,6198,14775
"2000","ALABAMA","SHELBY",13183,1294,47651,62128
"2000","ALABAMA","ST. CLAIR",6485,488,17117,24090
"2000","ALABAMA","SUMTER",4415,44,1629,6088
"2000","ALABAMA","TALLADEGA",11264,380,13807,25451
"2000","ALABAMA","TALLAPOOSA",6183,265,9805,16253
"2000","ALABAMA","TUSCALOOSA",24614,1497,34003,60114
"2000","ALABAMA","WALKER",11621,534,13486,25641
"2000","ALABAMA","WASHINGTON",3386,93,4117,7596
"2000","ALABAMA","WILCOX",3444,21,1661,5126
"2000","ALABAMA","WINSTON",2692,213,6413,9318
"2000","ALASKA","DISTRICT 1",1284,691,4681,6656
"2000","ALASKA","DISTRICT 10",2194,1017,5673,8884
"2000","ALASKA","DISTRICT 11",2043,977,3960,6980
"2000","ALASKA","DISTRICT 12",2051,924,4626,7601
"2000","ALASKA","DISTRICT 13",2661,1429,3853,7943
"2000","ALASKA","DISTRICT 14",1626,492,3750,5868
"2000","ALASKA","DISTRICT 15",2106,1311,2453,5870
"2000","ALASKA","DISTRICT 16",1969,736,1980,4685
"2000","ALASKA","DISTRICT 17",2230,910,4564,7704
"2000","ALASKA","DISTRICT 18",2739,1722,5421,9882
"2000","ALASKA","DISTRICT 19",2350,982,4619,7951
"2000","ALASKA","DISTRICT 2",2081,1072,4235,7388
"2000","ALASKA","DISTRICT 20",2259,1056,3648,6963
"2000","ALASKA","DISTRICT 21",2309,1057,3263,6629
"2000","ALASKA","DISTRICT 22",2656,959,4910,8525
"2000","ALASKA","DISTRICT 23",1282,387,2961,4630
"2000","ALASKA","DISTRICT 24",1985,867,5063,7915
"2000","ALASKA","DISTRICT 25",1697,1015,5489,8201
"2000","ALASKA","DISTRICT 26",1608,1113,5869,8590
"2000","ALASKA","DISTRICT 27",2199,1525,6714,10438
"2000","ALASKA","DISTRICT 28",2116,1811,7113,11040
"2000","ALASKA","DISTRICT 29",2806,1963,4054,8823
"2000","ALASKA","DISTRICT 3",3693,1397,3135,8225
"2000","ALASKA","DISTRICT 30",1698,763,3622,6083
"2000","ALASKA","DISTRICT 31",1831,808,3326,5965
"2000","ALASKA","DISTRICT 32",1389,466,4178,6033
"2000","ALASKA","DISTRICT 33",1765,1143,5804,8712
"2000","ALASKA","DISTRICT 34",1300,611,5243,7154
"2000","ALASKA","DISTRICT 35",1208,896,4278,6382
"2000","ALASKA","DISTRICT 36",1945,625,3007,5577
"2000","ALASKA","DISTRICT 37",1821,482,2725,5028
"2000","ALASKA","DISTRICT 38",2015,494,2467,4976
"2000","ALASKA","DISTRICT 39",2282,585,2321,5188
"2000","ALASKA","DISTRICT 4",2715,981,4127,7823
"2000","ALASKA","DISTRICT 40",1024,371,1831,3226
"2000","ALASKA","DISTRICT 5",1931,961,3545,6437
"2000","ALASKA","DISTRICT 6",1542,696,3862,6100
"2000","ALASKA","DISTRICT 7",1893,1916,4868,8677
"2000","ALASKA","DISTRICT 8",1498,1109,5371,7978
"2000","ALASKA","DISTRICT 9",1203,808,4789,6800
"2000","ALASKA","DISTRICT 99",0,0,0,0
"2000","ARIZONA","APACHE",13025,484,5947,19456
"2000","ARIZONA","COCHISE",13360,1701,18180,33241
"2000","ARIZONA","COCONINO",20280,3041,17562,40883
"2000","ARIZONA","GILA",7700,878,9158,17736
"2000","ARIZONA","GRAHAM",3355,302,6007,9664
"2000","ARIZONA","GREENLEE",1216,125,1619,2960
"2000","ARIZONA","LA PAZ",1769,171,2543,4483
"2000","ARIZONA","MARICOPA",386683,35049,479967,901699
"2000","ARIZONA","MOHAVE",17470,2285,24386,44141
"2000","ARIZONA","NAVAJO",11794,967,12386,25147
"2000","ARIZONA","PIMA",147688,15373,124579,287640
"2000","ARIZONA","PINAL",19650,1518,20122,41290
"2000","ARIZONA","SANTA CRUZ",5233,316,3344,8893
"2000","ARIZONA","YAVAPAI",24063,4021,40144,68228
"2000","ARIZONA","YUMA",12055,889,15708,28652
"2000","ARKANSAS","ARKANSAS",2877,142,3353,6372
"2000","ARKANSAS","ASHLEY",4253,142,3876,8271
"2000","ARKANSAS","BAXTER",6516,654,9538,16708
"2000","ARKANSAS","BENTON",17277,1531,34838,53646
"2000","ARKANSAS","BOONE",4493,573,8569,13635
"2000","ARKANSAS","BRADLEY",2122,64,1793,3979
"2000","ARKANSAS","CALHOUN",1017,40,1128,2185
"2000","ARKANSAS","CARROLL",3595,439,5556,9590
"2000","ARKANSAS","CHICOT",2820,68,1564,4452
"2000","ARKANSAS","CLARK",4661,189,3776,8626
"2000","ARKANSAS","CLAY",3527,119,2254,5900
"2000","ARKANSAS","CLEBURNE",4120,357,5730,10207
"2000","ARKANSAS","CLEVELAND",1414,89,1678,3181
"2000","ARKANSAS","COLUMBIA",4003,286,5018,9307
"2000","ARKANSAS","CONWAY",3496,193,3545,7234
"2000","ARKANSAS","CRAIGHEAD",12376,623,12158,25157
"2000","ARKANSAS","CRAWFORD",6288,533,10804,17625
"2000","ARKANSAS","CRITTENDEN",7224,153,5857,13234
"2000","ARKANSAS","CROSS",3096,86,3033,6215
"2000","ARKANSAS","DALLAS",1710,44,1571,3325
"2000","ARKANSAS","DESHA",2776,116,1603,4495
"2000","ARKANSAS","DREW",3060,106,2756,5922
"2000","ARKANSAS","FAULKNER",11950,1211,16055,29216
"2000","ARKANSAS","FRANKLIN",2674,189,3277,6140
"2000","ARKANSAS","FULTON",1976,96,2036,4108
"2000","ARKANSAS","GARLAND",15840,997,19098,35935
"2000","ARKANSAS","GRANT",2535,193,3285,6013
"2000","ARKANSAS","GREENE",6319,334,5831,12484
"2000","ARKANSAS","HEMPSTEAD",3937,95,3257,7289
"2000","ARKANSAS","HOT SPRING",5527,412,5042,10981
"2000","ARKANSAS","HOWARD",2063,70,2326,4459
"2000","ARKANSAS","INDEPENDENCE",5146,303,6145,11594
"2000","ARKANSAS","IZARD",2587,144,2301,5032
"2000","ARKANSAS","JACKSON",3651,141,2280,6072
"2000","ARKANSAS","JEFFERSON",17716,720,8765,27201
"2000","ARKANSAS","JOHNSON",3270,234,3657,7161
"2000","ARKANSAS","LAFAYETTE",1806,39,1538,3383
"2000","ARKANSAS","LAWRENCE",3255,159,2626,6040
"2000","ARKANSAS","LEE",2727,43,1351,4121
"2000","ARKANSAS","LINCOLN",1957,63,1526,3546
"2000","ARKANSAS","LITTLE RIVER",2883,97,2283,5263
"2000","ARKANSAS","LOGAN",3283,326,4487,8096
"2000","ARKANSAS","LONOKE",6851,486,10606,17943
"2000","ARKANSAS","MADISON",2055,186,3387,5628
"2000","ARKANSAS","MARION",2233,380,3402,6015
"2000","ARKANSAS","MILLER",6278,191,7276,13745
"2000","ARKANSAS","MISSISSIPPI",7107,280,5199,12586
"2000","ARKANSAS","MONROE",1910,54,1329,3293
"2000","ARKANSAS","MONTGOMERY",1438,173,2128,3739
"2000","ARKANSAS","NEVADA",1867,75,1796,3738
"2000","ARKANSAS","NEWTON",1205,193,2529,3927
"2000","ARKANSAS","OUACHITA",5464,192,4739,10395
"2000","ARKANSAS","PERRY",1648,245,2114,4007
"2000","ARKANSAS","PHILLIPS",6018,141,3154,9313
"2000","ARKANSAS","PIKE",1604,92,2275,3971
"2000","ARKANSAS","POINSETT",4102,145,2988,7235
"2000","ARKANSAS","POLK",2315,278,4600,7193
"2000","ARKANSAS","POPE",6669,509,11244,18422
"2000","ARKANSAS","PRAIRIE",1563,82,1862,3507
"2000","ARKANSAS","PULASKI",68320,2965,55866,127151
"2000","ARKANSAS","RANDOLPH",3019,185,2673,5877
"2000","ARKANSAS","SALINE",12700,1074,18617,32391
"2000","ARKANSAS","SCOTT",1444,138,2399,3981
"2000","ARKANSAS","SEARCY",1229,219,2610,4058
"2000","ARKANSAS","SEBASTIAN",15555,1121,23483,40159
"2000","ARKANSAS","SEVIER",2095,87,2111,4293
"2000","ARKANSAS","SHARP",3236,192,3698,7126
"2000","ARKANSAS","ST. FRANCIS",4986,96,3414,8496
"2000","ARKANSAS","STONE",2043,194,2623,4860
"2000","ARKANSAS","UNION",6261,701,8647,15609
"2000","ARKANSAS","VAN BUREN",3202,297,3485,6984
"2000","ARKANSAS","WASHINGTON",21425,1803,28231,51459
"2000","ARKANSAS","WHITE",8342,638,13170,22150
"2000","ARKANSAS","WOODRUFF",1699,54,898,2651
"2000","ARKANSAS","YELL",3062,194,3223,6479
"2000","CALIFORNIA","ALAMEDA",342889,32168,119279,494336
"2000","CALIFORNIA","ALPINE",265,40,281,586
"2000","CALIFORNIA","AMADOR",5906,792,8766,15464
"2000","CALIFORNIA","BUTTE",31338,6799,45584,83721
"2000","CALIFORNIA","CALAVERAS",7093,1184,10599,18876
"2000","CALIFORNIA","COLUSA",1745,216,3629,5590
"2000","CALIFORNIA","CONTRA COSTA",224338,15767,141373,381478
"2000","CALIFORNIA","DEL NORTE",3117,651,4526,8294
"2000","CALIFORNIA","EL DORADO",26220,3871,42045,72136
"2000","CALIFORNIA","FRESNO",95059,8434,117342,220835
"2000","CALIFORNIA","GLENN",2498,418,5795,8711
"2000","CALIFORNIA","HUMBOLDT",24851,7902,23219,55972
"2000","CALIFORNIA","IMPERIAL",15489,924,12524,28937
"2000","CALIFORNIA","INYO",2652,450,4713,7815
"2000","CALIFORNIA","KERN",66003,5642,110663,182308
"2000","CALIFORNIA","KINGS",11041,917,16377,28335
"2000","CALIFORNIA","LAKE",10717,1503,8699,20919
"2000","CALIFORNIA","LASSEN",2982,524,7080,10586
"2000","CALIFORNIA","LOS ANGELES",1710505,112719,871930,2695154
"2000","CALIFORNIA","MADERA",11650,1462,20283,33395
"2000","CALIFORNIA","MARIN",79135,9148,34872,123155
"2000","CALIFORNIA","MARIPOSA",2816,531,4727,8074
"2000","CALIFORNIA","MENDOCINO",16634,5504,12272,34410
"2000","CALIFORNIA","MERCED",22726,1590,26102,50418
"2000","CALIFORNIA","MODOC",945,193,2969,4107
"2000","CALIFORNIA","MONO",1788,287,2296,4371
"2000","CALIFORNIA","MONTEREY",67618,6155,43761,117534
"2000","CALIFORNIA","NAPA",28097,2994,20633,51724
"2000","CALIFORNIA","NEVADA",17670,3811,25998,47479
"2000","CALIFORNIA","ORANGE",391819,37787,541299,970905
"2000","CALIFORNIA","PLACER",42449,5515,69835,117799
"2000","CALIFORNIA","PLUMAS",3458,600,6343,10401
"2000","CALIFORNIA","RIVERSIDE",202576,16596,231955,451127
"2000","CALIFORNIA","SACRAMENTO",212792,23139,195619,431550
"2000","CALIFORNIA","SAN BENITO",9131,685,7015,16831
"2000","CALIFORNIA","SAN BERNARDINO",214749,18387,221757,454893
"2000","CALIFORNIA","SAN DIEGO",437666,45232,475736,958634
"2000","CALIFORNIA","SAN FRANCISCO",241578,26712,51496,319786
"2000","CALIFORNIA","SAN JOAQUIN",79776,5690,81773,167239
"2000","CALIFORNIA","SAN LUIS OBISPO",44526,7501,56859,108886
"2000","CALIFORNIA","SAN MATEO",166757,12346,80296,259399
"2000","CALIFORNIA","SANTA BARBARA",73411,10070,71493,154974
"2000","CALIFORNIA","SANTA CLARA",332490,26889,188750,548129
"2000","CALIFORNIA","SANTA CRUZ",66618,12105,29627,108350
"2000","CALIFORNIA","SHASTA",20127,3139,43278,66544
"2000","CALIFORNIA","SIERRA",540,135,1172,1847
"2000","CALIFORNIA","SISKIYOU",6323,1298,12198,19819
"2000","CALIFORNIA","SOLANO",75116,5015,51604,131735
"2000","CALIFORNIA","SONOMA",117295,16182,63529,197006
"2000","CALIFORNIA","STANISLAUS",56448,4631,67188,128267
"2000","CALIFORNIA","SUTTER",8416,798,17350,26564
"2000","CALIFORNIA","TEHAMA",6507,1077,13270,20854
"2000","CALIFORNIA","TRINITY",1932,525,3340,5797
"2000","CALIFORNIA","TULARE",33006,2742,54070,89818
"2000","CALIFORNIA","TUOLUMNE",9359,1196,13172,23727
"2000","CALIFORNIA","VENTURA",133258,13261,136173,282692
"2000","CALIFORNIA","YOLO",33747,4632,23057,61436
"2000","CALIFORNIA","YUBA",5546,743,9838,16127
"2000","COLORADO","ADAMS",54132,6159,47561,107852
"2000","COLORADO","ALAMOSA",2455,347,2857,5659
"2000","COLORADO","ARAPAHOE",82614,9560,97768,189942
"2000","COLORADO","ARCHULETA",1432,338,2988,4758
"2000","COLORADO","BACA",531,84,1663,2278
"2000","COLORADO","BENT",783,84,1096,1963
"2000","COLORADO","BOULDER",69983,18770,50873,139626
"2000","COLORADO","CHAFFEE",2768,542,4300,7610
"2000","COLORADO","CHEYENNE",209,46,957,1212
"2000","COLORADO","CLEAR CREEK",2188,489,2247,4924
"2000","COLORADO","CONEJOS",1749,150,1772,3671
"2000","COLORADO","COSTILLA",1054,90,504,1648
"2000","COLORADO","CROWLEY",511,79,855,1445
"2000","COLORADO","CUSTER",507,153,1451,2111
"2000","COLORADO","DELTA",3264,1050,8372,12686
"2000","COLORADO","DENVER",122693,14430,61224,198347
"2000","COLORADO","DOLORES",293,100,741,1134
"2000","COLORADO","DOUGLAS",27076,3142,56007,86225
"2000","COLORADO","EAGLE",6772,1251,7165,15188
"2000","COLORADO","EL PASO",61799,10664,128294,200757
"2000","COLORADO","ELBERT",2326,488,6151,8965
"2000","COLORADO","FREMONT",5293,849,9914,16056
"2000","COLORADO","GARFIELD",6087,1914,9103,17104
"2000","COLORADO","GILPIN",1099,360,1006,2465
"2000","COLORADO","GRAND",2308,475,3570,6353
"2000","COLORADO","GUNNISON",3059,1049,3128,7236
"2000","COLORADO","HINSDALE",188,62,316,566
"2000","COLORADO","HUERFANO",1495,213,1466,3174
"2000","COLORADO","JACKSON",173,70,682,925
"2000","COLORADO","JEFFERSON",100970,14383,120138,235491
"2000","COLORADO","KIOWA",211,29,728,968
"2000","COLORADO","KIT CARSON",809,107,2542,3458
"2000","COLORADO","LA PLATA",7864,2633,9993,20490
"2000","COLORADO","LAKE",1296,276,1056,2628
"2000","COLORADO","LARIMER",46055,10053,62429,118537
"2000","COLORADO","LAS ANIMAS",3243,282,2569,6094
"2000","COLORADO","LINCOLN",510,59,1630,2199
"2000","COLORADO","LOGAN",2296,269,5531,8096
"2000","COLORADO","MESA",15465,3193,32396,51054
"2000","COLORADO","MINERAL",168,24,294,486
"2000","COLORADO","MOFFAT",1223,274,3840,5337
"2000","COLORADO","MONTEZUMA",2556,670,6158,9384
"2000","COLORADO","MONTROSE",4041,908,9266,14215
"2000","COLORADO","MORGAN",2885,391,5722,8998
"2000","COLORADO","OTERO",2963,267,4082,7312
"2000","COLORADO","OURAY",705,249,1279,2233
"2000","COLORADO","PARK",2393,595,3677,6665
"2000","COLORADO","PHILLIPS",564,83,1573,2220
"2000","COLORADO","PITKIN",4137,1098,2565,7800
"2000","COLORADO","PROWERS",1361,137,3026,4524
"2000","COLORADO","PUEBLO",28888,2231,22827,53946
"2000","COLORADO","RIO BLANCO",543,127,2185,2855
"2000","COLORADO","RIO GRANDE",1707,257,3111,5075
"2000","COLORADO","ROUTT",4208,958,4472,9638
"2000","COLORADO","SAGUACHE",1145,306,1078,2529
"2000","COLORADO","SAN JUAN",149,77,210,436
"2000","COLORADO","SAN MIGUEL",1598,614,1043,3255
"2000","COLORADO","SEDGWICK",384,42,877,1303
"2000","COLORADO","SUMMIT",5304,1267,4497,11068
"2000","COLORADO","TELLER",2750,620,6477,9847
"2000","COLORADO","WASHINGTON",477,90,1878,2445
"2000","COLORADO","WELD",23436,3696,37409,64541
"2000","COLORADO","YUMA",1082,120,3156,4358
"2000","CONNECTICUT","FAIRFIELD",193769,16861,159659,370289
"2000","CONNECTICUT","HARTFORD",221167,18921,127468,367556
"2000","CONNECTICUT","LITCHFIELD",41806,6360,39172,87338
"2000","CONNECTICUT","MIDDLESEX",43319,4819,29295,77433
"2000","CONNECTICUT","NEW HAVEN",197928,20252,122919,341099
"2000","CONNECTICUT","NEW LONDON",60449,7530,41168,109147
"2000","CONNECTICUT","STATEWIDE WRITEIN",0,0,0,0
"2000","CONNECTICUT","TOLLAND",33554,4441,24705,62700
"2000","CONNECTICUT","WINDHAM",24023,3232,16708,43963
"2000","DELAWARE","KENT",22790,1376,24081,48247
"2000","DELAWARE","NEW CASTLE",127539,6869,78587,212995
"2000","DELAWARE","SUSSEX",29739,1928,34620,66287
"2000","DISTRICT OF COLUMBIA","DISTRICT OF COLUMBIA",171923,11898,18073,201894
"2000","FLORIDA","ALACHUA",47365,4240,34124,85729
"2000","FLORIDA","BAKER",2392,152,5610,8154
"2000","FLORIDA","BAY",18850,1318,38637,58805
"2000","FLORIDA","BRADFORD",3075,184,5414,8673
"2000","FLORIDA","BREVARD",97318,5892,115185,218395
"2000","FLORIDA","BROWARD",387703,9538,177902,575143
"2000","FLORIDA","CALHOUN",2155,146,2873,5174
"2000","FLORIDA","CHARLOTTE",29645,1825,35426,66896
"2000","FLORIDA","CITRUS",25525,1914,29767,57206
"2000","FLORIDA","CLAY",14632,985,41736,57353
"2000","FLORIDA","COLLIER",29921,1791,60450,92162
"2000","FLORIDA","COLUMBIA",7047,497,10964,18508
"2000","FLORIDA","DESOTO",3320,241,4256,7817
"2000","FLORIDA","DIXIE",1826,143,2697,4666
"2000","FLORIDA","DUVAL",107864,4674,152098,264636
"2000","FLORIDA","ESCAMBIA",40943,2688,73017,116648
"2000","FLORIDA","FLAGLER",13897,601,12613,27111
"2000","FLORIDA","FRANKLIN",2046,144,2454,4644
"2000","FLORIDA","GADSDEN",9735,225,4767,14727
"2000","FLORIDA","GILCHRIST",1910,185,3300,5395
"2000","FLORIDA","GLADES",1442,82,1841,3365
"2000","FLORIDA","GULF",2397,197,3550,6144
"2000","FLORIDA","HAMILTON",1722,96,2146,3964
"2000","FLORIDA","HARDEE",2339,129,3765,6233
"2000","FLORIDA","HENDRY",3240,152,4747,8139
"2000","FLORIDA","HERNANDO",32644,1929,30646,65219
"2000","FLORIDA","HIGHLANDS",14167,776,20206,35149
"2000","FLORIDA","HILLSBOROUGH",169557,9978,180760,360295
"2000","FLORIDA","HOLMES",2177,207,5011,7395
"2000","FLORIDA","INDIAN RIVER",19768,1219,28635,49622
"2000","FLORIDA","JACKSON",6868,294,9138,16300
"2000","FLORIDA","JEFFERSON",3041,125,2478,5644
"2000","FLORIDA","LAFAYETTE",789,46,1670,2505
"2000","FLORIDA","LAKE",36571,2030,50010,88611
"2000","FLORIDA","LEE",73560,4676,106141,184377
"2000","FLORIDA","LEON",61427,2635,39062,103124
"2000","FLORIDA","LEVY",5398,468,6858,12724
"2000","FLORIDA","LIBERTY",1017,76,1317,2410
"2000","FLORIDA","MADISON",3014,110,3038,6162
"2000","FLORIDA","MANATEE",49177,3092,57952,110221
"2000","FLORIDA","MARION",44665,3150,55141,102956
"2000","FLORIDA","MARTIN",26620,1423,33970,62013
"2000","FLORIDA","MIAMI-DADE",328808,7108,289533,625449
"2000","FLORIDA","MONROE",16483,1354,16059,33896
"2000","FLORIDA","NASSAU",6952,424,16404,23780
"2000","FLORIDA","OKALOOSA",16948,1639,52093,70680
"2000","FLORIDA","OKEECHOBEE",4588,208,5057,9853
"2000","FLORIDA","ORANGE",140220,5388,134517,280125
"2000","FLORIDA","OSCEOLA",28181,1266,26212,55659
"2000","FLORIDA","PALM BEACH",269732,10503,152951,433186
"2000","FLORIDA","PASCO",69564,4585,68582,142731
"2000","FLORIDA","PINELLAS",200630,13017,184825,398472
"2000","FLORIDA","POLK",75200,3112,90295,168607
"2000","FLORIDA","PUTNAM",12102,673,13447,26222
"2000","FLORIDA","SANTA ROSA",12802,1243,36274,50319
"2000","FLORIDA","SARASOTA",72853,4989,83100,160942
"2000","FLORIDA","SEMINOLE",59174,2783,75677,137634
"2000","FLORIDA","ST. JOHNS",19502,1698,39546,60746
"2000","FLORIDA","ST. LUCIE",41559,1725,34705,77989
"2000","FLORIDA","SUMTER",9637,497,12127,22261
"2000","FLORIDA","SUWANNEE",4075,392,8006,12473
"2000","FLORIDA","TAYLOR",2649,103,4056,6808
"2000","FLORIDA","UNION",1407,87,2332,3826
"2000","FLORIDA","VOLUSIA",97304,3993,82357,183654
"2000","FLORIDA","WAKULLA",3838,237,4512,8587
"2000","FLORIDA","WALTON",5642,494,12182,18318
"2000","FLORIDA","WASHINGTON",2798,237,4994,8029
"2000","GEORGIA","APPLING",2093,66,3940,6099
"2000","GEORGIA","ATKINSON",821,22,1228,2071
"2000","GEORGIA","BACON",956,29,2010,2995
"2000","GEORGIA","BAKER",893,11,615,1519
"2000","GEORGIA","BALDWIN",5893,192,6041,12126
"2000","GEORGIA","BANKS",1220,111,3202,4533
"2000","GEORGIA","BARROW",3657,520,7925,12102
"2000","GEORGIA","BARTOW",7508,553,14720,22781
"2000","GEORGIA","BEN HILL",2234,46,2381,4661
"2000","GEORGIA","BERRIEN",1640,52,2718,4410
"2000","GEORGIA","BIBB",24996,709,24071,49776
"2000","GEORGIA","BLECKLEY",1273,40,2436,3749
"2000","GEORGIA","BRANTLEY",1372,76,3118,4566
"2000","GEORGIA","BROOKS",2096,49,2406,4551
"2000","GEORGIA","BRYAN",2172,52,4835,7059
"2000","GEORGIA","BULLOCH",5561,231,8990,14782
"2000","GEORGIA","BURKE",3720,34,3381,7135
"2000","GEORGIA","BUTTS",2281,156,3198,5635
"2000","GEORGIA","CALHOUN",1107,12,768,1887
"2000","GEORGIA","CAMDEN",3636,112,6371,10119
"2000","GEORGIA","CANDLER",1053,26,1643,2722
"2000","GEORGIA","CARROLL",8752,663,16326,25741
"2000","GEORGIA","CATOOSA",5470,218,12033,17721
"2000","GEORGIA","CHARLTON",1015,31,1770,2816
"2000","GEORGIA","CHATHAM",37590,1038,37847,76475
"2000","GEORGIA","CHATTAHOOCHEE",600,17,590,1207
"2000","GEORGIA","CHATTOOGA",2729,108,3640,6477
"2000","GEORGIA","CHEROKEE",12295,2020,38033,52348
"2000","GEORGIA","CLARKE",15167,1887,11850,28904
"2000","GEORGIA","CLAY",821,8,448,1277
"2000","GEORGIA","CLAYTON",40042,1394,19966,61402
"2000","GEORGIA","CLINCH",816,22,1091,1929
"2000","GEORGIA","COBB",86676,7857,140494,235027
"2000","GEORGIA","COFFEE",3593,81,5756,9430
"2000","GEORGIA","COLQUITT",3297,86,6589,9972
"2000","GEORGIA","COLUMBIA",8969,379,26660,36008
"2000","GEORGIA","COOK",1639,26,2279,3944
"2000","GEORGIA","COWETA",9056,843,21327,31226
"2000","GEORGIA","CRAWFORD",1513,67,1987,3567
"2000","GEORGIA","CRISP",2268,56,3285,5609
"2000","GEORGIA","DADE",1628,88,3333,5049
"2000","GEORGIA","DAWSON",1458,230,4210,5898
"2000","GEORGIA","DECATUR",3398,63,4187,7648
"2000","GEORGIA","DEKALB",154509,6664,58807,219980
"2000","GEORGIA","DODGE",2326,79,3472,5877
"2000","GEORGIA","DOOLY",1901,31,1588,3520
"2000","GEORGIA","DOUGHERTY",16650,166,12248,29064
"2000","GEORGIA","DOUGLAS",11162,909,18893,30964
"2000","GEORGIA","EARLY",1622,25,1938,3585
"2000","GEORGIA","ECHOLS",272,12,614,898
"2000","GEORGIA","EFFINGHAM",3232,92,7326,10650
"2000","GEORGIA","ELBERT",2527,64,3262,5853
"2000","GEORGIA","EMANUEL",2835,85,3343,6263
"2000","GEORGIA","EVANS",1217,22,1841,3080
"2000","GEORGIA","FANNIN",2736,191,5463,8390
"2000","GEORGIA","FAYETTE",11912,1199,29338,42449
"2000","GEORGIA","FLOYD",10282,349,16194,26825
"2000","GEORGIA","FORSYTH",6694,1292,27769,35755
"2000","GEORGIA","FRANKLIN",2040,63,3659,5762
"2000","GEORGIA","FULTON",152039,6303,104870,263212
"2000","GEORGIA","GILMER",2230,199,4941,7370
"2000","GEORGIA","GLASCOCK",249,8,763,1020
"2000","GEORGIA","GLYNN",7778,260,14346,22384
"2000","GEORGIA","GORDON",4032,229,7944,12205
"2000","GEORGIA","GRADY",2721,88,3894,6703
"2000","GEORGIA","GREENE",2137,80,2980,5197
"2000","GEORGIA","GWINNETT",61434,7921,121756,191111
"2000","GEORGIA","HABERSHAM",2530,197,6964,9691
"2000","GEORGIA","HALL",10259,1050,26841,38150
"2000","GEORGIA","HANCOCK",2414,10,662,3086
"2000","GEORGIA","HARALSON",2869,145,5153,8167
"2000","GEORGIA","HARRIS",2912,96,5554,8562
"2000","GEORGIA","HART",3192,102,4242,7536
"2000","GEORGIA","HEARD",1178,73,1947,3198
"2000","GEORGIA","HENRY",11971,1081,25815,38867
"2000","GEORGIA","HOUSTON",13301,513,23174,36988
"2000","GEORGIA","IRWIN",1105,27,1720,2852
"2000","GEORGIA","JACKSON",3420,337,7878,11635
"2000","GEORGIA","JASPER",1558,87,2298,3943
"2000","GEORGIA","JEFF DAVIS",1379,45,2797,4221
"2000","GEORGIA","JEFFERSON",2973,34,2559,5566
"2000","GEORGIA","JENKINS",1250,26,1317,2593
"2000","GEORGIA","JOHNSON",1065,21,1797,2883
"2000","GEORGIA","JONES",3102,116,4850,8068
"2000","GEORGIA","LAMAR",2194,124,2912,5230
"2000","GEORGIA","LANIER",832,24,1048,1904
"2000","GEORGIA","LAURENS",5724,179,8133,14036
"2000","GEORGIA","LEE",1936,76,5872,7884
"2000","GEORGIA","LIBERTY",5347,170,4455,9972
"2000","GEORGIA","LINCOLN",1275,21,1807,3103
"2000","GEORGIA","LONG",975,19,1320,2314
"2000","GEORGIA","LOWNDES",10616,354,14462,25432
"2000","GEORGIA","LUMPKIN",2121,202,4427,6750
"2000","GEORGIA","MACON",2757,32,1566,4355
"2000","GEORGIA","MADISON",2285,179,5529,7993
"2000","GEORGIA","MARION",982,15,1187,2184
"2000","GEORGIA","MCDUFFIE",2580,44,3926,6550
"2000","GEORGIA","MCINTOSH",2047,24,1766,3837
"2000","GEORGIA","MERIWETHER",3441,106,3162,6709
"2000","GEORGIA","MILLER",783,18,1349,2150
"2000","GEORGIA","MITCHELL",2971,38,2790,5799
"2000","GEORGIA","MONROE",2839,141,4561,7541
"2000","GEORGIA","MONTGOMERY",1013,31,1465,2509
"2000","GEORGIA","MORGAN",2238,140,3524,5902
"2000","GEORGIA","MURRAY",2684,149,5539,8372
"2000","GEORGIA","MUSCOGEE",28193,491,23479,52163
"2000","GEORGIA","NEWTON",6703,545,11127,18375
"2000","GEORGIA","OCONEE",3184,373,7611,11168
"2000","GEORGIA","OGLETHORPE",1519,160,2706,4385
"2000","GEORGIA","PAULDING",6743,636,16881,24260
"2000","GEORGIA","PEACH",3540,72,3525,7137
"2000","GEORGIA","PICKENS",2489,224,5488,8201
"2000","GEORGIA","PIERCE",1300,33,3348,4681
"2000","GEORGIA","PIKE",1413,114,3358,4885
"2000","GEORGIA","POLK",4112,163,5841,10116
"2000","GEORGIA","PULASKI",1390,34,1922,3346
"2000","GEORGIA","PUTNAM",2612,91,3596,6299
"2000","GEORGIA","QUITMAN",542,14,348,904
"2000","GEORGIA","RABUN",1776,114,3451,5341
"2000","GEORGIA","RANDOLPH",1381,14,1174,2569
"2000","GEORGIA","RICHMOND",31413,640,25485,57538
"2000","GEORGIA","ROCKDALE",8295,914,15440,24649
"2000","GEORGIA","SCHLEY",460,10,706,1176
"2000","GEORGIA","SCREVEN",2233,25,2461,4719
"2000","GEORGIA","SEMINOLE",1313,27,1537,2877
"2000","GEORGIA","SPALDING",5831,289,9271,15391
"2000","GEORGIA","STEPHENS",2869,137,5370,8376
"2000","GEORGIA","STEWART",1267,12,675,1954
"2000","GEORGIA","SUMTER",4748,102,4847,9697
"2000","GEORGIA","TALBOT",1662,25,844,2531
"2000","GEORGIA","TALIAFERRO",556,5,271,832
"2000","GEORGIA","TATTNALL",1963,50,3597,5610
"2000","GEORGIA","TAYLOR",1340,28,1412,2780
"2000","GEORGIA","TELFAIR",1777,23,1693,3493
"2000","GEORGIA","TERRELL",1584,25,1504,3113
"2000","GEORGIA","THOMAS",4862,103,7093,12058
"2000","GEORGIA","TIFT",3547,103,6678,10328
"2000","GEORGIA","TOOMBS",2643,80,4487,7210
"2000","GEORGIA","TOWNS",1495,100,2902,4497
"2000","GEORGIA","TREUTLEN",879,22,1062,1963
"2000","GEORGIA","TROUP",6379,227,11198,17804
"2000","GEORGIA","TURNER",1169,29,1258,2456
"2000","GEORGIA","TWIGGS",1977,68,1570,3615
"2000","GEORGIA","UNION",2230,159,4567,6956
"2000","GEORGIA","UPSON",3158,105,5019,8282
"2000","GEORGIA","WALKER",6341,228,12326,18895
"2000","GEORGIA","WALTON",5484,633,12966,19083
"2000","GEORGIA","WARE",3480,49,6099,9628
"2000","GEORGIA","WARREN",1196,16,933,2145
"2000","GEORGIA","WASHINGTON",3476,53,3162,6691
"2000","GEORGIA","WAYNE",2736,49,5219,8004
"2000","GEORGIA","WEBSTER",541,9,359,909
"2000","GEORGIA","WHEELER",752,10,813,1575
"2000","GEORGIA","WHITE",2014,172,4857,7043
"2000","GEORGIA","WHITFIELD",7034,416,15852,23302
"2000","GEORGIA","WILCOX",962,22,1381,2365
"2000","GEORGIA","WILKES",1940,42,2044,4026
"2000","GEORGIA","WILKINSON",1884,56,1800,3740
"2000","GEORGIA","WORTH",2214,55,3792,6061
"2000","HAWAII","HAWAII",28670,5140,17050,50860
"2000","HAWAII","HONOLULU",139618,15062,101310,255990
"2000","HAWAII","KAUAI",13470,1720,6583,21773
"2000","HAWAII","MAUI",23484,2888,12876,39248
"2000","IDAHO","ADA",40650,7785,75050,123485
"2000","IDAHO","ADAMS",336,97,1476,1909
"2000","IDAHO","BANNOCK",10892,1737,18223,30852
"2000","IDAHO","BEAR LAKE",517,86,2296,2899
"2000","IDAHO","BENEWAH",895,186,2606,3687
"2000","IDAHO","BINGHAM",3310,527,10628,14465
"2000","IDAHO","BLAINE",3748,662,3528,7938
"2000","IDAHO","BOISE",745,291,2019,3055
"2000","IDAHO","BONNER",4318,1274,8945,14537
"2000","IDAHO","BONNEVILLE",7235,1333,24988,33556
"2000","IDAHO","BOUNDARY",832,255,2797,3884
"2000","IDAHO","BUTTE",354,52,1054,1460
"2000","IDAHO","CAMAS",113,35,359,507
"2000","IDAHO","CANYON",10588,1852,30560,43000
"2000","IDAHO","CARIBOU",475,101,2601,3177
"2000","IDAHO","CASSIA",1087,209,5983,7279
"2000","IDAHO","CLARK",63,8,311,382
"2000","IDAHO","CLEARWATER",841,170,2885,3896
"2000","IDAHO","CUSTER",416,120,1794,2330
"2000","IDAHO","ELMORE",1840,235,4891,6966
"2000","IDAHO","FRANKLIN",513,136,3594,4243
"2000","IDAHO","FREMONT",699,147,4242,5088
"2000","IDAHO","GEM",1346,261,4376,5983
"2000","IDAHO","GOODING",1282,242,3502,5026
"2000","IDAHO","IDAHO",1187,459,5806,7452
"2000","IDAHO","JEFFERSON",1100,256,6480,7836
"2000","IDAHO","JEROME",1360,229,4418,6007
"2000","IDAHO","KOOTENAI",13488,2162,28162,43812
"2000","IDAHO","LATAH",5661,1489,8161,15311
"2000","IDAHO","LEMHI",660,122,2859,3641
"2000","IDAHO","LEWIS",335,58,1295,1688
"2000","IDAHO","LINCOLN",437,88,1049,1574
"2000","IDAHO","MADISON",816,213,7941,8970
"2000","IDAHO","MINIDOKA",1344,267,4907,6518
"2000","IDAHO","NEZ PERCE",4995,449,10577,16021
"2000","IDAHO","ONEIDA",307,65,1426,1798
"2000","IDAHO","OWYHEE",623,115,2450,3188
"2000","IDAHO","PAYETTE",1643,254,4961,6858
"2000","IDAHO","POWER",755,82,1872,2709
"2000","IDAHO","SHOSHONE",2225,281,2879,5385
"2000","IDAHO","TETON",720,206,1745,2671
"2000","IDAHO","TWIN FALLS",5777,959,15794,22530
"2000","IDAHO","VALLEY",1129,301,2548,3978
"2000","IDAHO","WASHINGTON",980,191,2899,4070
"2000","ILLINOIS","ADAMS",12197,581,17331,30109
"2000","ILLINOIS","ALEXANDER",2357,77,1588,4022
"2000","ILLINOIS","BOND",3060,168,3804,7032
"2000","ILLINOIS","BOONE",6481,425,8617,15523
"2000","ILLINOIS","BROWN",1077,54,1529,2660
"2000","ILLINOIS","BUREAU",7754,543,8526,16823
"2000","ILLINOIS","CALHOUN",1310,63,1229,2602
"2000","ILLINOIS","CARROLL",3113,229,3835,7177
"2000","ILLINOIS","CASS",2789,142,2968,5899
"2000","ILLINOIS","CHAMPAIGN",35515,4125,34645,74285
"2000","ILLINOIS","CHRISTIAN",6799,435,7537,14771
"2000","ILLINOIS","CLARK",2932,182,4398,7512
"2000","ILLINOIS","CLAY",2212,134,3789,6135
"2000","ILLINOIS","CLINTON",6436,403,8588,15427
"2000","ILLINOIS","COLES",8904,694,10495,20093
"2000","ILLINOIS","COOK",1280547,50818,534542,1865907
"2000","ILLINOIS","CRAWFORD",3333,193,4974,8500
"2000","ILLINOIS","CUMBERLAND",1870,141,2964,4975
"2000","ILLINOIS","DE WITT",2870,213,3968,7051
"2000","ILLINOIS","DEKALB",14798,1296,17139,33233
"2000","ILLINOIS","DOUGLAS",3215,203,4734,8152
"2000","ILLINOIS","DUPAGE",152550,10775,201037,364362
"2000","ILLINOIS","EDGAR",3216,183,4833,8232
"2000","ILLINOIS","EDWARDS",978,70,2212,3260
"2000","ILLINOIS","EFFINGHAM",4225,405,9855,14485
"2000","ILLINOIS","FAYETTE",3886,252,5200,9338
"2000","ILLINOIS","FORD",2090,174,3889,6153
"2000","ILLINOIS","FRANKLIN",10201,521,8490,19212
"2000","ILLINOIS","FULTON",8940,401,6936,16277
"2000","ILLINOIS","GALLATIN",1878,89,1591,3558
"2000","ILLINOIS","GREENE",2490,148,3129,5767
"2000","ILLINOIS","GRUNDY",7516,359,8709,16584
"2000","ILLINOIS","HAMILTON",1943,125,2519,4587
"2000","ILLINOIS","HANCOCK",4256,301,5134,9691
"2000","ILLINOIS","HARDIN",1184,87,1366,2637
"2000","ILLINOIS","HENDERSON",2030,128,1708,3866
"2000","ILLINOIS","HENRY",11921,653,10896,23470
"2000","ILLINOIS","IROQUOIS",4397,342,8685,13424
"2000","ILLINOIS","JACKSON",11773,1494,9823,23090
"2000","ILLINOIS","JASPER",1815,87,3119,5021
"2000","ILLINOIS","JEFFERSON",6685,313,8362,15360
"2000","ILLINOIS","JERSEY",4355,359,4699,9413
"2000","ILLINOIS","JO DAVIESS",4585,433,5304,10322
"2000","ILLINOIS","JOHNSON",1928,149,3285,5362
"2000","ILLINOIS","KANE",60127,4282,76996,141405
"2000","ILLINOIS","KANKAKEE",19180,954,20049,40183
"2000","ILLINOIS","KENDALL",8444,637,13688,22769
"2000","ILLINOIS","KNOX",12572,690,9912,23174
"2000","ILLINOIS","LAKE",115058,6118,120988,242164
"2000","ILLINOIS","LASALLE",23355,1376,21276,46007
"2000","ILLINOIS","LAWRENCE",2822,162,3594,6578
"2000","ILLINOIS","LEE",6111,440,8069,14620
"2000","ILLINOIS","LIVINGSTON",5829,405,9187,15421
"2000","ILLINOIS","LOGAN",4600,324,8141,13065
"2000","ILLINOIS","MACON",24262,1407,23830,49499
"2000","ILLINOIS","MACOUPIN",11015,625,9749,21389
"2000","ILLINOIS","MADISON",59077,3206,48821,111104
"2000","ILLINOIS","MARION",8068,355,8240,16663
"2000","ILLINOIS","MARSHALL",2570,192,3145,5907
"2000","ILLINOIS","MASON",3192,169,3411,6772
"2000","ILLINOIS","MASSAC",2912,156,3676,6744
"2000","ILLINOIS","MCDONOUGH",6080,467,6465,13012
"2000","ILLINOIS","MCHENRY",40698,3375,62112,106185
"2000","ILLINOIS","MCLEAN",24936,1954,34008,60898
"2000","ILLINOIS","MENARD",2164,176,3862,6202
"2000","ILLINOIS","MERCER",4400,230,3688,8318
"2000","ILLINOIS","MONROE",5797,367,7632,13796
"2000","ILLINOIS","MONTGOMERY",6542,325,6226,13093
"2000","ILLINOIS","MORGAN",5899,377,8058,14334
"2000","ILLINOIS","MOULTRIE",2529,138,3058,5725
"2000","ILLINOIS","OGLE",7673,603,12325,20601
"2000","ILLINOIS","PEORIA",38604,1810,36398,76812
"2000","ILLINOIS","PERRY",4862,278,4802,9942
"2000","ILLINOIS","PIATT",3488,278,4619,8385
"2000","ILLINOIS","PIKE",3198,208,4706,8112
"2000","ILLINOIS","POPE",927,57,1346,2330
"2000","ILLINOIS","PULASKI",1518,68,1430,3016
"2000","ILLINOIS","PUTNAM",1657,85,1437,3179
"2000","ILLINOIS","RANDOLPH",6794,366,7127,14287
"2000","ILLINOIS","RICHLAND",2491,219,4718,7428
"2000","ILLINOIS","ROCK ISLAND",37957,1944,25194,65095
"2000","ILLINOIS","SALINE",5427,290,5933,11650
"2000","ILLINOIS","SANGAMON",38414,2697,50374,91485
"2000","ILLINOIS","SCHUYLER",1587,108,2077,3772
"2000","ILLINOIS","SCOTT",954,57,1458,2469
"2000","ILLINOIS","SHELBY",4018,294,5851,10163
"2000","ILLINOIS","ST. CLAIR",55961,2133,42299,100393
"2000","ILLINOIS","STARK",1211,84,1694,2989
"2000","ILLINOIS","STEPHENSON",8062,601,10715,19378
"2000","ILLINOIS","TAZEWELL",25379,1432,31537,58348
"2000","ILLINOIS","UNION",3982,281,4397,8660
"2000","ILLINOIS","VERMILION",15406,911,15783,32100
"2000","ILLINOIS","WABASH",1987,115,3406,5508
"2000","ILLINOIS","WARREN",3524,208,3899,7631
"2000","ILLINOIS","WASHINGTON",2638,147,4353,7138
"2000","ILLINOIS","WAYNE",2209,137,5347,7693
"2000","ILLINOIS","WHITE",2958,158,4521,7637
"2000","ILLINOIS","WHITESIDE",12886,699,11252,24837
"2000","ILLINOIS","WILL",90902,4940,95828,191670
"2000","ILLINOIS","WILLIAMSON",12192,735,14012,26939
"2000","ILLINOIS","WINNEBAGO",51981,3500,53816,109297
"2000","ILLINOIS","WOODFORD",5529,359,10905,16793
"2000","INDIANA","ADAMS",3775,260,8555,12590
"2000","INDIANA","ALLEN",41636,2258,70426,114320
"2000","INDIANA","BARTHOLOMEW",9015,554,16200,25769
"2000","INDIANA","BENTON",1328,105,2441,3874
"2000","INDIANA","BLACKFORD",2103,91,2699,4893
"2000","INDIANA","BOONE",4763,472,13161,18396
"2000","INDIANA","BROWN",2608,338,3871,6817
"2000","INDIANA","CARROLL",2965,201,5102,8268
"2000","INDIANA","CASS",5412,389,9305,15106
"2000","INDIANA","CLARK",17360,559,19417,37336
"2000","INDIANA","CLAY",3605,160,6393,10158
"2000","INDIANA","CLINTON",3643,207,7141,10991
"2000","INDIANA","CRAWFORD",1817,65,2327,4209
"2000","INDIANA","DAVIESS",2697,192,6872,9761
"2000","INDIANA","DEARBORN",6020,178,11452,17650
"2000","INDIANA","DECATUR",2889,167,6115,9171
"2000","INDIANA","DEKALB",4776,308,8701,13785
"2000","INDIANA","DELAWARE",20876,1166,22105,44147
"2000","INDIANA","DUBOIS",5090,280,10134,15504
"2000","INDIANA","ELKHART",16402,1324,36756,54482
"2000","INDIANA","FAYETTE",3415,172,5060,8647
"2000","INDIANA","FLOYD",13209,335,16486,30030
"2000","INDIANA","FOUNTAIN",2717,156,4408,7281
"2000","INDIANA","FRANKLIN",2591,161,5587,8339
"2000","INDIANA","FULTON",2960,149,5218,8327
"2000","INDIANA","GIBSON",5802,236,7734,13772
"2000","INDIANA","GRANT",9712,521,16153,26386
"2000","INDIANA","GREENE",4898,269,7452,12619
"2000","INDIANA","HAMILTON",18002,1552,56372,75926
"2000","INDIANA","HANCOCK",6503,504,15943,22950
"2000","INDIANA","HARRISON",5870,315,8711,14896
"2000","INDIANA","HENDRICKS",10786,784,28651,40221
"2000","INDIANA","HENRY",7647,347,10321,18315
"2000","INDIANA","HOWARD",12899,865,20331,34095
"2000","INDIANA","HUNTINGTON",4119,388,10113,14620
"2000","INDIANA","JACKSON",5330,218,9054,14602
"2000","INDIANA","JASPER",3744,211,7212,11167
"2000","INDIANA","JAY",3167,176,4687,8030
"2000","INDIANA","JEFFERSON",5117,232,6582,11931
"2000","INDIANA","JENNINGS",3549,213,5732,9494
"2000","INDIANA","JOHNSON",11952,928,29404,42284
"2000","INDIANA","KNOX",6300,269,8485,15054
"2000","INDIANA","KOSCIUSKO",5785,459,19040,25284
"2000","INDIANA","LAGRANGE",2733,163,5437,8333
"2000","INDIANA","LAKE",109078,3527,63389,175994
"2000","INDIANA","LAPORTE",19736,1017,18994,39747
"2000","INDIANA","LAWRENCE",5071,394,10677,16142
"2000","INDIANA","MADISON",23403,857,27956,52216
"2000","INDIANA","MARION",134189,7904,137810,279903
"2000","INDIANA","MARSHALL",5541,343,10266,16150
"2000","INDIANA","MARTIN",1518,83,3008,4609
"2000","INDIANA","MIAMI",4155,372,8401,12928
"2000","INDIANA","MONROE",17523,3550,19147,40220
"2000","INDIANA","MONTGOMERY",3899,311,8891,13101
"2000","INDIANA","MORGAN",6228,522,15286,22036
"2000","INDIANA","NEWTON",2101,159,3250,5510
"2000","INDIANA","NOBLE",4822,291,9103,14216
"2000","INDIANA","OHIO",951,26,1515,2492
"2000","INDIANA","ORANGE",2601,170,4687,7458
"2000","INDIANA","OWEN",2253,231,4019,6503
"2000","INDIANA","PARKE",2481,125,3841,6447
"2000","INDIANA","PERRY",3823,103,3461,7387
"2000","INDIANA","PIKE",2605,131,3566,6302
"2000","INDIANA","PORTER",26790,1431,31157,59378
"2000","INDIANA","POSEY",4430,182,6498,11110
"2000","INDIANA","PULASKI",1919,102,3497,5518
"2000","INDIANA","PUTNAM",4123,396,7352,11871
"2000","INDIANA","RANDOLPH",3906,206,6020,10132
"2000","INDIANA","RIPLEY",3498,189,6988,10675
"2000","INDIANA","RUSH",2370,165,4749,7284
"2000","INDIANA","SCOTT",3915,170,3761,7846
"2000","INDIANA","SHELBY",5374,346,9590,15310
"2000","INDIANA","SPENCER",3752,139,5096,8987
"2000","INDIANA","ST. JOSEPH",47703,2190,47581,97474
"2000","INDIANA","STARKE",4136,216,4349,8701
"2000","INDIANA","STEUBEN",4103,221,6953,11277
"2000","INDIANA","SULLIVAN",3833,110,4319,8262
"2000","INDIANA","SWITZERLAND",1336,72,1831,3239
"2000","INDIANA","TIPPECANOE",18220,1969,26106,46295
"2000","INDIANA","TIPTON",2392,140,4784,7316
"2000","INDIANA","UNION",927,63,1838,2828
"2000","INDIANA","VANDERBURGH",29222,1153,35846,66221
"2000","INDIANA","VERMILLION",3370,133,3130,6633
"2000","INDIANA","VIGO",17570,637,18021,36228
"2000","INDIANA","WABASH",4277,285,8321,12883
"2000","INDIANA","WARREN",1471,79,2218,3768
"2000","INDIANA","WARRICK",8749,355,13205,22309
"2000","INDIANA","WASHINGTON",3675,258,5868,9801
"2000","INDIANA","WAYNE",10273,605,14273,25151
"2000","INDIANA","WELLS",3319,207,7755,11281
"2000","INDIANA","WHITE",3655,212,6037,9904
"2000","INDIANA","WHITLEY",4107,245,8080,12432
"2000","IOWA","ADAIR",1753,95,2275,4123
"2000","IOWA","ADAMS",897,78,1170,2145
"2000","IOWA","ALLAMAKEE",2883,302,3277,6462
"2000","IOWA","APPANOOSE",2560,152,2992,5704
"2000","IOWA","AUDUBON",1780,95,1909,3784
"2000","IOWA","BENTON",5915,383,5468,11766
"2000","IOWA","BLACK HAWK",30112,1505,23468,55085
"2000","IOWA","BOONE",6270,354,5625,12249
"2000","IOWA","BREMER",5169,331,5675,11175
"2000","IOWA","BUCHANAN",5045,273,4092,9410
"2000","IOWA","BUENA VISTA",3297,326,4354,7977
"2000","IOWA","BUTLER",2735,152,3837,6724
"2000","IOWA","CALHOUN",2132,133,2776,5041
"2000","IOWA","CARROLL",4463,226,4879,9568
"2000","IOWA","CASS",2481,193,4206,6880
"2000","IOWA","CEDAR",4033,280,4031,8344
"2000","IOWA","CERRO GORDO",12185,580,9397,22162
"2000","IOWA","CHEROKEE",2845,284,3463,6592
"2000","IOWA","CHICKASAW",3435,213,2936,6584
"2000","IOWA","CLARKE",2081,111,1984,4176
"2000","IOWA","CLAY",3294,292,3992,7578
"2000","IOWA","CLAYTON",4238,299,4034,8571
"2000","IOWA","CLINTON",12276,675,9229,22180
"2000","IOWA","CRAWFORD",2838,235,3482,6555
"2000","IOWA","DALLAS",8561,463,10306,19330
"2000","IOWA","DAVIS",1691,111,1956,3758
"2000","IOWA","DECATUR",1674,132,1903,3709
"2000","IOWA","DELAWARE",3808,268,4273,8349
"2000","IOWA","DES MOINES",11351,629,7385,19365
"2000","IOWA","DICKINSON",3660,236,4225,8121
"2000","IOWA","DUBUQUE",22341,1520,16462,40323
"2000","IOWA","EMMET",2165,134,2331,4630
"2000","IOWA","FAYETTE",4640,234,4747,9621
"2000","IOWA","FLOYD",3830,217,3191,7238
"2000","IOWA","FRANKLIN",2122,159,2657,4938
"2000","IOWA","FREMONT",1459,88,2069,3616
"2000","IOWA","GREENE",2301,136,2282,4719
"2000","IOWA","GRUNDY",2139,121,3851,6111
"2000","IOWA","GUTHRIE",2493,136,2840,5469
"2000","IOWA","HAMILTON",3407,199,3968,7574
"2000","IOWA","HANCOCK",2281,169,2988,5438
"2000","IOWA","HARDIN",3734,215,4486,8435
"2000","IOWA","HARRISON",2551,190,3802,6543
"2000","IOWA","HENRY",3907,288,4476,8671
"2000","IOWA","HOWARD",2426,143,1922,4491
"2000","IOWA","HUMBOLDT",1949,145,2846,4940
"2000","IOWA","IDA",1411,112,1968,3491
"2000","IOWA","IOWA",3230,289,3894,7413
"2000","IOWA","JACKSON",4945,318,3769,9032
"2000","IOWA","JASPER",8699,407,8729,17835
"2000","IOWA","JEFFERSON",2863,1437,3248,7548
"2000","IOWA","JOHNSON",31174,3696,17899,52769
"2000","IOWA","JONES",4690,252,4201,9143
"2000","IOWA","KEOKUK",2181,195,2571,4947
"2000","IOWA","KOSSUTH",3960,306,4612,8878
"2000","IOWA","LEE",9632,601,6339,16572
"2000","IOWA","LINN",48897,2750,40417,92064
"2000","IOWA","LOUISA",2294,136,2207,4637
"2000","IOWA","LUCAS",1934,107,2262,4303
"2000","IOWA","LYON",1313,111,3918,5342
"2000","IOWA","MADISON",3093,214,3662,6969
"2000","IOWA","MAHASKA",3370,202,5971,9543
"2000","IOWA","MARION",5741,309,8358,14408
"2000","IOWA","MARSHALL",8322,517,8785,17624
"2000","IOWA","MILLS",2039,192,3684,5915
"2000","IOWA","MITCHELL",2650,124,2388,5162
"2000","IOWA","MONONA",2086,170,2304,4560
"2000","IOWA","MONROE",1699,90,1858,3647
"2000","IOWA","MONTGOMERY",1838,139,3417,5394
"2000","IOWA","MUSCATINE",8058,535,7483,16076
"2000","IOWA","O'BRIEN",2170,200,4674,7044
"2000","IOWA","OSCEOLA",913,86,2064,3063
"2000","IOWA","PAGE",2293,178,4588,7059
"2000","IOWA","PALO ALTO",2326,156,2341,4823
"2000","IOWA","PLYMOUTH",3499,430,6189,10118
"2000","IOWA","POCAHONTAS",1736,163,2242,4141
"2000","IOWA","POLK",89715,4525,79927,174167
"2000","IOWA","POTTAWATTAMIE",14726,958,18783,34467
"2000","IOWA","POWESHIEK",4222,362,4396,8980
"2000","IOWA","RINGGOLD",1246,77,1369,2692
"2000","IOWA","SAC",2099,158,2776,5033
"2000","IOWA","SCOTT",35857,1910,32801,70568
"2000","IOWA","SHELBY",2179,175,3655,6009
"2000","IOWA","SIOUX",2148,303,12241,14692
"2000","IOWA","STORY",17478,1658,16228,35364
"2000","IOWA","TAMA",4045,236,4034,8315
"2000","IOWA","TAYLOR",1247,79,1770,3096
"2000","IOWA","UNION",2540,197,3003,5740
"2000","IOWA","VAN BUREN",1440,105,2016,3561
"2000","IOWA","WAPELLO",8355,471,6313,15139
"2000","IOWA","WARREN",9521,511,9621,19653
"2000","IOWA","WASHINGTON",3932,335,4827,9094
"2000","IOWA","WAYNE",1300,55,1666,3021
"2000","IOWA","WEBSTER",8479,397,8172,17048
"2000","IOWA","WINNEBAGO",2691,174,2662,5527
"2000","IOWA","WINNESHIEK",4339,431,4647,9417
"2000","IOWA","WOODBURY",17691,1341,18864,37896
"2000","IOWA","WORTH",2208,137,1659,4004
"2000","IOWA","WRIGHT",2796,156,3384,6336
"2000","KANSAS","ALLEN",2132,255,3379,5766
"2000","KANSAS","ANDERSON",1327,167,1984,3478
"2000","KANSAS","ATCHISON",3171,351,3378,6900
"2000","KANSAS","BARBER",637,106,1755,2498
"2000","KANSAS","BARTON",3238,415,7302,10955
"2000","KANSAS","BOURBON",2211,245,3852,6308
"2000","KANSAS","BROWN",1512,194,2985,4691
"2000","KANSAS","BUTLER",6755,870,13377,21002
"2000","KANSAS","CHASE",391,78,848,1317
"2000","KANSAS","CHAUTAUQUA",443,90,1347,1880
"2000","KANSAS","CHEROKEE",3783,333,5014,9130
"2000","KANSAS","CHEYENNE",350,65,1312,1727
"2000","KANSAS","CLARK",292,43,926,1261
"2000","KANSAS","CLAY",951,139,2998,4088
"2000","KANSAS","CLOUD",1314,271,2918,4503
"2000","KANSAS","COFFEY",1196,144,2700,4040
"2000","KANSAS","COMANCHE",211,35,760,1006
"2000","KANSAS","COWLEY",5535,595,8080,14210
"2000","KANSAS","CRAWFORD",7076,798,7160,15034
"2000","KANSAS","DECATUR",424,80,1255,1759
"2000","KANSAS","DICKINSON",2413,436,5243,8092
"2000","KANSAS","DONIPHAN",1134,165,2350,3649
"2000","KANSAS","DOUGLAS",18249,4527,17062,39838
"2000","KANSAS","EDWARDS",447,54,1062,1563
"2000","KANSAS","ELK",402,68,1080,1550
"2000","KANSAS","ELLIS",3926,718,6516,11160
"2000","KANSAS","ELLSWORTH",825,169,1845,2839
"2000","KANSAS","FINNEY",2431,277,6442,9150
"2000","KANSAS","FORD",2566,301,6050,8917
"2000","KANSAS","FRANKLIN",3321,412,5925,9658
"2000","KANSAS","GEARY",2660,229,3977,6866
"2000","KANSAS","GOVE",296,77,1122,1495
"2000","KANSAS","GRAHAM",346,70,1058,1474
"2000","KANSAS","GRANT",683,47,2126,2856
"2000","KANSAS","GRAY",482,47,1631,2160
"2000","KANSAS","GREELEY",143,32,628,803
"2000","KANSAS","GREENWOOD",1027,142,2392,3561
"2000","KANSAS","HAMILTON",264,27,901,1192
"2000","KANSAS","HARPER",869,110,2076,3055
"2000","KANSAS","HARVEY",4591,822,8271,13684
"2000","KANSAS","HASKELL",263,30,1323,1616
"2000","KANSAS","HODGEMAN",217,36,835,1088
"2000","KANSAS","JACKSON",1990,259,3001,5250
"2000","KANSAS","JEFFERSON",3000,454,4423,7877
"2000","KANSAS","JEWELL",380,97,1400,1877
"2000","KANSAS","JOHNSON",79118,8453,129965,217536
"2000","KANSAS","KEARNY",320,31,1084,1435
"2000","KANSAS","KINGMAN",991,145,2672,3808
"2000","KANSAS","KIOWA",294,52,1262,1608
"2000","KANSAS","LABETTE",3745,318,4475,8538
"2000","KANSAS","LANE",252,35,846,1133
"2000","KANSAS","LEAVENWORTH",9733,955,12583,23271
"2000","KANSAS","LINCOLN",469,126,1295,1890
"2000","KANSAS","LINN",1587,159,2513,4259
"2000","KANSAS","LOGAN",231,78,1088,1397
"2000","KANSAS","LYON",5190,613,6652,12455
"2000","KANSAS","MARION",1475,272,4156,5903
"2000","KANSAS","MARSHALL",1831,218,3066,5115
"2000","KANSAS","MCPHERSON",3272,688,8501,12461
"2000","KANSAS","MEADE",400,49,1604,2053
"2000","KANSAS","MIAMI",4554,442,6611,11607
"2000","KANSAS","MITCHELL",751,165,2350,3266
"2000","KANSAS","MONTGOMERY",4770,479,8496,13745
"2000","KANSAS","MORRIS",882,160,1599,2641
"2000","KANSAS","MORTON",321,33,1203,1557
"2000","KANSAS","NEMAHA",1494,218,3578,5290
"2000","KANSAS","NEOSHO",2588,284,4014,6886
"2000","KANSAS","NESS",383,73,1420,1876
"2000","KANSAS","NORTON",598,109,1744,2451
"2000","KANSAS","OSAGE",2530,313,3770,6613
"2000","KANSAS","OSBORNE",484,114,1432,2030
"2000","KANSAS","OTTAWA",631,183,1977,2791
"2000","KANSAS","PAWNEE",968,122,1850,2940
"2000","KANSAS","PHILLIPS",611,124,2057,2792
"2000","KANSAS","POTTAWATOMIE",2037,709,4985,7731
"2000","KANSAS","PRATT",1314,217,2885,4416
"2000","KANSAS","RAWLINS",306,85,1349,1740
"2000","KANSAS","RENO",9025,1226,15179,25430
"2000","KANSAS","REPUBLIC",604,142,2239,2985
"2000","KANSAS","RICE",1422,195,2903,4520
"2000","KANSAS","RILEY",6188,1393,10672,18253
"2000","KANSAS","ROOKS",597,162,2016,2775
"2000","KANSAS","RUSH",505,114,1235,1854
"2000","KANSAS","RUSSELL",886,162,2434,3482
"2000","KANSAS","SALINE",7487,1628,12412,21527
"2000","KANSAS","SCOTT",418,74,1811,2303
"2000","KANSAS","SEDGWICK",62561,7132,93724,163417
"2000","KANSAS","SEWARD",1126,101,3869,5096
"2000","KANSAS","SHAWNEE",34818,3661,35894,74373
"2000","KANSAS","SHERIDAN",281,76,1132,1489
"2000","KANSAS","SHERMAN",681,107,1894,2682
"2000","KANSAS","SMITH",534,116,1534,2184
"2000","KANSAS","STAFFORD",567,87,1546,2200
"2000","KANSAS","STANTON",215,29,785,1029
"2000","KANSAS","STEVENS",345,52,1714,2111
"2000","KANSAS","SUMNER",3549,507,6176,10232
"2000","KANSAS","THOMAS",807,151,2822,3780
"2000","KANSAS","TREGO",516,101,1220,1837
"2000","KANSAS","WABAUNSEE",1025,213,2182,3420
"2000","KANSAS","WALLACE",103,21,737,861
"2000","KANSAS","WASHINGTON",687,134,2446,3267
"2000","KANSAS","WICHITA",207,24,859,1090
"2000","KANSAS","WILSON",1186,161,2748,4095
"2000","KANSAS","WOODSON",521,100,974,1595
"2000","KANSAS","WYANDOTTE",32411,1837,14024,48272
"2000","KENTUCKY","ADAIR",1779,89,5460,7328
"2000","KENTUCKY","ALLEN",1950,64,4415,6429
"2000","KENTUCKY","ANDERSON",2902,156,4909,7967
"2000","KENTUCKY","BALLARD",1880,66,1824,3770
"2000","KENTUCKY","BARREN",4930,173,8741,13844
"2000","KENTUCKY","BATH",2087,83,2303,4473
"2000","KENTUCKY","BELL",4787,239,5585,10611
"2000","KENTUCKY","BOONE",9248,720,22016,31984
"2000","KENTUCKY","BOURBON",3048,173,3881,7102
"2000","KENTUCKY","BOYD",9541,394,9247,19182
"2000","KENTUCKY","BOYLE",3963,237,6126,10326
"2000","KENTUCKY","BRACKEN",888,66,2065,3019
"2000","KENTUCKY","BREATHITT",2902,87,2084,5073
"2000","KENTUCKY","BRECKINRIDGE",2595,95,4763,7453
"2000","KENTUCKY","BULLITT",8195,452,14054,22701
"2000","KENTUCKY","BUTLER",1299,57,3654,5010
"2000","KENTUCKY","CALDWELL",2223,98,3161,5482
"2000","KENTUCKY","CALLOWAY",5635,333,7705,13673
"2000","KENTUCKY","CAMPBELL",12040,1000,20789,33829
"2000","KENTUCKY","CARLISLE",1149,39,1405,2593
"2000","KENTUCKY","CARROLL",1601,80,1818,3499
"2000","KENTUCKY","CARTER",4182,160,4617,8959
"2000","KENTUCKY","CASEY",1122,63,4284,5469
"2000","KENTUCKY","CHRISTIAN",6778,208,10787,17773
"2000","KENTUCKY","CLARK",4918,258,7297,12473
"2000","KENTUCKY","CLAY",1723,70,4926,6719
"2000","KENTUCKY","CLINTON",1032,49,3224,4305
"2000","KENTUCKY","CRITTENDEN",1610,75,2469,4154
"2000","KENTUCKY","CUMBERLAND",736,50,2220,3006
"2000","KENTUCKY","DAVIESS",14126,753,21361,36240
"2000","KENTUCKY","EDMONSON",1710,35,3250,4995
"2000","KENTUCKY","ELLIOTT",1525,29,827,2381
"2000","KENTUCKY","ESTILL",1591,86,3033,4710
"2000","KENTUCKY","FAYETTE",47277,3705,54495,105477
"2000","KENTUCKY","FLEMING",1813,84,3282,5179
"2000","KENTUCKY","FLOYD",10088,238,5068,15394
"2000","KENTUCKY","FRANKLIN",10853,592,10209,21654
"2000","KENTUCKY","FULTON",1452,43,1293,2788
"2000","KENTUCKY","GALLATIN",1049,65,1345,2459
"2000","KENTUCKY","GARRARD",1713,67,4043,5823
"2000","KENTUCKY","GRANT",2568,130,4405,7103
"2000","KENTUCKY","GRAVES",6097,285,7849,14231
"2000","KENTUCKY","GRAYSON",2604,111,5843,8558
"2000","KENTUCKY","GREEN",1085,56,3615,4756
"2000","KENTUCKY","GREENUP",7164,266,7233,14663
"2000","KENTUCKY","HANCOCK",1508,70,2032,3610
"2000","KENTUCKY","HARDIN",11095,631,18964,30690
"2000","KENTUCKY","HARLAN",5365,190,4980,10535
"2000","KENTUCKY","HARRISON",2658,160,3793,6611
"2000","KENTUCKY","HART",2201,93,3725,6019
"2000","KENTUCKY","HENDERSON",8054,287,7698,16039
"2000","KENTUCKY","HENRY",2117,112,3244,5473
"2000","KENTUCKY","HICKMAN",940,33,1151,2124
"2000","KENTUCKY","HOPKINS",6734,265,9490,16489
"2000","KENTUCKY","JACKSON",701,75,4079,4855
"2000","KENTUCKY","JEFFERSON",149901,7409,145052,302362
"2000","KENTUCKY","JESSAMINE",4633,354,10074,15061
"2000","KENTUCKY","JOHNSON",3251,146,4783,8180
"2000","KENTUCKY","KENTON",19100,1786,35363,56249
"2000","KENTUCKY","KNOTT",4349,80,2029,6458
"2000","KENTUCKY","KNOX",3690,162,6058,9910
"2000","KENTUCKY","LARUE",1727,68,3384,5179
"2000","KENTUCKY","LAUREL",4856,235,13029,18120
"2000","KENTUCKY","LAWRENCE",2258,80,2969,5307
"2000","KENTUCKY","LEE",836,35,1893,2764
"2000","KENTUCKY","LESLIE",1210,65,3159,4434
"2000","KENTUCKY","LETCHER",4698,195,4092,8985
"2000","KENTUCKY","LEWIS",1293,58,3217,4568
"2000","KENTUCKY","LINCOLN",2678,124,4795,7597
"2000","KENTUCKY","LIVINGSTON",2022,90,2118,4230
"2000","KENTUCKY","LOGAN",3885,103,5344,9332
"2000","KENTUCKY","LYON",1680,52,1688,3420
"2000","KENTUCKY","MADISON",9309,675,13682,23666
"2000","KENTUCKY","MAGOFFIN",2603,65,2785,5453
"2000","KENTUCKY","MARION",2778,139,3259,6176
"2000","KENTUCKY","MARSHALL",6203,264,7294,13761
"2000","KENTUCKY","MARTIN",1714,75,2667,4456
"2000","KENTUCKY","MASON",2178,123,3572,5873
"2000","KENTUCKY","MCCRACKEN",11412,532,14745,26689
"2000","KENTUCKY","MCCREARY",1418,60,3321,4799
"2000","KENTUCKY","MCLEAN",1747,56,2219,4022
"2000","KENTUCKY","MEADE",3596,156,5319,9071
"2000","KENTUCKY","MENIFEE",1038,41,1170,2249
"2000","KENTUCKY","MERCER",3092,178,5362,8632
"2000","KENTUCKY","METCALFE",1318,55,2476,3849
"2000","KENTUCKY","MONROE",1158,34,4377,5569
"2000","KENTUCKY","MONTGOMERY",3833,152,4534,8519
"2000","KENTUCKY","MORGAN",1875,70,2295,4240
"2000","KENTUCKY","MUHLENBERG",6295,143,5518,11956
"2000","KENTUCKY","NELSON",5481,293,7714,13488
"2000","KENTUCKY","NICHOLAS",994,66,1613,2673
"2000","KENTUCKY","OHIO",3303,166,5413,8882
"2000","KENTUCKY","OLDHAM",6236,452,13580,20268
"2000","KENTUCKY","OWEN",1394,94,2582,4070
"2000","KENTUCKY","OWSLEY",339,21,1466,1826
"2000","KENTUCKY","PENDLETON",1670,89,3044,4803
"2000","KENTUCKY","PERRY",5514,186,5300,11000
"2000","KENTUCKY","PIKE",13611,319,11005,24935
"2000","KENTUCKY","POWELL",2008,96,2258,4362
"2000","KENTUCKY","PULASKI",5415,281,15845,21541
"2000","KENTUCKY","ROBERTSON",341,27,630,998
"2000","KENTUCKY","ROCKCASTLE",1174,81,3992,5247
"2000","KENTUCKY","ROWAN",3505,175,3546,7226
"2000","KENTUCKY","RUSSELL",1710,96,5268,7074
"2000","KENTUCKY","SCOTT",5472,362,7952,13786
"2000","KENTUCKY","SHELBY",4435,235,8068,12738
"2000","KENTUCKY","SIMPSON",2583,72,3169,5824
"2000","KENTUCKY","SPENCER",1554,68,3150,4772
"2000","KENTUCKY","TAYLOR",2790,110,6151,9051
"2000","KENTUCKY","TODD",1496,45,2646,4187
"2000","KENTUCKY","TRIGG",2110,104,3130,5344
"2000","KENTUCKY","TRIMBLE",1181,63,1837,3081
"2000","KENTUCKY","UNION",2547,72,2749,5368
"2000","KENTUCKY","WARREN",12180,560,20235,32975
"2000","KENTUCKY","WASHINGTON",1458,86,3044,4588
"2000","KENTUCKY","WAYNE",2312,93,4069,6474
"2000","KENTUCKY","WEBSTER",2388,85,2599,5072
"2000","KENTUCKY","WHITLEY",4101,171,7502,11774
"2000","KENTUCKY","WOLFE",1136,22,1267,2425
"2000","KENTUCKY","WOODFORD",3995,252,5890,10137
"2000","LOUISIANA","ACADIA",8892,532,13814,23238
"2000","LOUISIANA","ALLEN",3914,343,4035,8292
"2000","LOUISIANA","ASCENSION",13385,641,16818,30844
"2000","LOUISIANA","ASSUMPTION",5222,443,4388,10053
"2000","LOUISIANA","AVOYELLES",6701,623,7329,14653
"2000","LOUISIANA","BEAUREGARD",3958,385,7862,12205
"2000","LOUISIANA","BIENVILLE",3413,324,3269,7006
"2000","LOUISIANA","BOSSIER",11933,758,23224,35915
"2000","LOUISIANA","CADDO",47530,1302,46807,95639
"2000","LOUISIANA","CALCASIEU",33919,1631,38086,73636
"2000","LOUISIANA","CALDWELL",1359,152,2817,4328
"2000","LOUISIANA","CAMERON",1435,155,2593,4183
"2000","LOUISIANA","CATAHOULA",1718,135,2912,4765
"2000","LOUISIANA","CLAIBORNE",2721,176,3384,6281
"2000","LOUISIANA","CONCORDIA",3569,303,4627,8499
"2000","LOUISIANA","DE SOTO",5036,300,5260,10596
"2000","LOUISIANA","EAST BATON ROUGE",76516,3345,89128,168989
"2000","LOUISIANA","EAST CARROLL",1876,89,1280,3245
"2000","LOUISIANA","EAST FELICIANA",3870,178,4051,8099
"2000","LOUISIANA","EVANGELINE",5763,559,7290,13612
"2000","LOUISIANA","FRANKLIN",2792,201,5363,8356
"2000","LOUISIANA","GRANT",2099,172,4784,7055
"2000","LOUISIANA","IBERIA",11762,1022,17236,30020
"2000","LOUISIANA","IBERVILLE",8355,575,5573,14503
"2000","LOUISIANA","JACKSON",2582,177,4347,7106
"2000","LOUISIANA","JEFFERSON",70411,3737,105003,179151
"2000","LOUISIANA","JEFFERSON DAVIS",5162,439,6945,12546
"2000","LOUISIANA","LA SALLE",1397,147,4564,6108
"2000","LOUISIANA","LAFAYETTE",27190,2612,48491,78293
"2000","LOUISIANA","LAFOURCHE",14627,1247,18575,34449
"2000","LOUISIANA","LINCOLN",6851,454,9246,16551
"2000","LOUISIANA","LIVINGSTON",11008,968,24889,36865
"2000","LOUISIANA","MADISON",2489,127,2127,4743
"2000","LOUISIANA","MOREHOUSE",5289,391,6641,12321
"2000","LOUISIANA","NATCHITOCHES",6924,601,7332,14857
"2000","LOUISIANA","ORLEANS",137630,4187,39404,181221
"2000","LOUISIANA","OUACHITA",21457,1647,35107,58211
"2000","LOUISIANA","PLAQUEMINES",4425,204,6302,10931
"2000","LOUISIANA","POINTE COUPEE",5813,309,4710,10832
"2000","LOUISIANA","RAPIDES",18898,1295,28831,49024
"2000","LOUISIANA","RED RIVER",2177,145,2200,4522
"2000","LOUISIANA","RICHLAND",3282,308,4895,8485
"2000","LOUISIANA","SABINE",2846,262,5754,8862
"2000","LOUISIANA","ST. BERNARD",11682,684,16255,28621
"2000","LOUISIANA","ST. CHARLES",8918,611,11981,21510
"2000","LOUISIANA","ST. HELENA",3059,230,1965,5254
"2000","LOUISIANA","ST. JAMES",6523,369,3813,10705
"2000","LOUISIANA","ST. JOHN THE BAPTIST",9745,545,7423,17713
"2000","LOUISIANA","ST. LANDRY",18067,635,15449,34151
"2000","LOUISIANA","ST. MARTIN",9853,964,9961,20778
"2000","LOUISIANA","ST. MARY",9851,634,11325,21810
"2000","LOUISIANA","ST. TAMMANY",22722,1822,59193,83737
"2000","LOUISIANA","TANGIPAHOA",15843,891,20421,37155
"2000","LOUISIANA","TENSAS",1580,100,1330,3010
"2000","LOUISIANA","TERREBONNE",14414,947,21314,36675
"2000","LOUISIANA","UNION",3205,366,5772,9343
"2000","LOUISIANA","VERMILION",8704,1036,12495,22235
"2000","LOUISIANA","VERNON",4655,378,8794,13827
"2000","LOUISIANA","WASHINGTON",7399,505,8983,16887
"2000","LOUISIANA","WEBSTER",7197,473,9420,17090
"2000","LOUISIANA","WEST BATON ROUGE",5058,187,4924,10169
"2000","LOUISIANA","WEST CARROLL",1319,136,3220,4675
"2000","LOUISIANA","WEST FELICIANA",2187,161,2512,4860
"2000","LOUISIANA","WINN",2167,166,4028,6361
"2000","MAINE","ANDROSCOGGIN",26251,3046,19948,49245
"2000","MAINE","AROOSTOOK",17196,1392,16555,35143
"2000","MAINE","CUMBERLAND",74203,9874,58543,142620
"2000","MAINE","FRANKLIN",7593,1396,6459,15448
"2000","MAINE","HANCOCK",12983,2859,12732,28574
"2000","MAINE","KENNEBEC",31198,3742,23967,58907
"2000","MAINE","KNOX",9453,2080,8968,20501
"2000","MAINE","LINCOLN",8634,1580,9457,19671
"2000","MAINE","MAINE UOCAVA",0,0,0,0
"2000","MAINE","OXFORD",13649,2009,11835,27493
"2000","MAINE","PENOBSCOT",32868,4718,35620,73206
"2000","MAINE","PISCATAQUIS",3745,666,4845,9256
"2000","MAINE","SAGADAHOC",8844,1510,8052,18406
"2000","MAINE","SOMERSET",11538,1729,10684,23951
"2000","MAINE","WALDO",8477,1972,8689,19138
"2000","MAINE","WASHINGTON",6701,1049,7958,15708
"2000","MAINE","YORK",46618,5628,42304,94550
"2000","MARYLAND","ALLEGANY",10894,821,14656,26371
"2000","MARYLAND","ANNE ARUNDEL",89624,6824,104209,200657
"2000","MARYLAND","BALTIMORE",160635,10416,133033,304084
"2000","MARYLAND","BALTIMORE CITY",158765,6489,27150,192404
"2000","MARYLAND","CALVERT",12986,816,16004,29806
"2000","MARYLAND","CAROLINE",3396,256,5300,8952
"2000","MARYLAND","CARROLL",20146,2139,41742,64027
"2000","MARYLAND","CECIL",12327,1055,15494,28876
"2000","MARYLAND","CHARLES",21873,951,21768,44592
"2000","MARYLAND","DORCHESTER",5232,313,5847,11392
"2000","MARYLAND","FREDERICK",30725,2586,45350,78661
"2000","MARYLAND","GARRETT",2872,269,7514,10655
"2000","MARYLAND","HARFORD",35665,2897,52862,91424
"2000","MARYLAND","HOWARD",58556,4414,49809,112779
"2000","MARYLAND","KENT",3627,303,4155,8085
"2000","MARYLAND","MONTGOMERY",232453,14655,124580,371688
"2000","MARYLAND","PRINCE GEORGE'S",216119,5803,49987,271909
"2000","MARYLAND","QUEEN ANNE'S",6257,534,9970,16761
"2000","MARYLAND","SOMERSET",3785,210,3609,7604
"2000","MARYLAND","ST. MARY'S",11912,733,16856,29501
"2000","MARYLAND","TALBOT",5854,506,8874,15234
"2000","MARYLAND","WASHINGTON",18221,1301,27948,47470
"2000","MARYLAND","WICOMICO",14469,988,16338,31795
"2000","MARYLAND","WORCESTER",9389,622,10742,20753
"2000","MASSACHUSETTS","BARNSTABLE",62363,9037,49686,121086
"2000","MASSACHUSETTS","BERKSHIRE",37934,5672,15805,59411
"2000","MASSACHUSETTS","BRISTOL",136325,12164,62848,211337
"2000","MASSACHUSETTS","DUKES",5474,1067,2315,8856
"2000","MASSACHUSETTS","ESSEX",178400,21923,110010,310333
"2000","MASSACHUSETTS","FRANKLIN",17945,5245,10176,33366
"2000","MASSACHUSETTS","HAMPDEN",100103,12432,59558,172093
"2000","MASSACHUSETTS","HAMPSHIRE",38543,10881,19202,68626
"2000","MASSACHUSETTS","MIDDLESEX",404043,54091,198914,657048
"2000","MASSACHUSETTS","NANTUCKET",2874,428,1624,4926
"2000","MASSACHUSETTS","NORFOLK",188450,21694,107033,317177
"2000","MASSACHUSETTS","PLYMOUTH",115376,13450,82751,211577
"2000","MASSACHUSETTS","SUFFOLK",154888,17671,44441,217000
"2000","MASSACHUSETTS","WORCESTER",173769,22240,114139,310148
"2000","MICHIGAN","ALCONA",2696,149,3152,5997
"2000","MICHIGAN","ALGER",2071,153,2142,4366
"2000","MICHIGAN","ALLEGAN",15495,1199,28197,44891
"2000","MICHIGAN","ALPENA",7053,310,6769,14132
"2000","MICHIGAN","ANTRIM",4329,398,6780,11507
"2000","MICHIGAN","ARENAC",3685,161,3421,7267
"2000","MICHIGAN","BARAGA",1400,157,1836,3393
"2000","MICHIGAN","BARRY",9769,759,15716,26244
"2000","MICHIGAN","BAY",28251,1235,22150,51636
"2000","MICHIGAN","BENZIE",3546,354,4172,8072
"2000","MICHIGAN","BERRIEN",28152,1400,35689,65241
"2000","MICHIGAN","BRANCH",6691,349,8743,15783
"2000","MICHIGAN","CALHOUN",27312,1477,26291,55080
"2000","MICHIGAN","CASS",8808,472,10545,19825
"2000","MICHIGAN","CHARLEVOIX",4958,511,7018,12487
"2000","MICHIGAN","CHEBOYGAN",5484,318,6815,12617
"2000","MICHIGAN","CHIPPEWA",6370,458,7526,14354
"2000","MICHIGAN","CLARE",6287,383,5937,12607
"2000","MICHIGAN","CLINTON",13394,751,18054,32199
"2000","MICHIGAN","CRAWFORD",2790,229,3345,6364
"2000","MICHIGAN","DELTA",7970,475,8871,17316
"2000","MICHIGAN","DICKINSON",5533,367,6932,12832
"2000","MICHIGAN","EATON",23211,1258,24803,49272
"2000","MICHIGAN","EMMET",5451,658,8602,14711
"2000","MICHIGAN","GENESEE",119833,4391,66641,190865
"2000","MICHIGAN","GLADWIN",5573,313,5743,11629
"2000","MICHIGAN","GOGEBIC",4066,344,3929,8339
"2000","MICHIGAN","GRAND TRAVERSE",14371,1500,22358,38229
"2000","MICHIGAN","GRATIOT",6538,329,8312,15179
"2000","MICHIGAN","HILLSDALE",6495,495,10483,17473
"2000","MICHIGAN","HOUGHTON",5688,633,7895,14216
"2000","MICHIGAN","HURON",6899,285,8911,16095
"2000","MICHIGAN","INGHAM",69231,4050,47314,120595
"2000","MICHIGAN","IONIA",9481,574,13915,23970
"2000","MICHIGAN","IOSCO",6505,372,6345,13222
"2000","MICHIGAN","IRON",3014,207,2967,6188
"2000","MICHIGAN","ISABELLA",10228,788,10053,21069
"2000","MICHIGAN","JACKSON",28160,1720,32066,61946
"2000","MICHIGAN","KALAMAZOO",48807,3595,48254,100656
"2000","MICHIGAN","KALKASKA",2774,233,3842,6849
"2000","MICHIGAN","KENT",95442,6274,148602,250318
"2000","MICHIGAN","KEWEENAW",540,63,740,1343
"2000","MICHIGAN","LAKE",2584,148,1961,4693
"2000","MICHIGAN","LAPEER",15749,1134,20351,37234
"2000","MICHIGAN","LEELANAU",4635,534,6840,12009
"2000","MICHIGAN","LENAWEE",18365,1047,20681,40093
"2000","MICHIGAN","LIVINGSTON",28780,2058,44637,75475
"2000","MICHIGAN","LUCE",956,100,1480,2536
"2000","MICHIGAN","MACKINAC",2533,165,3272,5970
"2000","MICHIGAN","MACOMB",172625,8669,164265,345559
"2000","MICHIGAN","MANISTEE",5639,388,5401,11428
"2000","MICHIGAN","MARQUETTE",15503,1099,12577,29179
"2000","MICHIGAN","MASON",5579,371,7066,13016
"2000","MICHIGAN","MECOSTA",6300,382,8072,14754
"2000","MICHIGAN","MENOMINEE",4597,308,5529,10434
"2000","MICHIGAN","MIDLAND",15959,1042,21887,38888
"2000","MICHIGAN","MISSAUKEE",2062,160,4274,6496
"2000","MICHIGAN","MONROE",31555,1300,28940,61795
"2000","MICHIGAN","MONTCALM",9627,581,12696,22904
"2000","MICHIGAN","MONTMORENCY",2139,120,2750,5009
"2000","MICHIGAN","MUSKEGON",37865,1377,30028,69270
"2000","MICHIGAN","NEWAYGO",7677,481,11399,19557
"2000","MICHIGAN","OAKLAND",281201,14745,274319,570265
"2000","MICHIGAN","OCEANA",4597,262,5913,10772
"2000","MICHIGAN","OGEMAW",4896,253,4706,9855
"2000","MICHIGAN","ONTONAGON",1514,165,2472,4151
"2000","MICHIGAN","OSCEOLA",4006,244,5680,9930
"2000","MICHIGAN","OSCODA",1677,108,2207,3992
"2000","MICHIGAN","OTSEGO",4034,363,6108,10505
"2000","MICHIGAN","OTTAWA",29600,2296,78703,110599
"2000","MICHIGAN","PRESQUE ISLE",3242,178,3660,7080
"2000","MICHIGAN","ROSCOMMON",6433,305,6190,12928
"2000","MICHIGAN","SAGINAW",50825,1779,41152,93756
"2000","MICHIGAN","SANILAC",7153,447,10966,18566
"2000","MICHIGAN","SCHOOLCRAFT",2036,74,2088,4198
"2000","MICHIGAN","SHIAWASSEE",15520,882,15816,32218
"2000","MICHIGAN","ST. CLAIR",33002,1943,33571,68516
"2000","MICHIGAN","ST. JOSEPH",8574,544,12906,22024
"2000","MICHIGAN","TUSCOLA",10845,594,13213,24652
"2000","MICHIGAN","VAN BUREN",13796,894,14792,29482
"2000","MICHIGAN","WASHTENAW",86647,5834,52459,144940
"2000","MICHIGAN","WAYNE",530414,15192,223021,768627
"2000","MICHIGAN","WEXFORD",5326,441,7215,12982
"2000","MINNESOTA","AITKIN",3830,675,3755,8260
"2000","MINNESOTA","ANOKA",68008,8355,69256,145619
"2000","MINNESOTA","BECKER",5253,928,8152,14333
"2000","MINNESOTA","BELTRAMI",7301,1570,8346,17217
"2000","MINNESOTA","BENTON",6009,1236,7663,14908
"2000","MINNESOTA","BIG STONE",1430,180,1370,2980
"2000","MINNESOTA","BLUE EARTH",12329,2131,12942,27402
"2000","MINNESOTA","BROWN",4650,814,7370,12834
"2000","MINNESOTA","CARLTON",8620,883,5578,15081
"2000","MINNESOTA","CARVER",12462,1769,20790,35021
"2000","MINNESOTA","CASS",5534,925,7134,13593
"2000","MINNESOTA","CHIPPEWA",2952,423,2977,6352
"2000","MINNESOTA","CHISAGO",9593,1457,10937,21987
"2000","MINNESOTA","CLAY",10128,1518,11712,23358
"2000","MINNESOTA","CLEARWATER",1466,221,2137,3824
"2000","MINNESOTA","COOK",1171,354,1295,2820
"2000","MINNESOTA","COTTONWOOD",2503,309,3369,6181
"2000","MINNESOTA","CROW WING",11255,1838,15035,28128
"2000","MINNESOTA","DAKOTA",85446,9553,87250,182249
"2000","MINNESOTA","DODGE",3370,467,4213,8050
"2000","MINNESOTA","DOUGLAS",6352,1042,9811,17205
"2000","MINNESOTA","FARIBAULT",3624,464,4336,8424
"2000","MINNESOTA","FILLMORE",5020,557,4646,10223
"2000","MINNESOTA","FREEBORN",8514,782,6843,16139
"2000","MINNESOTA","GOODHUE",9981,1424,10852,22257
"2000","MINNESOTA","GRANT",1507,313,1804,3624
"2000","MINNESOTA","HENNEPIN",307599,40590,225657,573846
"2000","MINNESOTA","HOUSTON",4502,588,5077,10167
"2000","MINNESOTA","HUBBARD",3632,674,5307,9613
"2000","MINNESOTA","ISANTI",6247,1014,7668,14929
"2000","MINNESOTA","ITASCA",10583,1586,9545,21714
"2000","MINNESOTA","JACKSON",2364,301,2773,5438
"2000","MINNESOTA","KANABEC",2831,500,3480,6811
"2000","MINNESOTA","KANDIYOHI",8220,1039,10026,19285
"2000","MINNESOTA","KITTSON",1107,177,1353,2637
"2000","MINNESOTA","KOOCHICHING",2903,453,3523,6879
"2000","MINNESOTA","LAC QUI PARLE",2244,268,1941,4453
"2000","MINNESOTA","LAKE",3579,519,2465,6563
"2000","MINNESOTA","LAKE OF THE WOODS",848,123,1216,2187
"2000","MINNESOTA","LE SUEUR",5361,832,6138,12331
"2000","MINNESOTA","LINCOLN",1590,181,1513,3284
"2000","MINNESOTA","LYON",4737,665,6087,11489
"2000","MINNESOTA","MAHNOMEN",921,181,1122,2224
"2000","MINNESOTA","MARSHALL",1910,377,2912,5199
"2000","MINNESOTA","MARTIN",4166,519,5686,10371
"2000","MINNESOTA","MCLEOD",5609,1003,8782,15394
"2000","MINNESOTA","MEEKER",4402,750,5520,10672
"2000","MINNESOTA","MILLE LACS",4376,654,5223,10253
"2000","MINNESOTA","MORRISON",5274,1206,8197,14677
"2000","MINNESOTA","MOWER",10693,914,6873,18480
"2000","MINNESOTA","MURRAY",2093,253,2407,4753
"2000","MINNESOTA","NICOLLET",7041,1065,7221,15327
"2000","MINNESOTA","NOBLES",3760,346,4766,8872
"2000","MINNESOTA","NORMAN",1575,258,1808,3641
"2000","MINNESOTA","OLMSTED",25822,2929,30641,59392
"2000","MINNESOTA","OTTER TAIL",9844,1704,16963,28511
"2000","MINNESOTA","PENNINGTON",2458,482,3380,6320
"2000","MINNESOTA","PINE",6148,1066,5854,13068
"2000","MINNESOTA","PIPESTONE",1970,231,2693,4894
"2000","MINNESOTA","POLK",5764,767,7609,14140
"2000","MINNESOTA","POPE",2771,408,2808,5987
"2000","MINNESOTA","RAMSEY",138470,18139,87669,244278
"2000","MINNESOTA","RED LAKE",830,170,1090,2090
"2000","MINNESOTA","REDWOOD",2681,478,4589,7748
"2000","MINNESOTA","RENVILLE",3533,553,4036,8122
"2000","MINNESOTA","RICE",13140,2005,10876,26021
"2000","MINNESOTA","ROCK",2081,157,2772,5010
"2000","MINNESOTA","ROSEAU",2128,343,4695,7166
"2000","MINNESOTA","SAINT LOUIS",64237,7807,35420,107464
"2000","MINNESOTA","SCOTT",17503,2336,23954,43793
"2000","MINNESOTA","SHERBURNE",12109,1913,16813,30835
"2000","MINNESOTA","SIBLEY",2687,561,4087,7335
"2000","MINNESOTA","STEARNS",24800,5274,32402,62476
"2000","MINNESOTA","STEELE",6900,943,8223,16066
"2000","MINNESOTA","STEVENS",2434,487,2831,5752
"2000","MINNESOTA","SWIFT",2698,363,2376,5437
"2000","MINNESOTA","TODD",4132,929,6031,11092
"2000","MINNESOTA","TRAVERSE",884,148,1074,2106
"2000","MINNESOTA","WABASHA",4522,764,5245,10531
"2000","MINNESOTA","WADENA",2251,398,3733,6382
"2000","MINNESOTA","WASECA",3694,562,4608,8864
"2000","MINNESOTA","WASHINGTON",49637,5870,51502,107009
"2000","MINNESOTA","WATONWAN",2258,314,2562,5134
"2000","MINNESOTA","WILKIN",1046,227,2032,3305
"2000","MINNESOTA","WINONA",11069,2076,10773,23918
"2000","MINNESOTA","WRIGHT",16762,2743,23861,43366
"2000","MINNESOTA","YELLOW MEDICINE",2528,389,2598,5515
"2000","MISSISSIPPI","ADAMS",8065,123,6691,14879
"2000","MISSISSIPPI","ALCORN",5059,325,7254,12638
"2000","MISSISSIPPI","AMITE",2673,58,3677,6408
"2000","MISSISSIPPI","ATTALA",2922,45,4206,7173
"2000","MISSISSIPPI","BENTON",1886,34,1561,3481
"2000","MISSISSIPPI","BOLIVAR",8436,255,4847,13538
"2000","MISSISSIPPI","CALHOUN",2251,59,3448,5758
"2000","MISSISSIPPI","CARROLL",1726,33,3165,4924
"2000","MISSISSIPPI","CHICKASAW",3519,107,3549,7175
"2000","MISSISSIPPI","CHOCTAW",1278,43,2398,3719
"2000","MISSISSIPPI","CLAIBORNE",3670,62,883,4615
"2000","MISSISSIPPI","CLARKE",2368,48,4503,6919
"2000","MISSISSIPPI","CLAY",4515,80,3570,8165
"2000","MISSISSIPPI","COAHOMA",5662,196,3695,9553
"2000","MISSISSIPPI","COPIAH",4845,99,5643,10587
"2000","MISSISSIPPI","COVINGTON",2623,78,4180,6881
"2000","MISSISSIPPI","DESOTO",9586,471,24879,34936
"2000","MISSISSIPPI","FORREST",8500,470,13281,22251
"2000","MISSISSIPPI","FRANKLIN",1486,40,2427,3953
"2000","MISSISSIPPI","GEORGE",1977,164,5143,7284
"2000","MISSISSIPPI","GREENE",1317,37,3082,4436
"2000","MISSISSIPPI","GRENADA",4163,93,5129,9385
"2000","MISSISSIPPI","HANCOCK",4801,421,9326,14548
"2000","MISSISSIPPI","HARRISON",19142,1218,32256,52616
"2000","MISSISSIPPI","HINDS",46789,3228,37753,87770
"2000","MISSISSIPPI","HOLMES",5447,38,1937,7422
"2000","MISSISSIPPI","HUMPHREYS",2288,28,1628,3944
"2000","MISSISSIPPI","ISSAQUENA",555,20,366,941
"2000","MISSISSIPPI","ITAWAMBA",2994,146,5424,8564
"2000","MISSISSIPPI","JACKSON",14193,846,30068,45107
"2000","MISSISSIPPI","JASPER",3104,49,3294,6447
"2000","MISSISSIPPI","JEFFERSON",2786,22,600,3408
"2000","MISSISSIPPI","JEFFERSON DAVIS",2835,45,2437,5317
"2000","MISSISSIPPI","JONES",7713,286,16341,24340
"2000","MISSISSIPPI","KEMPER",2311,35,1915,4261
"2000","MISSISSIPPI","LAFAYETTE",5139,458,7081,12678
"2000","MISSISSIPPI","LAMAR",3478,329,12795,16602
"2000","MISSISSIPPI","LAUDERDALE",8412,243,17315,25970
"2000","MISSISSIPPI","LAWRENCE",2841,72,3674,6587
"2000","MISSISSIPPI","LEAKE",2793,45,4114,6952
"2000","MISSISSIPPI","LEE",9142,401,15551,25094
"2000","MISSISSIPPI","LEFLORE",6401,249,4626,11276
"2000","MISSISSIPPI","LINCOLN",4358,102,8540,13000
"2000","MISSISSIPPI","LOWNDES",7537,289,11404,19230
"2000","MISSISSIPPI","MADISON",10416,334,19109,29859
"2000","MISSISSIPPI","MARION",4114,88,6796,10998
"2000","MISSISSIPPI","MARSHALL",7735,134,4723,12592
"2000","MISSISSIPPI","MONROE",5783,180,7397,13360
"2000","MISSISSIPPI","MONTGOMERY",2187,32,2630,4849
"2000","MISSISSIPPI","NESHOBA",2563,94,6409,9066
"2000","MISSISSIPPI","NEWTON",2147,51,5540,7738
"2000","MISSISSIPPI","NOXUBEE",3383,41,1530,4954
"2000","MISSISSIPPI","OKTIBBEHA",6443,402,7959,14804
"2000","MISSISSIPPI","PANOLA",5880,85,5424,11389
"2000","MISSISSIPPI","PEARL RIVER",4611,291,11575,16477
"2000","MISSISSIPPI","PERRY",1285,48,3026,4359
"2000","MISSISSIPPI","PIKE",6544,158,7464,14166
"2000","MISSISSIPPI","PONTOTOC",2771,138,6601,9510
"2000","MISSISSIPPI","PRENTISS",3287,94,5101,8482
"2000","MISSISSIPPI","QUITMAN",2103,30,1280,3413
"2000","MISSISSIPPI","RANKIN",8050,402,32983,41435
"2000","MISSISSIPPI","SCOTT",3548,57,5601,9206
"2000","MISSISSIPPI","SHARKEY",1706,123,1074,2903
"2000","MISSISSIPPI","SIMPSON",3227,93,6254,9574
"2000","MISSISSIPPI","SMITH",1620,70,4838,6528
"2000","MISSISSIPPI","STONE",1677,144,3702,5523
"2000","MISSISSIPPI","SUNFLOWER",4981,65,3369,8415
"2000","MISSISSIPPI","TALLAHATCHIE",3041,54,2428,5523
"2000","MISSISSIPPI","TATE",3441,104,5148,8693
"2000","MISSISSIPPI","TIPPAH",2908,114,5381,8403
"2000","MISSISSIPPI","TISHOMINGO",2747,123,4122,6992
"2000","MISSISSIPPI","TUNICA",1539,35,792,2366
"2000","MISSISSIPPI","UNION",3094,130,6087,9311
"2000","MISSISSIPPI","WALTHALL",2356,63,3476,5895
"2000","MISSISSIPPI","WARREN",7485,246,10892,18623
"2000","MISSISSIPPI","WASHINGTON",10405,556,7367,18328
"2000","MISSISSIPPI","WAYNE",2981,89,4635,7705
"2000","MISSISSIPPI","WEBSTER",1426,50,3069,4545
"2000","MISSISSIPPI","WILKINSON",2551,124,1423,4098
"2000","MISSISSIPPI","WINSTON",3672,51,4645,8368
"2000","MISSISSIPPI","YALOBUSHA",2674,84,2470,5228
"2000","MISSISSIPPI","YAZOO",4997,265,5254,10516
"2000","MISSOURI","ADAIR",4101,401,6050,10552
"2000","MISSOURI","ANDREW",2795,222,4257,7274
"2000","MISSOURI","ATCHISON",1013,60,1798,2871
"2000","MISSOURI","AUDRAIN",4551,178,5256,9985
"2000","MISSOURI","BARRY",4135,348,7885,12368
"2000","MISSOURI","BARTON",1424,106,3836,5366
"2000","MISSOURI","BATES",3386,161,4245,7792
"2000","MISSOURI","BENTON",3150,166,4218,7534
"2000","MISSOURI","BOLLINGER",1692,115,3487,5294
"2000","MISSOURI","BOONE",28811,2372,28426,59609
"2000","MISSOURI","BUCHANAN",17085,1243,16423,34751
"2000","MISSOURI","BUTLER",4996,290,9111,14397
"2000","MISSOURI","CALDWELL",1488,142,2220,3850
"2000","MISSOURI","CALLAWAY",6708,362,8238,15308
"2000","MISSOURI","CAMDEN",6323,418,10358,17099
"2000","MISSOURI","CAPE GIRARDEAU",9334,693,19832,29859
"2000","MISSOURI","CARROLL",1620,81,2880,4581
"2000","MISSOURI","CARTER",997,81,1730,2808
"2000","MISSOURI","CASS",14921,835,20113,35869
"2000","MISSOURI","CEDAR",1979,154,3530,5663
"2000","MISSOURI","CHARITON",1792,62,2300,4154
"2000","MISSOURI","CHRISTIAN",7896,508,14824,23228
"2000","MISSOURI","CLARK",1812,91,1899,3802
"2000","MISSOURI","CLAY",39084,2006,39083,80173
"2000","MISSOURI","CLINTON",3994,214,4323,8531
"2000","MISSOURI","COLE",12056,552,20167,32775
"2000","MISSOURI","COOPER",2567,151,4072,6790
"2000","MISSOURI","CRAWFORD",3350,198,4754,8302
"2000","MISSOURI","DADE",1193,91,2468,3752
"2000","MISSOURI","DALLAS",2311,185,3723,6219
"2000","MISSOURI","DAVIESS",1367,116,2011,3494
"2000","MISSOURI","DEKALB",1562,124,2363,4049
"2000","MISSOURI","DENT",1839,153,3996,5988
"2000","MISSOURI","DOUGLAS",1546,136,3599,5281
"2000","MISSOURI","DUNKLIN",4947,152,5426,10525
"2000","MISSOURI","FRANKLIN",16172,1159,21863,39194
"2000","MISSOURI","GASCONADE",2257,182,4190,6629
"2000","MISSOURI","GENTRY",1271,63,1771,3105
"2000","MISSOURI","GREENE",41091,2657,59178,102926
"2000","MISSOURI","GRUNDY",1563,169,2976,4708
"2000","MISSOURI","HARRISON",1328,111,2552,3991
"2000","MISSOURI","HENRY",4459,199,5120,9778
"2000","MISSOURI","HICKORY",1961,105,2172,4238
"2000","MISSOURI","HOLT",871,53,1738,2662
"2000","MISSOURI","HOWARD",1944,154,2414,4512
"2000","MISSOURI","HOWELL",4641,416,9018,14075
"2000","MISSOURI","IRON",2044,133,2237,4414
"2000","MISSOURI","JACKSON",160419,7225,104418,272062
"2000","MISSOURI","JASPER",11737,845,24899,37481
"2000","MISSOURI","JEFFERSON",38616,1822,36766,77204
"2000","MISSOURI","JOHNSON",6926,522,9339,16787
"2000","MISSOURI","KANSAS CITY",0,0,0,0
"2000","MISSOURI","KNOX",787,42,1226,2055
"2000","MISSOURI","LACLEDE",4183,307,8556,13046
"2000","MISSOURI","LAFAYETTE",6343,328,7849,14520
"2000","MISSOURI","LAWRENCE",4235,363,8305,12903
"2000","MISSOURI","LEWIS",2023,73,2388,4484
"2000","MISSOURI","LINCOLN",6961,403,8549,15913
"2000","MISSOURI","LINN",2646,118,3246,6010
"2000","MISSOURI","LIVINGSTON",2425,142,3709,6276
"2000","MISSOURI","MACON",2817,126,4232,7175
"2000","MISSOURI","MADISON",1828,85,2460,4373
"2000","MISSOURI","MARIES",1554,84,2216,3854
"2000","MISSOURI","MARION",4993,169,6550,11712
"2000","MISSOURI","MCDONALD",1866,203,4460,6529
"2000","MISSOURI","MERCER",555,37,1250,1842
"2000","MISSOURI","MILLER",3217,194,5945,9356
"2000","MISSOURI","MISSISSIPPI",2756,64,2395,5215
"2000","MISSOURI","MONITEAU",2176,125,3764,6065
"2000","MISSOURI","MONROE",1860,59,2175,4094
"2000","MISSOURI","MONTGOMERY",2092,105,3106,5303
"2000","MISSOURI","MORGAN",3235,186,4460,7881
"2000","MISSOURI","NEW MADRID",3738,112,3416,7266
"2000","MISSOURI","NEWTON",6447,483,14232,21162
"2000","MISSOURI","NODAWAY",3553,335,5161,9049
"2000","MISSOURI","OREGON",1568,144,2521,4233
"2000","MISSOURI","OSAGE",1938,86,4154,6178
"2000","MISSOURI","OZARK",1432,197,2663,4292
"2000","MISSOURI","PEMISCOT",3245,65,2750,6060
"2000","MISSOURI","PERRY",2085,151,4667,6903
"2000","MISSOURI","PETTIS",5855,367,9533,15755
"2000","MISSOURI","PHELPS",6262,440,9444,16146
"2000","MISSOURI","PIKE",3557,146,3648,7351
"2000","MISSOURI","PLATTE",15325,944,17785,34054
"2000","MISSOURI","POLK",3606,258,6430,10294
"2000","MISSOURI","PULASKI",3800,200,6531,10531
"2000","MISSOURI","PUTNAM",708,33,1593,2334
"2000","MISSOURI","RALLS",2033,63,2446,4542
"2000","MISSOURI","RANDOLPH",4116,226,4844,9186
"2000","MISSOURI","RAY",4970,260,4517,9747
"2000","MISSOURI","REYNOLDS",1298,71,1762,3131
"2000","MISSOURI","RIPLEY",1820,124,3121,5065
"2000","MISSOURI","SALINE",4585,198,4572,9355
"2000","MISSOURI","SCHUYLER",808,39,1159,2006
"2000","MISSOURI","SCOTLAND",790,54,1335,2179
"2000","MISSOURI","SCOTT",6452,253,8999,15704
"2000","MISSOURI","SHANNON",1430,106,2245,3781
"2000","MISSOURI","SHELBY",1262,59,1936,3257
"2000","MISSOURI","ST. CHARLES",53806,2766,72114,128686
"2000","MISSOURI","ST. CLAIR",1866,142,2731,4739
"2000","MISSOURI","ST. FRANCOIS",9075,439,9327,18841
"2000","MISSOURI","ST. LOUIS CITY",96557,3396,24799,124752
"2000","MISSOURI","ST. LOUIS COUNTY",250631,11564,224689,486884
"2000","MISSOURI","STE. GENEVIEVE",3600,206,3505,7311
"2000","MISSOURI","STODDARD",4476,251,7727,12454
"2000","MISSOURI","STONE",4055,303,7793,12151
"2000","MISSOURI","SULLIVAN",1127,60,1877,3064
"2000","MISSOURI","TANEY",5092,373,9647,15112
"2000","MISSOURI","TEXAS",3486,310,6136,9932
"2000","MISSOURI","VERNON",3156,267,4985,8408
"2000","MISSOURI","WARREN",4524,237,5979,10740
"2000","MISSOURI","WASHINGTON",4047,198,4020,8265
"2000","MISSOURI","WAYNE",2387,115,3346,5848
"2000","MISSOURI","WEBSTER",4174,356,7350,11880
"2000","MISSOURI","WORTH",469,38,651,1158
"2000","MISSOURI","WRIGHT",2250,200,5391,7841
"2000","MONTANA","BEAVERHEAD",799,284,3113,4196
"2000","MONTANA","BIG HORN",2345,165,1651,4161
"2000","MONTANA","BLAINE",1246,103,1410,2759
"2000","MONTANA","BROADWATER",462,124,1488,2074
"2000","MONTANA","CARBON",1434,347,3008,4789
"2000","MONTANA","CARTER",53,19,573,645
"2000","MONTANA","CASCADE",13137,2016,18164,33317
"2000","MONTANA","CHOUTEAU",686,160,2039,2885
"2000","MONTANA","CUSTER",1501,248,3156,4905
"2000","MONTANA","DANIELS",303,57,750,1110
"2000","MONTANA","DAWSON",1364,184,2723,4271
"2000","MONTANA","DEER LODGE",2672,369,1493,4534
"2000","MONTANA","FALLON",256,52,1061,1369
"2000","MONTANA","FERGUS",1352,289,4353,5994
"2000","MONTANA","FLATHEAD",8329,2991,22519,33839
"2000","MONTANA","GALLATIN",10009,3198,18833,32040
"2000","MONTANA","GARFIELD",61,32,651,744
"2000","MONTANA","GLACIER",2211,204,1709,4124
"2000","MONTANA","GOLDEN VALLEY",88,38,405,531
"2000","MONTANA","GRANITE",295,114,1181,1590
"2000","MONTANA","HILL",2760,406,3392,6558
"2000","MONTANA","JEFFERSON",1513,342,3308,5163
"2000","MONTANA","JUDITH BASIN",278,59,1057,1394
"2000","MONTANA","LAKE",3884,1123,6441,11448
"2000","MONTANA","LEWIS AND CLARK",9982,2196,15091,27269
"2000","MONTANA","LIBERTY",243,49,752,1044
"2000","MONTANA","LINCOLN",1629,639,5578,7846
"2000","MONTANA","MADISON",758,242,2656,3656
"2000","MONTANA","MCCONE",267,48,827,1142
"2000","MONTANA","MEAGHER",176,61,698,935
"2000","MONTANA","MINERAL",382,179,1078,1639
"2000","MONTANA","MISSOULA",17241,7861,21474,46576
"2000","MONTANA","MUSSELSHELL",512,113,1582,2207
"2000","MONTANA","PARK",2154,729,4523,7406
"2000","MONTANA","PETROLEUM",36,16,254,306
"2000","MONTANA","PHILLIPS",423,78,1727,2228
"2000","MONTANA","PONDERA",792,156,1948,2896
"2000","MONTANA","POWDER RIVER",115,33,860,1008
"2000","MONTANA","POWELL",638,223,1971,2832
"2000","MONTANA","PRAIRIE",164,41,541,746
"2000","MONTANA","RAVALLI",4451,1546,11241,17238
"2000","MONTANA","RICHLAND",1018,157,2858,4033
"2000","MONTANA","ROOSEVELT",2059,149,1605,3813
"2000","MONTANA","ROSEBUD",1394,203,1826,3423
"2000","MONTANA","SANDERS",1165,412,3144,4721
"2000","MONTANA","SHERIDAN",702,87,1176,1965
"2000","MONTANA","SILVER BOW",8967,1437,6299,16703
"2000","MONTANA","STILLWATER",925,228,2765,3918
"2000","MONTANA","SWEET GRASS",305,91,1450,1846
"2000","MONTANA","TETON",847,173,2294,3314
"2000","MONTANA","TOOLE",630,109,1639,2378
"2000","MONTANA","TREASURE",106,29,344,479
"2000","MONTANA","VALLEY",1273,190,2500,3963
"2000","MONTANA","WHEATLAND",243,48,708,999
"2000","MONTANA","WIBAUX",121,28,369,518
"2000","MONTANA","YELLOWSTONE",20370,3207,33922,57499
"2000","NEBRASKA","ADAMS",3686,590,8162,12438
"2000","NEBRASKA","ANTELOPE",678,128,2562,3368
"2000","NEBRASKA","ARTHUR",26,11,235,272
"2000","NEBRASKA","BANNER",65,7,390,462
"2000","NEBRASKA","BLAINE",43,7,299,349
"2000","NEBRASKA","BOONE",575,91,2196,2862
"2000","NEBRASKA","BOX BUTTE",1614,267,3208,5089
"2000","NEBRASKA","BOYD",265,46,931,1242
"2000","NEBRASKA","BROWN",250,59,1375,1684
"2000","NEBRASKA","BUFFALO",3927,603,11931,16461
"2000","NEBRASKA","BURT",1223,113,2056,3392
"2000","NEBRASKA","BUTLER",1028,162,2638,3828
"2000","NEBRASKA","CASS",3656,480,6144,10280
"2000","NEBRASKA","CEDAR",1062,218,2989,4269
"2000","NEBRASKA","CHASE",306,64,1505,1875
"2000","NEBRASKA","CHERRY",446,79,2322,2847
"2000","NEBRASKA","CHEYENNE",844,135,3207,4186
"2000","NEBRASKA","CLAY",774,115,2326,3215
"2000","NEBRASKA","COLFAX",863,114,2338,3315
"2000","NEBRASKA","CUMING",857,126,3232,4215
"2000","NEBRASKA","CUSTER",976,193,4245,5414
"2000","NEBRASKA","DAKOTA",2695,247,3119,6061
"2000","NEBRASKA","DAWES",823,249,2549,3621
"2000","NEBRASKA","DAWSON",1740,256,5511,7507
"2000","NEBRASKA","DEUEL",213,37,783,1033
"2000","NEBRASKA","DIXON",820,138,1834,2792
"2000","NEBRASKA","DODGE",5021,580,8871,14472
"2000","NEBRASKA","DOUGLAS",73347,8784,101025,183156
"2000","NEBRASKA","DUNDY",179,31,801,1011
"2000","NEBRASKA","FILLMORE",848,126,2024,2998
"2000","NEBRASKA","FRANKLIN",420,52,1196,1668
"2000","NEBRASKA","FRONTIER",244,47,1102,1393
"2000","NEBRASKA","FURNAS",534,48,1849,2431
"2000","NEBRASKA","GAGE",3516,452,5538,9506
"2000","NEBRASKA","GARDEN",203,53,963,1219
"2000","NEBRASKA","GARFIELD",202,43,718,963
"2000","NEBRASKA","GOSPER",228,29,757,1014
"2000","NEBRASKA","GRANT",49,12,324,385
"2000","NEBRASKA","GREELEY",416,55,839,1310
"2000","NEBRASKA","HALL",5952,791,11803,18546
"2000","NEBRASKA","HAMILTON",1066,174,3251,4491
"2000","NEBRASKA","HARLAN",438,56,1358,1852
"2000","NEBRASKA","HAYES",66,19,486,571
"2000","NEBRASKA","HITCHCOCK",312,42,1126,1480
"2000","NEBRASKA","HOLT",846,159,3954,4959
"2000","NEBRASKA","HOOKER",74,18,317,409
"2000","NEBRASKA","HOWARD",955,112,1760,2827
"2000","NEBRASKA","JEFFERSON",1361,135,2351,3847
"2000","NEBRASKA","JOHNSON",794,108,1210,2112
"2000","NEBRASKA","KEARNEY",680,109,2333,3122
"2000","NEBRASKA","KEITH",778,118,2953,3849
"2000","NEBRASKA","KEYA PAHA",78,13,422,513
"2000","NEBRASKA","KIMBALL",379,62,1379,1820
"2000","NEBRASKA","KNOX",1037,157,2784,3978
"2000","NEBRASKA","LANCASTER",44650,6968,55514,107132
"2000","NEBRASKA","LINCOLN",5205,689,9220,15114
"2000","NEBRASKA","LOGAN",60,16,336,412
"2000","NEBRASKA","LOUP",84,10,284,378
"2000","NEBRASKA","MADISON",2772,445,9636,12853
"2000","NEBRASKA","MCPHERSON",48,9,244,301
"2000","NEBRASKA","MERRICK",848,112,2380,3340
"2000","NEBRASKA","MORRILL",460,81,1597,2138
"2000","NEBRASKA","NANCE",497,63,1105,1665
"2000","NEBRASKA","NEMAHA",1063,129,2177,3369
"2000","NEBRASKA","NUCKOLLS",644,98,1701,2443
"2000","NEBRASKA","OTOE",2208,276,4178,6662
"2000","NEBRASKA","PAWNEE",522,60,937,1519
"2000","NEBRASKA","PERKINS",243,39,1170,1452
"2000","NEBRASKA","PHELPS",934,118,3575,4627
"2000","NEBRASKA","PIERCE",570,104,2534,3208
"2000","NEBRASKA","PLATTE",2612,386,9861,12859
"2000","NEBRASKA","POLK",610,78,1925,2613
"2000","NEBRASKA","RED WILLOW",1188,157,3680,5025
"2000","NEBRASKA","RICHARDSON",1382,145,2623,4150
"2000","NEBRASKA","ROCK",141,28,725,894
"2000","NEBRASKA","SALINE",2321,243,2581,5145
"2000","NEBRASKA","SARPY",14637,1662,28979,45278
"2000","NEBRASKA","SAUNDERS",2852,379,5688,8919
"2000","NEBRASKA","SCOTTS BLUFF",3937,505,9397,13839
"2000","NEBRASKA","SEWARD",2250,309,4457,7016
"2000","NEBRASKA","SHERIDAN",392,79,2105,2576
"2000","NEBRASKA","SHERMAN",564,69,1072,1705
"2000","NEBRASKA","SIOUX",98,25,629,752
"2000","NEBRASKA","STANTON",500,91,1895,2486
"2000","NEBRASKA","THAYER",821,89,2096,3006
"2000","NEBRASKA","THOMAS",55,11,329,395
"2000","NEBRASKA","THURSTON",924,118,1040,2082
"2000","NEBRASKA","VALLEY",583,70,1610,2263
"2000","NEBRASKA","WASHINGTON",2550,318,5758,8626
"2000","NEBRASKA","WAYNE",1001,165,2774,3940
"2000","NEBRASKA","WEBSTER",584,59,1302,1945
"2000","NEBRASKA","WHEELER",85,17,351,453
"2000","NEBRASKA","YORK",1407,237,4816,6460
"2000","NEVADA","CARSON CITY",7354,1014,11084,19452
"2000","NEVADA","CHURCHILL",2191,395,6237,8823
"2000","NEVADA","CLARK",196100,15166,170932,382198
"2000","NEVADA","DOUGLAS",5837,944,11193,17974
"2000","NEVADA","ELKO",2542,613,11025,14180
"2000","NEVADA","ESMERALDA",116,42,333,491
"2000","NEVADA","EUREKA",150,55,632,837
"2000","NEVADA","HUMBOLDT",1128,264,3638,5030
"2000","NEVADA","LANDER",395,105,1619,2119
"2000","NEVADA","LINCOLN",461,123,1372,1956
"2000","NEVADA","LYON",3955,767,7270,11992
"2000","NEVADA","MINERAL",916,150,1227,2293
"2000","NEVADA","NYE",4525,752,6904,12181
"2000","NEVADA","PERSHING",476,105,1221,1802
"2000","NEVADA","STOREY",666,118,1014,1798
"2000","NEVADA","WASHOE",52097,6564,63640,122301
"2000","NEVADA","WHITE PINE",1069,240,2234,3543
"2000","NEW HAMPSHIRE","BELKNAP",10719,1277,14799,26795
"2000","NEW HAMPSHIRE","CARROLL",9852,1430,12597,23879
"2000","NEW HAMPSHIRE","CHESHIRE",17382,2220,13793,33395
"2000","NEW HAMPSHIRE","COOS",6570,701,7329,14600
"2000","NEW HAMPSHIRE","GRAFTON",18326,2315,18092,38733
"2000","NEW HAMPSHIRE","HILLSBOROUGH",77625,7487,80649,165761
"2000","NEW HAMPSHIRE","MERRIMACK",30622,3034,30028,63684
"2000","NEW HAMPSHIRE","ROCKINGHAM",61628,6685,65860,134173
"2000","NEW HAMPSHIRE","STRAFFORD",25400,2885,21108,49393
"2000","NEW HAMPSHIRE","SULLIVAN",8224,1140,9304,18668
"2000","NEW JERSEY","ATLANTIC",52880,2629,35593,91102
"2000","NEW JERSEY","BERGEN",202682,11308,152731,366721
"2000","NEW JERSEY","BURLINGTON",99506,5781,72254,177541
"2000","NEW JERSEY","CAMDEN",127166,7231,62464,196861
"2000","NEW JERSEY","CAPE MAY",22189,1611,23794,47594
"2000","NEW JERSEY","CUMBERLAND",28188,1614,18882,48684
"2000","NEW JERSEY","ESSEX",185505,7226,66842,259573
"2000","NEW JERSEY","GLOUCESTER",61095,3888,42315,107298
"2000","NEW JERSEY","HUDSON",118206,5351,43804,167361
"2000","NEW JERSEY","HUNTERDON",21387,2858,32210,56455
"2000","NEW JERSEY","MERCER",83256,5633,46670,135559
"2000","NEW JERSEY","MIDDLESEX",154998,10306,93545,258849
"2000","NEW JERSEY","MONMOUTH",131476,11374,119291,262141
"2000","NEW JERSEY","MORRIS",88039,7403,111066,206508
"2000","NEW JERSEY","OCEAN",102104,8605,105684,216393
"2000","NEW JERSEY","PASSAIC",90324,5206,61043,156573
"2000","NEW JERSEY","SALEM",13718,997,12257,26972
"2000","NEW JERSEY","SOMERSET",56232,4420,59725,120377
"2000","NEW JERSEY","SUSSEX",21353,2860,33277,57490
"2000","NEW JERSEY","UNION",112003,5816,68554,186373
"2000","NEW JERSEY","WARREN",16543,2086,22172,40801
"2000","NEW MEXICO","BERNALILLO",99461,9609,95249,204319
"2000","NEW MEXICO","CATRON",353,85,1273,1711
"2000","NEW MEXICO","CHAVES",6340,431,11378,18149
"2000","NEW MEXICO","CIBOLA",4127,209,2752,7088
"2000","NEW MEXICO","COLFAX",2653,208,2600,5461
"2000","NEW MEXICO","CURRY",3471,197,8301,11969
"2000","NEW MEXICO","DE BACA",349,21,612,982
"2000","NEW MEXICO","DONA ANA",23912,1478,21263,46653
"2000","NEW MEXICO","EDDY",7108,344,10335,17787
"2000","NEW MEXICO","GRANT",5673,607,4961,11241
"2000","NEW MEXICO","GUADALUPE",1076,27,548,1651
"2000","NEW MEXICO","HARDING",214,13,366,593
"2000","NEW MEXICO","HIDALGO",839,41,954,1834
"2000","NEW MEXICO","LEA",3855,244,10157,14256
"2000","NEW MEXICO","LINCOLN",2027,287,4458,6772
"2000","NEW MEXICO","LOS ALAMOS",4149,446,5623,10218
"2000","NEW MEXICO","LUNA",2975,242,3395,6612
"2000","NEW MEXICO","MCKINLEY",10281,528,5070,15879
"2000","NEW MEXICO","MORA",1456,67,668,2191
"2000","NEW MEXICO","OTERO",5465,481,10258,16204
"2000","NEW MEXICO","QUAY",1471,81,2292,3844
"2000","NEW MEXICO","RIO ARRIBA",8169,433,3495,12097
"2000","NEW MEXICO","ROOSEVELT",1762,127,3762,5651
"2000","NEW MEXICO","SAN JUAN",11980,1243,21434,34657
"2000","NEW MEXICO","SAN MIGUEL",6540,406,2215,9161
"2000","NEW MEXICO","SANDOVAL",14899,1433,15423,31755
"2000","NEW MEXICO","SANTA FE",32017,3480,13974,49471
"2000","NEW MEXICO","SIERRA",1689,176,2721,4586
"2000","NEW MEXICO","SOCORRO",3294,359,3173,6826
"2000","NEW MEXICO","TAOS",7039,1112,2744,10895
"2000","NEW MEXICO","TORRANCE",1868,201,2891,4960
"2000","NEW MEXICO","UNION",452,34,1269,1755
"2000","NEW MEXICO","VALENCIA",9819,755,10803,21377
"2000","NEW YORK","ALBANY",85617,8728,47624,141969
"2000","NEW YORK","ALLEGANY",6336,917,11436,18689
"2000","NEW YORK","BRONX",265801,6002,36245,308048
"2000","NEW YORK","BROOME",45381,4736,36946,87063
"2000","NEW YORK","CATTARAUGUS",13697,1654,18382,33733
"2000","NEW YORK","CAYUGA",17031,1959,14988,33978
"2000","NEW YORK","CHAUTAUQUA",27016,2640,29064,58720
"2000","NEW YORK","CHEMUNG",17424,1507,18779,37710
"2000","NEW YORK","CHENANGO",9112,1105,10033,20250
"2000","NEW YORK","CLINTON",15542,1739,13274,30555
"2000","NEW YORK","COLUMBIA",13489,2049,13153,28691
"2000","NEW YORK","CORTLAND",9691,1175,9857,20723
"2000","NEW YORK","DELAWARE",8450,1063,10662,20175
"2000","NEW YORK","DUTCHESS",52390,6703,52669,111762
"2000","NEW YORK","ERIE",240176,24302,160176,424654
"2000","NEW YORK","ESSEX",7927,1183,8822,17932
"2000","NEW YORK","FRANKLIN",8870,934,7643,17447
"2000","NEW YORK","FULTON",9314,923,11434,21671
"2000","NEW YORK","GENESEE",10191,1419,14459,26069
"2000","NEW YORK","GREENE",8480,1282,11332,21094
"2000","NEW YORK","HAMILTON",1114,180,2388,3682
"2000","NEW YORK","HERKIMER",12224,1334,14147,27705
"2000","NEW YORK","JEFFERSON",16799,1427,18192,36418
"2000","NEW YORK","KINGS",497468,23032,96605,617105
"2000","NEW YORK","LEWIS",4333,487,6103,10923
"2000","NEW YORK","LIVINGSTON",10476,1503,15244,27223
"2000","NEW YORK","MADISON",12017,1470,14879,28366
"2000","NEW YORK","MONROE",161743,14753,141266,317762
"2000","NEW YORK","MONTGOMERY",10249,795,9765,20809
"2000","NEW YORK","NASSAU",341610,21143,226954,589707
"2000","NEW YORK","NEW YORK",449300,34011,79921,563232
"2000","NEW YORK","NIAGARA",47781,4524,40952,93257
"2000","NEW YORK","ONEIDA",43933,4460,47603,95996
"2000","NEW YORK","ONONDAGA",109896,10055,83678,203629
"2000","NEW YORK","ONTARIO",19761,2302,23885,45948
"2000","NEW YORK","ORANGE",58170,5527,62852,126549
"2000","NEW YORK","ORLEANS",5991,650,9202,15843
"2000","NEW YORK","OSWEGO",22857,2367,23249,48473
"2000","NEW YORK","OTSEGO",11460,1679,12219,25358
"2000","NEW YORK","PUTNAM",18525,2169,21853,42547
"2000","NEW YORK","QUEENS",416967,16911,122052,555930
"2000","NEW YORK","RENSSELAER",34808,4066,29562,68436
"2000","NEW YORK","RICHMOND",73828,4390,63903,142121
"2000","NEW YORK","ROCKLAND",69530,4609,48441,122580
"2000","NEW YORK","SARATOGA",43359,5075,46623,95057
"2000","NEW YORK","SCHENECTADY",35534,3451,27961,66946
"2000","NEW YORK","SCHOHARIE",5390,699,7459,13548
"2000","NEW YORK","SCHUYLER",3301,471,4381,8153
"2000","NEW YORK","SENECA",6841,758,6734,14333
"2000","NEW YORK","ST. LAWRENCE",21386,1944,16449,39779
"2000","NEW YORK","STEUBEN",14600,1763,24200,40563
"2000","NEW YORK","SUFFOLK",306306,26568,240992,573866
"2000","NEW YORK","SULLIVAN",14348,1473,12703,28524
"2000","NEW YORK","TIOGA",9170,1045,12239,22454
"2000","NEW YORK","TOMPKINS",21807,4902,13351,40060
"2000","NEW YORK","ULSTER",38162,6616,33447,78225
"2000","NEW YORK","WARREN",12193,1435,14993,28621
"2000","NEW YORK","WASHINGTON",9641,1318,12596,23555
"2000","NEW YORK","WAYNE",14977,1651,21701,38329
"2000","NEW YORK","WESTCHESTER",218010,14487,139278,371775
"2000","NEW YORK","WYOMING",5935,883,10809,17627
"2000","NEW YORK","YATES",3962,525,5565,10052
"2000","NORTH CAROLINA","ALAMANCE",17459,327,29305,47091
"2000","NORTH CAROLINA","ALEXANDER",4166,84,9242,13492
"2000","NORTH CAROLINA","ALLEGHANY",1715,67,2531,4313
"2000","NORTH CAROLINA","ANSON",4792,32,3161,7985
"2000","NORTH CAROLINA","ASHE",4011,79,6226,10316
"2000","NORTH CAROLINA","AVERY",1686,52,4956,6694
"2000","NORTH CAROLINA","BEAUFORT",6634,148,10531,17313
"2000","NORTH CAROLINA","BERTIE",4660,28,2488,7176
"2000","NORTH CAROLINA","BLADEN",5889,42,4977,10908
"2000","NORTH CAROLINA","BRUNSWICK",13118,294,15427,28839
"2000","NORTH CAROLINA","BUNCOMBE",38545,830,46101,85476
"2000","NORTH CAROLINA","BURKE",11924,268,18466,30658
"2000","NORTH CAROLINA","CABARRUS",16284,393,32704,49381
"2000","NORTH CAROLINA","CALDWELL",8588,190,17337,26115
"2000","NORTH CAROLINA","CAMDEN",1187,16,1628,2831
"2000","NORTH CAROLINA","CARTERET",8839,241,17381,26461
"2000","NORTH CAROLINA","CASWELL",4091,61,4270,8422
"2000","NORTH CAROLINA","CATAWBA",16246,351,34244,50841
"2000","NORTH CAROLINA","CHATHAM",10461,222,10248,20931
"2000","NORTH CAROLINA","CHEROKEE",3239,130,6305,9674
"2000","NORTH CAROLINA","CHOWAN",2430,45,2415,4890
"2000","NORTH CAROLINA","CLAY",1361,75,2416,3852
"2000","NORTH CAROLINA","CLEVELAND",13455,227,19064,32746
"2000","NORTH CAROLINA","COLUMBUS",9986,97,8342,18425
"2000","NORTH CAROLINA","CRAVEN",12213,278,19494,31985
"2000","NORTH CAROLINA","CUMBERLAND",38626,396,38129,77151
"2000","NORTH CAROLINA","CURRITUCK",2595,49,4095,6739
"2000","NORTH CAROLINA","DARE",5589,112,7301,13002
"2000","NORTH CAROLINA","DAVIDSON",16199,461,35387,52047
"2000","NORTH CAROLINA","DAVIE",3651,163,10184,13998
"2000","NORTH CAROLINA","DUPLIN",6475,75,7840,14390
"2000","NORTH CAROLINA","DURHAM",53907,547,30150,84604
"2000","NORTH CAROLINA","EDGECOMBE",11315,51,6836,18202
"2000","NORTH CAROLINA","FORSYTH",52457,785,67700,120942
"2000","NORTH CAROLINA","FRANKLIN",7454,96,8501,16051
"2000","NORTH CAROLINA","GASTON",19281,445,39453,59179
"2000","NORTH CAROLINA","GATES",1944,22,1480,3446
"2000","NORTH CAROLINA","GRAHAM",1006,51,2304,3361
"2000","NORTH CAROLINA","GRANVILLE",7733,97,7364,15194
"2000","NORTH CAROLINA","GREENE",2478,39,3353,5870
"2000","NORTH CAROLINA","GUILFORD",80787,1083,84394,166264
"2000","NORTH CAROLINA","HALIFAX",10222,50,6698,16970
"2000","NORTH CAROLINA","HARNETT",9155,250,14762,24167
"2000","NORTH CAROLINA","HAYWOOD",9793,362,12118,22273
"2000","NORTH CAROLINA","HENDERSON",12562,357,25688,38607
"2000","NORTH CAROLINA","HERTFORD",5484,31,2382,7897
"2000","NORTH CAROLINA","HOKE",5017,126,3439,8582
"2000","NORTH CAROLINA","HYDE",1088,17,1132,2237
"2000","NORTH CAROLINA","IREDELL",15434,299,29853,45586
"2000","NORTH CAROLINA","JACKSON",5722,162,6237,12121
"2000","NORTH CAROLINA","JOHNSTON",13704,239,27212,41155
"2000","NORTH CAROLINA","JONES",1822,28,2114,3964
"2000","NORTH CAROLINA","LEE",6785,92,9406,16283
"2000","NORTH CAROLINA","LENOIR",9527,124,11512,21163
"2000","NORTH CAROLINA","LINCOLN",8412,166,15951,24529
"2000","NORTH CAROLINA","MACON",4683,145,8406,13234
"2000","NORTH CAROLINA","MADISON",3505,144,4676,8325
"2000","NORTH CAROLINA","MARTIN",4929,17,4420,9366
"2000","NORTH CAROLINA","MCDOWELL",4747,155,9109,14011
"2000","NORTH CAROLINA","MECKLENBURG",126911,2057,134068,263036
"2000","NORTH CAROLINA","MITCHELL",1535,81,4984,6600
"2000","NORTH CAROLINA","MONTGOMERY",3979,49,4946,8974
"2000","NORTH CAROLINA","MOORE",11232,187,19882,31301
"2000","NORTH CAROLINA","NASH",12376,142,17995,30513
"2000","NORTH CAROLINA","NEW HANOVER",29292,524,36503,66319
"2000","NORTH CAROLINA","NORTHAMPTON",5513,20,2667,8200
"2000","NORTH CAROLINA","ONSLOW",10269,289,19657,30215
"2000","NORTH CAROLINA","ORANGE",30921,493,17930,49344
"2000","NORTH CAROLINA","PAMLICO",2188,55,2999,5242
"2000","NORTH CAROLINA","PASQUOTANK",5874,86,4943,10903
"2000","NORTH CAROLINA","PENDER",6415,78,7661,14154
"2000","NORTH CAROLINA","PERQUIMANS",2033,43,2230,4306
"2000","NORTH CAROLINA","PERSON",5042,69,6722,11833
"2000","NORTH CAROLINA","PITT",19685,198,23192,43075
"2000","NORTH CAROLINA","POLK",3114,115,5074,8303
"2000","NORTH CAROLINA","RANDOLPH",11366,371,30959,42696
"2000","NORTH CAROLINA","RICHMOND",7935,71,6263,14269
"2000","NORTH CAROLINA","ROBESON",17834,192,11721,29747
"2000","NORTH CAROLINA","ROCKINGHAM",13260,289,18979,32528
"2000","NORTH CAROLINA","ROWAN",14891,320,28922,44133
"2000","NORTH CAROLINA","RUTHERFORD",7697,264,13755,21716
"2000","NORTH CAROLINA","SAMPSON",8768,61,10410,19239
"2000","NORTH CAROLINA","SCOTLAND",5627,36,3740,9403
"2000","NORTH CAROLINA","STANLY",7066,204,15548,22818
"2000","NORTH CAROLINA","STOKES",5030,124,12028,17182
"2000","NORTH CAROLINA","SURRY",7757,200,15401,23358
"2000","NORTH CAROLINA","SWAIN",2097,49,2224,4370
"2000","NORTH CAROLINA","TRANSYLVANIA",5044,170,9011,14225
"2000","NORTH CAROLINA","TYRRELL",849,11,706,1566
"2000","NORTH CAROLINA","UNION",14890,395,31876,47161
"2000","NORTH CAROLINA","VANCE",7092,45,5564,12701
"2000","NORTH CAROLINA","WAKE",123466,2260,142494,268220
"2000","NORTH CAROLINA","WARREN",4576,17,2202,6795
"2000","NORTH CAROLINA","WASHINGTON",2704,17,2169,4890
"2000","NORTH CAROLINA","WATAUGA",7959,326,10438,18723
"2000","NORTH CAROLINA","WAYNE",13005,121,20758,33884
"2000","NORTH CAROLINA","WILKES",7226,271,16826,24323
"2000","NORTH CAROLINA","WILSON",11266,94,13466,24826
"2000","NORTH CAROLINA","YADKIN",3127,120,10435,13682
"2000","NORTH CAROLINA","YANCEY",3714,80,4970,8764
"2000","NORTH DAKOTA","ADAMS",286,48,826,1160
"2000","NORTH DAKOTA","BARNES",1933,363,3452,5748
"2000","NORTH DAKOTA","BENSON",952,147,1055,2154
"2000","NORTH DAKOTA","BILLINGS",82,49,394,525
"2000","NORTH DAKOTA","BOTTINEAU",1173,168,2349,3690
"2000","NORTH DAKOTA","BOWMAN",330,61,1080,1471
"2000","NORTH DAKOTA","BURKE",296,45,698,1039
"2000","NORTH DAKOTA","BURLEIGH",9842,2173,22467,34482
"2000","NORTH DAKOTA","CASS",21451,4008,33536,58995
"2000","NORTH DAKOTA","CAVALIER",618,240,1513,2371
"2000","NORTH DAKOTA","DICKEY",806,127,1853,2786
"2000","NORTH DAKOTA","DIVIDE",306,45,443,794
"2000","NORTH DAKOTA","DUNN",474,130,1124,1728
"2000","NORTH DAKOTA","EDDY",458,107,703,1268
"2000","NORTH DAKOTA","EMMONS",405,157,1430,1992
"2000","NORTH DAKOTA","FOSTER",474,97,1172,1743
"2000","NORTH DAKOTA","GOLDEN VALLEY",156,45,611,812
"2000","NORTH DAKOTA","GRAND FORKS",10593,1917,15875,28385
"2000","NORTH DAKOTA","GRANT",235,115,1077,1427
"2000","NORTH DAKOTA","GRIGGS",484,65,920,1469
"2000","NORTH DAKOTA","HETTINGER",353,109,1057,1519
"2000","NORTH DAKOTA","KIDDER",283,156,837,1276
"2000","NORTH DAKOTA","LAMOURE",689,189,1590,2468
"2000","NORTH DAKOTA","LOGAN",223,110,812,1145
"2000","NORTH DAKOTA","MCHENRY",888,167,1682,2737
"2000","NORTH DAKOTA","MCINTOSH",350,109,1178,1637
"2000","NORTH DAKOTA","MCKENZIE",653,77,1634,2364
"2000","NORTH DAKOTA","MCLEAN",1465,290,2891,4646
"2000","NORTH DAKOTA","MERCER",1011,358,2984,4353
"2000","NORTH DAKOTA","MORTON",3439,791,6993,11223
"2000","NORTH DAKOTA","MOUNTRAIL",1256,174,1466,2896
"2000","NORTH DAKOTA","NELSON",687,122,1031,1840
"2000","NORTH DAKOTA","OLIVER",244,98,709,1051
"2000","NORTH DAKOTA","PEMBINA",1093,256,2430,3779
"2000","NORTH DAKOTA","PIERCE",500,123,1348,1971
"2000","NORTH DAKOTA","RAMSEY",1658,314,3005,4977
"2000","NORTH DAKOTA","RANSOM",1080,151,1488,2719
"2000","NORTH DAKOTA","RENVILLE",443,69,820,1332
"2000","NORTH DAKOTA","RICHLAND",2490,526,4999,8015
"2000","NORTH DAKOTA","ROLETTE",2681,301,1416,4398
"2000","NORTH DAKOTA","SARGENT",959,122,1103,2184
"2000","NORTH DAKOTA","SHERIDAN",161,60,707,928
"2000","NORTH DAKOTA","SIOUX",724,48,269,1041
"2000","NORTH DAKOTA","SLOPE",85,41,316,442
"2000","NORTH DAKOTA","STARK",2784,606,6387,9777
"2000","NORTH DAKOTA","STEELE",475,80,655,1210
"2000","NORTH DAKOTA","STUTSMAN",3067,563,5488,9118
"2000","NORTH DAKOTA","TOWNER",410,85,694,1189
"2000","NORTH DAKOTA","TRAILL",1512,208,2392,4112
"2000","NORTH DAKOTA","WALSH",1743,340,3099,5182
"2000","NORTH DAKOTA","WARD",7533,952,13997,22482
"2000","NORTH DAKOTA","WELLS",661,139,1610,2410
"2000","NORTH DAKOTA","WILLIAMS",2330,290,5187,7807
"2000","OHIO","ADAMS",3581,274,6380,10235
"2000","OHIO","ALLEN",13996,1152,28647,43795
"2000","OHIO","ASHLAND",6685,1040,13533,21258
"2000","OHIO","ASHTABULA",19831,1701,17940,39472
"2000","OHIO","ATHENS",13158,2586,9703,25447
"2000","OHIO","AUGLAIZE",5564,558,13770,19892
"2000","OHIO","BELMONT",15980,1536,12625,30141
"2000","OHIO","BROWN",5972,430,10027,16429
"2000","OHIO","BUTLER",46390,3760,86587,136737
"2000","OHIO","CARROLL",4960,569,6732,12261
"2000","OHIO","CHAMPAIGN",5955,505,9220,15680
"2000","OHIO","CLARK",27984,1915,27660,57559
"2000","OHIO","CLERMONT",20927,1821,47129,69877
"2000","OHIO","CLINTON",4791,455,9824,15070
"2000","OHIO","COLUMBIANA",20657,1966,21804,44427
"2000","OHIO","COSHOCTON",5594,431,8243,14268
"2000","OHIO","CRAWFORD",6721,789,11666,19176
"2000","OHIO","CUYAHOGA",359913,22770,192099,574782
"2000","OHIO","DARKE",7741,709,14817,23267
"2000","OHIO","DEFIANCE",6175,527,9540,16242
"2000","OHIO","DELAWARE",17134,1630,36639,55403
"2000","OHIO","ERIE",17732,1178,16105,35015
"2000","OHIO","FAIRFIELD",19065,1506,33523,54094
"2000","OHIO","FAYETTE",3363,230,5685,9278
"2000","OHIO","FRANKLIN",202018,14194,197862,414074
"2000","OHIO","FULTON",6805,545,11546,18896
"2000","OHIO","GALLIA",4872,393,7511,12776
"2000","OHIO","GEAUGA",15327,1856,25417,42600
"2000","OHIO","GREENE",25059,2199,37946,65204
"2000","OHIO","GUERNSEY",6643,606,8181,15430
"2000","OHIO","HAMILTON",161578,12146,204175,377899
"2000","OHIO","HANCOCK",8798,834,20985,30617
"2000","OHIO","HARDIN",4557,387,7124,12068
"2000","OHIO","HARRISON",3351,393,3417,7161
"2000","OHIO","HENRY",4367,355,8530,13252
"2000","OHIO","HIGHLAND",5328,391,9728,15447
"2000","OHIO","HOCKING",4474,580,5702,10756
"2000","OHIO","HOLMES",2066,325,6754,9145
"2000","OHIO","HURON",8183,891,12286,21360
"2000","OHIO","JACKSON",5131,401,6958,12490
"2000","OHIO","JEFFERSON",17488,2110,15038,34636
"2000","OHIO","KNOX",7133,734,13393,21260
"2000","OHIO","LAKE",46497,4320,51747,102564
"2000","OHIO","LAWRENCE",11307,614,12531,24452
"2000","OHIO","LICKING",23196,2090,37180,62466
"2000","OHIO","LOGAN",5945,661,11849,18455
"2000","OHIO","LORAIN",59809,4414,47957,112180
"2000","OHIO","LUCAS",108344,5664,73342,187350
"2000","OHIO","MADISON",5287,488,8892,14667
"2000","OHIO","MAHONING",69212,4447,40460,114119
"2000","OHIO","MARION",10370,828,13617,24815
"2000","OHIO","MEDINA",26635,2899,37349,66883
"2000","OHIO","MEIGS",3674,371,5750,9795
"2000","OHIO","MERCER",5212,597,12485,18294
"2000","OHIO","MIAMI",15584,1220,26037,42841
"2000","OHIO","MONROE",3605,365,3145,7115
"2000","OHIO","MONTGOMERY",114597,6598,109792,230987
"2000","OHIO","MORGAN",2261,281,3451,5993
"2000","OHIO","MORROW",4529,468,7842,12839
"2000","OHIO","MUSKINGUM",13415,1214,17995,32624
"2000","OHIO","NOBLE",2296,257,3435,5988
"2000","OHIO","OTTAWA",9485,566,9917,19968
"2000","OHIO","PAULDING",3384,352,5210,8946
"2000","OHIO","PERRY",5895,493,6440,12828
"2000","OHIO","PICKAWAY",6598,425,10717,17740
"2000","OHIO","PIKE",4923,304,5333,10560
"2000","OHIO","PORTAGE",31446,3182,28271,62899
"2000","OHIO","PREBLE",6375,615,11176,18166
"2000","OHIO","PUTNAM",4063,444,12837,17344
"2000","OHIO","RICHLAND",20572,2069,30138,52779
"2000","OHIO","ROSS",11662,648,13706,26016
"2000","OHIO","SANDUSKY",11146,899,13699,25744
"2000","OHIO","SCIOTO",13997,926,15022,29945
"2000","OHIO","SENECA",9512,976,13863,24351
"2000","OHIO","SHELBY",6593,601,12476,19670
"2000","OHIO","STARK",75308,6383,78153,159844
"2000","OHIO","SUMMIT",119759,8359,96721,224839
"2000","OHIO","TRUMBULL",57643,3942,34654,96239
"2000","OHIO","TUSCARAWAS",15879,1690,19549,37118
"2000","OHIO","UNION",5040,482,11502,17024
"2000","OHIO","VAN WERT",4209,331,8679,13219
"2000","OHIO","VINTON",2037,189,2720,4946
"2000","OHIO","WARREN",19142,1618,48318,69078
"2000","OHIO","WASHINGTON",10383,790,15342,26515
"2000","OHIO","WAYNE",14779,1756,25901,42436
"2000","OHIO","WILLIAMS",5454,524,9941,15919
"2000","OHIO","WOOD",22687,2003,27504,52194
"2000","OHIO","WYANDOT",3397,317,6113,9827
"2000","OKLAHOMA","ADAIR",2361,113,3503,5977
"2000","OKLAHOMA","ALFALFA",583,38,1886,2507
"2000","OKLAHOMA","ATOKA",1906,43,2375,4324
"2000","OKLAHOMA","BEAVER",339,25,2092,2456
"2000","OKLAHOMA","BECKHAM",2408,57,4067,6532
"2000","OKLAHOMA","BLAINE",1402,59,2633,4094
"2000","OKLAHOMA","BRYAN",5554,108,6084,11746
"2000","OKLAHOMA","CADDO",4272,103,4835,9210
"2000","OKLAHOMA","CANADIAN",8367,314,22679,31360
"2000","OKLAHOMA","CARTER",6659,132,9667,16458
"2000","OKLAHOMA","CHEROKEE",7256,294,6918,14468
"2000","OKLAHOMA","CHOCTAW",2799,55,2461,5315
"2000","OKLAHOMA","CIMARRON",227,27,1230,1484
"2000","OKLAHOMA","CLEVELAND",27792,986,47393,76171
"2000","OKLAHOMA","COAL",1148,18,1196,2362
"2000","OKLAHOMA","COMANCHE",11971,259,17103,29333
"2000","OKLAHOMA","COTTON",1068,26,1388,2482
"2000","OKLAHOMA","CRAIG",2568,101,2815,5484
"2000","OKLAHOMA","CREEK",9753,408,13580,23741
"2000","OKLAHOMA","CUSTER",3115,101,6527,9743
"2000","OKLAHOMA","DELAWARE",5514,221,7618,13353
"2000","OKLAHOMA","DEWEY",599,14,1607,2220
"2000","OKLAHOMA","ELLIS",468,32,1513,2013
"2000","OKLAHOMA","GARFIELD",6543,238,14902,21683
"2000","OKLAHOMA","GARVIN",4189,118,5536,9843
"2000","OKLAHOMA","GRADY",6037,199,10040,16276
"2000","OKLAHOMA","GRANT",709,32,1762,2503
"2000","OKLAHOMA","GREER",839,26,1287,2152
"2000","OKLAHOMA","HARMON",507,6,692,1205
"2000","OKLAHOMA","HARPER",374,13,1296,1683
"2000","OKLAHOMA","HASKELL",2510,79,2039,4628
"2000","OKLAHOMA","HUGHES",2334,55,2196,4585
"2000","OKLAHOMA","JACKSON",2515,53,5591,8159
"2000","OKLAHOMA","JEFFERSON",1245,28,1320,2593
"2000","OKLAHOMA","JOHNSTON",1809,49,2072,3930
"2000","OKLAHOMA","KAY",6122,272,11768,18162
"2000","OKLAHOMA","KINGFISHER",1304,59,4693,6056
"2000","OKLAHOMA","KIOWA",1544,33,2173,3750
"2000","OKLAHOMA","LATIMER",1865,65,1739,3669
"2000","OKLAHOMA","LE FLORE",6536,234,8215,14985
"2000","OKLAHOMA","LINCOLN",4140,174,7387,11701
"2000","OKLAHOMA","LOGAN",4510,173,8187,12870
"2000","OKLAHOMA","LOVE",1530,35,1807,3372
"2000","OKLAHOMA","MAJOR",635,45,2672,3352
"2000","OKLAHOMA","MARSHALL",2210,49,2641,4900
"2000","OKLAHOMA","MAYES",6618,251,7132,14001
"2000","OKLAHOMA","MCCLAIN",3679,110,6750,10539
"2000","OKLAHOMA","MCCURTAIN",3752,129,6601,10482
"2000","OKLAHOMA","MCINTOSH",4206,131,3444,7781
"2000","OKLAHOMA","MURRAY",2263,50,2609,4922
"2000","OKLAHOMA","MUSKOGEE",12520,353,11820,24693
"2000","OKLAHOMA","NOBLE",1416,51,3230,4697
"2000","OKLAHOMA","NOWATA",1703,77,2069,3849
"2000","OKLAHOMA","OKFUSKEE",1814,64,1910,3788
"2000","OKLAHOMA","OKLAHOMA",81590,2443,139078,223111
"2000","OKLAHOMA","OKMULGEE",7186,195,5797,13178
"2000","OKLAHOMA","OSAGE",7540,231,8138,15909
"2000","OKLAHOMA","OTTAWA",5647,139,5625,11411
"2000","OKLAHOMA","PAWNEE",2435,104,3386,5925
"2000","OKLAHOMA","PAYNE",9319,372,15256,24947
"2000","OKLAHOMA","PITTSBURG",7627,216,8514,16357
"2000","OKLAHOMA","PONTOTOC",5387,150,7299,12836
"2000","OKLAHOMA","POTTAWATOMIE",8763,318,13235,22316
"2000","OKLAHOMA","PUSHMATAHA",1969,48,2331,4348
"2000","OKLAHOMA","ROGER MILLS",441,12,1234,1687
"2000","OKLAHOMA","ROGERS",10813,425,17713,28951
"2000","OKLAHOMA","SEMINOLE",3783,72,4011,7866
"2000","OKLAHOMA","SEQUOYAH",5425,215,6614,12254
"2000","OKLAHOMA","STEPHENS",6467,161,10860,17488
"2000","OKLAHOMA","TEXAS",1084,40,4964,6088
"2000","OKLAHOMA","TILLMAN",1400,29,1920,3349
"2000","OKLAHOMA","TULSA",81656,2883,134152,218691
"2000","OKLAHOMA","WAGONER",8244,292,12981,21517
"2000","OKLAHOMA","WASHINGTON",6644,312,13788,20744
"2000","OKLAHOMA","WASHITA",1564,54,2850,4468
"2000","OKLAHOMA","WOODS",1235,37,2774,4046
"2000","OKLAHOMA","WOODWARD",1950,83,5067,7100
"2000","OREGON","BAKER",2195,445,5618,8258
"2000","OREGON","BENTON",19444,2957,15825,38226
"2000","OREGON","CLACKAMAS",76421,8302,77539,162262
"2000","OREGON","CLATSOP",8296,1228,6950,16474
"2000","OREGON","COLUMBIA",10331,1495,9369,21195
"2000","OREGON","COOS",11610,2143,15626,29379
"2000","OREGON","CROOK",2474,440,5363,8277
"2000","OREGON","CURRY",4090,872,6551,11513
"2000","OREGON","DESCHUTES",22061,3692,32132,57885
"2000","OREGON","DOUGLAS",14193,2733,30294,47220
"2000","OREGON","GILLIAM",359,52,679,1090
"2000","OREGON","GRANT",589,179,3078,3846
"2000","OREGON","HARNEY",766,169,2799,3734
"2000","OREGON","HOOD RIVER",4072,756,3721,8549
"2000","OREGON","JACKSON",33153,5591,46052,84796
"2000","OREGON","JEFFERSON",2681,378,3838,6897
"2000","OREGON","JOSEPHINE",11864,2683,22186,36733
"2000","OREGON","KLAMATH",7541,1448,18855,27844
"2000","OREGON","LAKE",707,192,2830,3729
"2000","OREGON","LANE",78583,12027,61578,152188
"2000","OREGON","LINCOLN",10861,1811,8446,21118
"2000","OREGON","LINN",16682,2347,25359,44388
"2000","OREGON","MALHEUR",2336,444,7624,10404
"2000","OREGON","MARION",49430,6461,57443,113334
"2000","OREGON","MORROW",1197,188,2224,3609
"2000","OREGON","MULTNOMAH",188441,24567,83677,296685
"2000","OREGON","POLK",11921,1540,14988,28449
"2000","OREGON","SHERMAN",326,57,679,1062
"2000","OREGON","TILLAMOOK",5762,839,5775,12376
"2000","OREGON","UMATILLA",7809,1111,14140,23060
"2000","OREGON","UNION",3577,663,7836,12076
"2000","OREGON","WALLOWA",836,179,3279,4294
"2000","OREGON","WASCO",4616,692,5356,10664
"2000","OREGON","WASHINGTON",90662,9221,86091,185974
"2000","OREGON","WHEELER",202,55,584,841
"2000","OREGON","YAMHILL",14254,2092,19193,35539
"2000","PENNSYLVANIA","ADAMS",11682,903,20848,33433
"2000","PENNSYLVANIA","ALLEGHENY",329963,17154,235361,582478
"2000","PENNSYLVANIA","ARMSTRONG",11127,788,15508,27423
"2000","PENNSYLVANIA","BEAVER",38925,2177,32491,73593
"2000","PENNSYLVANIA","BEDFORD",5474,363,13598,19435
"2000","PENNSYLVANIA","BERKS",59150,4740,71273,135163
"2000","PENNSYLVANIA","BLAIR",15774,990,28376,45140
"2000","PENNSYLVANIA","BRADFORD",7911,759,14660,23330
"2000","PENNSYLVANIA","BUCKS",132914,8581,121927,263422
"2000","PENNSYLVANIA","BUTLER",25037,1778,44009,70824
"2000","PENNSYLVANIA","CAMBRIA",30308,1977,28001,60286
"2000","PENNSYLVANIA","CAMERON",779,84,1383,2246
"2000","PENNSYLVANIA","CARBON",10668,892,9717,21277
"2000","PENNSYLVANIA","CENTRE",21409,1957,26172,49538
"2000","PENNSYLVANIA","CHESTER",82047,5435,100080,187562
"2000","PENNSYLVANIA","CLARION",5605,442,9796,15843
"2000","PENNSYLVANIA","CLEARFIELD",11718,872,18019,30609
"2000","PENNSYLVANIA","CLINTON",5521,409,6064,11994
"2000","PENNSYLVANIA","COLUMBIA",8975,824,12095,21894
"2000","PENNSYLVANIA","CRAWFORD",13250,1213,18858,33321
"2000","PENNSYLVANIA","CUMBERLAND",31053,2207,54802,88062
"2000","PENNSYLVANIA","DAUPHIN",44390,2637,53631,100658
"2000","PENNSYLVANIA","DELAWARE",134861,7380,105836,248077
"2000","PENNSYLVANIA","ELK",5754,477,7347,13578
"2000","PENNSYLVANIA","ERIE",59399,3909,49027,112335
"2000","PENNSYLVANIA","FAYETTE",28152,1367,20013,49532
"2000","PENNSYLVANIA","FOREST",843,69,1371,2283
"2000","PENNSYLVANIA","FRANKLIN",14922,1005,33042,48969
"2000","PENNSYLVANIA","FULTON",1425,107,3753,5285
"2000","PENNSYLVANIA","GREENE",7230,514,5890,13634
"2000","PENNSYLVANIA","HUNTINGDON",5073,476,10408,15957
"2000","PENNSYLVANIA","INDIANA",13667,935,16799,31401
"2000","PENNSYLVANIA","JEFFERSON",5566,535,11473,17574
"2000","PENNSYLVANIA","JUNIATA",2656,216,5795,8667
"2000","PENNSYLVANIA","LACKAWANNA",57471,3814,35096,96381
"2000","PENNSYLVANIA","LANCASTER",54968,4449,115900,175317
"2000","PENNSYLVANIA","LAWRENCE",20593,987,18060,39640
"2000","PENNSYLVANIA","LEBANON",16093,1253,28534,45880
"2000","PENNSYLVANIA","LEHIGH",56667,4121,55492,116280
"2000","PENNSYLVANIA","LUZERNE",62199,5059,52328,119586
"2000","PENNSYLVANIA","LYCOMING",14663,1383,27137,43183
"2000","PENNSYLVANIA","MCKEAN",5510,633,9661,15804
"2000","PENNSYLVANIA","MERCER",23817,1776,23132,48725
"2000","PENNSYLVANIA","MIFFLIN",4835,379,9400,14614
"2000","PENNSYLVANIA","MONROE",21939,1674,23265,46878
"2000","PENNSYLVANIA","MONTGOMERY",177990,8809,145623,332422
"2000","PENNSYLVANIA","MONTOUR",2356,176,3960,6492
"2000","PENNSYLVANIA","NORTHAMPTON",53097,4197,47396,104690
"2000","PENNSYLVANIA","NORTHUMBERLAND",13670,1439,18142,33251
"2000","PENNSYLVANIA","PERRY",4459,428,11184,16071
"2000","PENNSYLVANIA","PHILADELPHIA",449182,11039,100959,561180
"2000","PENNSYLVANIA","PIKE",7330,695,9339,17364
"2000","PENNSYLVANIA","POTTER",2037,195,4858,7090
"2000","PENNSYLVANIA","SCHUYLKILL",26215,2244,29841,58300
"2000","PENNSYLVANIA","SNYDER",3536,342,8963,12841
"2000","PENNSYLVANIA","SOMERSET",12028,739,20218,32985
"2000","PENNSYLVANIA","SULLIVAN",1066,111,1928,3105
"2000","PENNSYLVANIA","SUSQUEHANNA",6481,564,10226,17271
"2000","PENNSYLVANIA","TIOGA",4617,520,9635,14772
"2000","PENNSYLVANIA","UNION",4209,443,8523,13175
"2000","PENNSYLVANIA","VENANGO",8196,685,11642,20523
"2000","PENNSYLVANIA","WARREN",7537,714,9290,17541
"2000","PENNSYLVANIA","WASHINGTON",44961,2141,37339,84441
"2000","PENNSYLVANIA","WAYNE",6904,809,11201,18914
"2000","PENNSYLVANIA","WESTMORELAND",71792,4059,80858,156709
"2000","PENNSYLVANIA","WYOMING",4363,408,6922,11693
"2000","PENNSYLVANIA","YORK",51958,4634,87652,144244
"2000","RHODE ISLAND","BRISTOL",13424,1473,8375,23272
"2000","RHODE ISLAND","FEDERAL PRECINCT",0,0,0,0
"2000","RHODE ISLAND","KENT",43265,4914,25291,73470
"2000","RHODE ISLAND","NEWPORT",20790,2790,14258,37838
"2000","RHODE ISLAND","PROVIDENCE",142469,14461,61378,218308
"2000","RHODE ISLAND","WASHINGTON",29560,5411,21253,56224
"2000","SOUTH CAROLINA","ABBEVILLE",3766,158,4450,8374
"2000","SOUTH CAROLINA","AIKEN",16409,1170,33203,50782
"2000","SOUTH CAROLINA","ALLENDALE",2338,35,967,3340
"2000","SOUTH CAROLINA","ANDERSON",19606,1248,35827,56681
"2000","SOUTH CAROLINA","BAMBERG",3451,53,2047,5551
"2000","SOUTH CAROLINA","BARNWELL",3661,94,4521,8276
"2000","SOUTH CAROLINA","BEAUFORT",17487,1100,25561,44148
"2000","SOUTH CAROLINA","BERKELEY",17707,813,24796,43316
"2000","SOUTH CAROLINA","CALHOUN",3063,94,3216,6373
"2000","SOUTH CAROLINA","CHARLESTON",49520,3727,58229,111476
"2000","SOUTH CAROLINA","CHEROKEE",6138,285,9900,16323
"2000","SOUTH CAROLINA","CHESTER",5242,204,4986,10432
"2000","SOUTH CAROLINA","CHESTERFIELD",6111,149,6266,12526
"2000","SOUTH CAROLINA","CLARENDON",5999,105,5186,11290
"2000","SOUTH CAROLINA","COLLETON",6449,174,6767,13390
"2000","SOUTH CAROLINA","DARLINGTON",10253,320,11290,21863
"2000","SOUTH CAROLINA","DILLON",4930,85,3975,8990
"2000","SOUTH CAROLINA","DORCHESTER",12168,739,20734,33641
"2000","SOUTH CAROLINA","EDGEFIELD",3950,124,4760,8834
"2000","SOUTH CAROLINA","FAIRFIELD",5263,124,3011,8398
"2000","SOUTH CAROLINA","FLORENCE",17157,602,23678,41437
"2000","SOUTH CAROLINA","GEORGETOWN",9445,371,10535,20351
"2000","SOUTH CAROLINA","GREENVILLE",43810,3769,92714,140293
"2000","SOUTH CAROLINA","GREENWOOD",8139,528,12193,20860
"2000","SOUTH CAROLINA","HAMPTON",4896,65,2798,7759
"2000","SOUTH CAROLINA","HORRY",29113,1852,40300,71265
"2000","SOUTH CAROLINA","JASPER",3646,409,2414,6469
"2000","SOUTH CAROLINA","KERSHAW",7428,338,11911,19677
"2000","SOUTH CAROLINA","LANCASTER",8782,247,11676,20705
"2000","SOUTH CAROLINA","LAURENS",7920,388,12102,20410
"2000","SOUTH CAROLINA","LEE",3899,68,2675,6642
"2000","SOUTH CAROLINA","LEXINGTON",22830,2156,58095,83081
"2000","SOUTH CAROLINA","MARION",7358,104,4687,12149
"2000","SOUTH CAROLINA","MARLBORO",5060,124,2699,7883
"2000","SOUTH CAROLINA","MCCORMICK",1896,61,1704,3661
"2000","SOUTH CAROLINA","NEWBERRY",4428,452,7492,12372
"2000","SOUTH CAROLINA","OCONEE",7571,640,15364,23575
"2000","SOUTH CAROLINA","ORANGEBURG",19802,275,12657,32734
"2000","SOUTH CAROLINA","PICKENS",8927,974,24681,34582
"2000","SOUTH CAROLINA","RICHLAND",63179,3138,50164,116481
"2000","SOUTH CAROLINA","SALUDA",2682,111,4098,6891
"2000","SOUTH CAROLINA","SPARTANBURG",29559,1880,52114,83553
"2000","SOUTH CAROLINA","SUMTER",14365,392,15915,30672
"2000","SOUTH CAROLINA","UNION",4662,159,5768,10589
"2000","SOUTH CAROLINA","WILLIAMSBURG",6723,84,4524,11331
"2000","SOUTH CAROLINA","YORK",19251,1324,33776,54351
"2000","SOUTH DAKOTA","AURORA",513,53,847,1413
"2000","SOUTH DAKOTA","BEADLE",3216,176,4347,7739
"2000","SOUTH DAKOTA","BENNETT",377,27,712,1116
"2000","SOUTH DAKOTA","BON HOMME",1162,76,1901,3139
"2000","SOUTH DAKOTA","BROOKINGS",4546,226,6212,10984
"2000","SOUTH DAKOTA","BROWN",7173,323,9060,16556
"2000","SOUTH DAKOTA","BRULE",818,81,1268,2167
"2000","SOUTH DAKOTA","BUFFALO",256,12,140,408
"2000","SOUTH DAKOTA","BUTTE",840,89,2760,3689
"2000","SOUTH DAKOTA","CAMPBELL",147,31,739,917
"2000","SOUTH DAKOTA","CHARLES MIX",1300,74,2205,3579
"2000","SOUTH DAKOTA","CLARK",791,45,1272,2108
"2000","SOUTH DAKOTA","CLAY",2638,104,2363,5105
"2000","SOUTH DAKOTA","CODINGTON",4192,228,6718,11138
"2000","SOUTH DAKOTA","CORSON",549,65,629,1243
"2000","SOUTH DAKOTA","CUSTER",955,123,2495,3573
"2000","SOUTH DAKOTA","DAVISON",2936,147,4445,7528
"2000","SOUTH DAKOTA","DAY",1492,82,1623,3197
"2000","SOUTH DAKOTA","DEUEL",926,53,1245,2224
"2000","SOUTH DAKOTA","DEWEY",880,40,761,1681
"2000","SOUTH DAKOTA","DOUGLAS",363,35,1311,1709
"2000","SOUTH DAKOTA","EDMUNDS",676,53,1257,1986
"2000","SOUTH DAKOTA","FALL RIVER",1133,111,2185,3429
"2000","SOUTH DAKOTA","FAULK",388,37,904,1329
"2000","SOUTH DAKOTA","GRANT",1475,120,2235,3830
"2000","SOUTH DAKOTA","GREGORY",718,52,1487,2257
"2000","SOUTH DAKOTA","HAAKON",164,27,938,1129
"2000","SOUTH DAKOTA","HAMLIN",923,69,1731,2723
"2000","SOUTH DAKOTA","HAND",565,47,1419,2031
"2000","SOUTH DAKOTA","HANSON",457,20,944,1421
"2000","SOUTH DAKOTA","HARDING",64,17,650,731
"2000","SOUTH DAKOTA","HUGHES",2212,134,5188,7534
"2000","SOUTH DAKOTA","HUTCHINSON",1052,76,2497,3625
"2000","SOUTH DAKOTA","HYDE",218,25,592,835
"2000","SOUTH DAKOTA","JACKSON",319,34,687,1040
"2000","SOUTH DAKOTA","JERAULD",468,30,624,1122
"2000","SOUTH DAKOTA","JONES",137,18,509,664
"2000","SOUTH DAKOTA","KINGSBURY",1049,66,1612,2727
"2000","SOUTH DAKOTA","LAKE",2331,99,2724,5154
"2000","SOUTH DAKOTA","LAWRENCE",2797,282,6327,9406
"2000","SOUTH DAKOTA","LINCOLN",3844,166,6546,10556
"2000","SOUTH DAKOTA","LYMAN",482,29,875,1386
"2000","SOUTH DAKOTA","MARSHALL",939,43,1097,2079
"2000","SOUTH DAKOTA","MCCOOK",965,56,1610,2631
"2000","SOUTH DAKOTA","MCPHERSON",295,49,1073,1417
"2000","SOUTH DAKOTA","MEADE",2267,229,6870,9366
"2000","SOUTH DAKOTA","MELLETTE",222,16,495,733
"2000","SOUTH DAKOTA","MINER",523,19,724,1266
"2000","SOUTH DAKOTA","MINNEHAHA",27042,899,33428,61369
"2000","SOUTH DAKOTA","MOODY",1318,56,1361,2735
"2000","SOUTH DAKOTA","PENNINGTON",11123,738,24696,36557
"2000","SOUTH DAKOTA","PERKINS",297,80,1237,1614
"2000","SOUTH DAKOTA","POTTER",356,26,1112,1494
"2000","SOUTH DAKOTA","ROBERTS",1700,137,2237,4074
"2000","SOUTH DAKOTA","SANBORN",468,33,767,1268
"2000","SOUTH DAKOTA","SHANNON",1667,34,252,1953
"2000","SOUTH DAKOTA","SPINK",1274,53,1957,3284
"2000","SOUTH DAKOTA","STANLEY",402,24,955,1381
"2000","SOUTH DAKOTA","SULLY",209,29,633,871
"2000","SOUTH DAKOTA","TODD",993,23,478,1494
"2000","SOUTH DAKOTA","TRIPP",799,57,1909,2765
"2000","SOUTH DAKOTA","TURNER",1414,76,2514,4004
"2000","SOUTH DAKOTA","UNION",2358,149,3265,5772
"2000","SOUTH DAKOTA","WALWORTH",721,74,1758,2553
"2000","SOUTH DAKOTA","YANKTON",3596,240,4904,8740
"2000","SOUTH DAKOTA","ZIEBACH",314,23,384,721
"2000","TENNESSEE","ANDERSON",13556,535,14688,28779
"2000","TENNESSEE","BEDFORD",6136,160,5911,12207
"2000","TENNESSEE","BENTON",3700,127,2484,6311
"2000","TENNESSEE","BLEDSOE",1756,60,2380,4196
"2000","TENNESSEE","BLOUNT",14688,701,25273,40662
"2000","TENNESSEE","BRADLEY",8768,508,20167,29443
"2000","TENNESSEE","CAMPBELL",6492,145,5784,12421
"2000","TENNESSEE","CANNON",2697,76,1924,4697
"2000","TENNESSEE","CARROLL",5239,123,5465,10827
"2000","TENNESSEE","CARTER",6724,267,12111,19102
"2000","TENNESSEE","CHEATHAM",6062,198,6356,12616
"2000","TENNESSEE","CHESTER",2192,49,3487,5728
"2000","TENNESSEE","CLAIBORNE",3841,136,5023,9000
"2000","TENNESSEE","CLAY",1931,43,1468,3442
"2000","TENNESSEE","COCKE",3872,182,6185,10239
"2000","TENNESSEE","COFFEE",8741,259,8788,17788
"2000","TENNESSEE","CROCKETT",2705,59,2676,5440
"2000","TENNESSEE","CUMBERLAND",7644,379,10994,19017
"2000","TENNESSEE","DAVIDSON",120508,3963,84117,208588
"2000","TENNESSEE","DECATUR",2278,46,2046,4370
"2000","TENNESSEE","DEKALB",3765,89,2411,6265
"2000","TENNESSEE","DICKSON",8332,208,7016,15556
"2000","TENNESSEE","DYER",5425,134,6282,11841
"2000","TENNESSEE","FAYETTE",5037,90,6402,11529
"2000","TENNESSEE","FENTRESS",2529,83,3417,6029
"2000","TENNESSEE","FRANKLIN",7828,303,6560,14691
"2000","TENNESSEE","GIBSON",8663,188,8286,17137
"2000","TENNESSEE","GILES",5527,162,4377,10066
"2000","TENNESSEE","GRAINGER",2361,87,3746,6194
"2000","TENNESSEE","GREENE",7909,367,12540,20816
"2000","TENNESSEE","GRUNDY",2970,73,1553,4596
"2000","TENNESSEE","HAMBLEN",7564,311,11824,19699
"2000","TENNESSEE","HAMILTON",51708,2066,66605,120379
"2000","TENNESSEE","HANCOCK",690,42,1343,2075
"2000","TENNESSEE","HARDEMAN",4953,121,3729,8803
"2000","TENNESSEE","HARDIN",3735,96,4951,8782
"2000","TENNESSEE","HAWKINS",6753,274,10071,17098
"2000","TENNESSEE","HAYWOOD",3887,37,2554,6478
"2000","TENNESSEE","HENDERSON",3166,80,5153,8399
"2000","TENNESSEE","HENRY",6093,272,5944,12309
"2000","TENNESSEE","HICKMAN",4239,111,2914,7264
"2000","TENNESSEE","HOUSTON",2081,53,993,3127
"2000","TENNESSEE","HUMPHREYS",4205,89,2387,6681
"2000","TENNESSEE","JACKSON",3304,66,1384,4754
"2000","TENNESSEE","JEFFERSON",5226,204,8657,14087
"2000","TENNESSEE","JOHNSON",1813,104,3740,5657
"2000","TENNESSEE","KNOX",60969,2766,86851,150586
"2000","TENNESSEE","LAKE",1419,24,781,2224
"2000","TENNESSEE","LAUDERDALE",4224,65,3329,7618
"2000","TENNESSEE","LAWRENCE",6643,214,7613,14470
"2000","TENNESSEE","LEWIS",2281,102,2037,4420
"2000","TENNESSEE","LINCOLN",5060,164,5435,10659
"2000","TENNESSEE","LOUDON",5905,235,10266,16406
"2000","TENNESSEE","MACON",3059,66,3366,6491
"2000","TENNESSEE","MADISON",15781,287,17862,33930
"2000","TENNESSEE","MARION",5441,158,4651,10250
"2000","TENNESSEE","MARSHALL",5107,147,4105,9359
"2000","TENNESSEE","MAURY",11127,343,11930,23400
"2000","TENNESSEE","MCMINN",6142,303,10155,16600
"2000","TENNESSEE","MCNAIRY",4003,89,4897,8989
"2000","TENNESSEE","MEIGS",1555,38,1797,3390
"2000","TENNESSEE","MONROE",5327,162,7514,13003
"2000","TENNESSEE","MONTGOMERY",18818,582,19644,39044
"2000","TENNESSEE","MOORE",1107,49,1145,2301
"2000","TENNESSEE","MORGAN",2921,97,3144,6162
"2000","TENNESSEE","OBION",6056,216,6168,12440
"2000","TENNESSEE","OVERTON",4507,114,2875,7496
"2000","TENNESSEE","PERRY",1650,51,1165,2866
"2000","TENNESSEE","PICKETT",939,19,1281,2239
"2000","TENNESSEE","POLK",2574,113,2907,5594
"2000","TENNESSEE","PUTNAM",10785,405,11248,22438
"2000","TENNESSEE","RHEA",3722,150,5900,9772
"2000","TENNESSEE","ROANE",9575,406,11345,21326
"2000","TENNESSEE","ROBERTSON",10249,240,9675,20164
"2000","TENNESSEE","RUTHERFORD",27360,1377,33445,62182
"2000","TENNESSEE","SCOTT",2967,69,3579,6615
"2000","TENNESSEE","SEQUATCHIE",1648,70,2169,3887
"2000","TENNESSEE","SEVIER",8208,423,16734,25365
"2000","TENNESSEE","SHELBY",190404,4595,141756,336755
"2000","TENNESSEE","SMITH",4884,80,2384,7348
"2000","TENNESSEE","STEWART",2870,86,1826,4782
"2000","TENNESSEE","SULLIVAN",21354,891,33482,55727
"2000","TENNESSEE","SUMNER",22118,758,27601,50477
"2000","TENNESSEE","TIPTON",6300,182,10070,16552
"2000","TENNESSEE","TROUSDALE",1966,29,950,2945
"2000","TENNESSEE","UNICOI",2566,83,3780,6429
"2000","TENNESSEE","UNION",2564,58,3199,5821
"2000","TENNESSEE","VAN BUREN",1255,31,845,2131
"2000","TENNESSEE","WARREN",7378,201,5552,13131
"2000","TENNESSEE","WASHINGTON",14769,594,22579,37942
"2000","TENNESSEE","WAYNE",1859,77,3370,5306
"2000","TENNESSEE","WEAKLEY",5570,168,6106,11844
"2000","TENNESSEE","WHITE",4135,115,3525,7775
"2000","TENNESSEE","WILLIAMSON",18745,783,38901,58429
"2000","TENNESSEE","WILSON",16561,511,18844,35916
"2000","TEXAS","ANDERSON",5041,204,9835,15080
"2000","TEXAS","ANDREWS",876,57,3091,4024
"2000","TEXAS","ANGELINA",9957,369,16648,26974
"2000","TEXAS","ARANSAS",2637,220,5390,8247
"2000","TEXAS","ARCHER",993,53,2951,3997
"2000","TEXAS","ARMSTRONG",150,16,772,938
"2000","TEXAS","ATASCOSA",4322,193,6231,10746
"2000","TEXAS","AUSTIN",2407,159,6661,9227
"2000","TEXAS","BAILEY",488,13,1589,2090
"2000","TEXAS","BANDERA",1426,234,5613,7273
"2000","TEXAS","BASTROP",6973,1025,10310,18308
"2000","TEXAS","BAYLOR",663,36,1285,1984
"2000","TEXAS","BEE",3795,106,4429,8330
"2000","TEXAS","BELL",21011,1072,41208,63291
"2000","TEXAS","BEXAR",185158,11955,215613,412726
"2000","TEXAS","BLANCO",811,179,2777,3767
"2000","TEXAS","BORDEN",62,8,283,353
"2000","TEXAS","BOSQUE",1930,95,4745,6770
"2000","TEXAS","BOWIE",11662,333,18325,30320
"2000","TEXAS","BRAZORIA",24883,1691,53445,80019
"2000","TEXAS","BRAZOS",12359,1718,32864,46941
"2000","TEXAS","BREWSTER",1349,364,1867,3580
"2000","TEXAS","BRISCOE",224,4,544,772
"2000","TEXAS","BROOKS",1854,21,556,2431
"2000","TEXAS","BROWN",3138,173,9609,12920
"2000","TEXAS","BURLESON",2235,89,3542,5866
"2000","TEXAS","BURNET",3557,389,9286,13232
"2000","TEXAS","CALDWELL",3872,337,5216,9425
"2000","TEXAS","CALHOUN",2766,73,3724,6563
"2000","TEXAS","CALLAHAN",1174,66,3656,4896
"2000","TEXAS","CAMERON",33214,1043,27800,62057
"2000","TEXAS","CAMP",1625,38,2121,3784
"2000","TEXAS","CARSON",480,46,2216,2742
"2000","TEXAS","CASS",4618,106,6295,11019
"2000","TEXAS","CASTRO",727,20,1607,2354
"2000","TEXAS","CHAMBERS",2888,149,6769,9806
"2000","TEXAS","CHEROKEE",4755,183,9599,14537
"2000","TEXAS","CHILDRESS",602,18,1506,2126
"2000","TEXAS","CLAY",1460,65,3112,4637
"2000","TEXAS","COCHRAN",344,20,807,1171
"2000","TEXAS","COKE",355,23,1137,1515
"2000","TEXAS","COLEMAN",853,38,2687,3578
"2000","TEXAS","COLLIN",42884,4357,128179,175420
"2000","TEXAS","COLLINGSWORTH",429,12,974,1415
"2000","TEXAS","COLORADO",2229,107,4913,7249
"2000","TEXAS","COMAL",7131,1018,24599,32748
"2000","TEXAS","COMANCHE",1636,52,3334,5022
"2000","TEXAS","CONCHO",268,17,818,1103
"2000","TEXAS","COOKE",3153,188,10128,13469
"2000","TEXAS","CORYELL",4493,273,10321,15087
"2000","TEXAS","COTTLE",241,14,502,757
"2000","TEXAS","CRANE",387,21,1246,1654
"2000","TEXAS","CROCKETT",467,7,924,1398
"2000","TEXAS","CROSBY",705,27,1270,2002
"2000","TEXAS","CULBERSON",577,22,413,1012
"2000","TEXAS","DALLAM",341,18,1385,1744
"2000","TEXAS","DALLAS",275308,15386,322345,613039
"2000","TEXAS","DAWSON",1463,39,3337,4839
"2000","TEXAS","DEAF SMITH",1240,57,3687,4984
"2000","TEXAS","DELTA",726,31,1143,1900
"2000","TEXAS","DENTON",40144,4475,102171,146790
"2000","TEXAS","DEWITT",1570,72,4541,6183
"2000","TEXAS","DICKENS",284,8,589,881
"2000","TEXAS","DIMMIT",2678,43,1032,3753
"2000","TEXAS","DONLEY",360,26,1333,1719
"2000","TEXAS","DUVAL",3990,30,1010,5030
"2000","TEXAS","EASTLAND",1774,109,4531,6414
"2000","TEXAS","ECTOR",9425,583,22893,32901
"2000","TEXAS","EDWARDS",261,13,663,937
"2000","TEXAS","EL PASO",83848,3620,57574,145042
"2000","TEXAS","ELLIS",10629,587,26091,37307
"2000","TEXAS","ERATH",2804,185,8126,11115
"2000","TEXAS","FALLS",2417,59,3239,5715
"2000","TEXAS","FANNIN",4102,164,6074,10340
"2000","TEXAS","FAYETTE",2542,187,6658,9387
"2000","TEXAS","FISHER",884,20,968,1872
"2000","TEXAS","FLOYD",580,10,1830,2420
"2000","TEXAS","FOARD",263,7,286,556
"2000","TEXAS","FORT BEND",47569,2373,73567,123509
"2000","TEXAS","FRANKLIN",1018,34,2420,3472
"2000","TEXAS","FREESTONE",2316,78,4247,6641
"2000","TEXAS","FRIO",2317,37,1774,4128
"2000","TEXAS","GAINES",723,45,2691,3459
"2000","TEXAS","GALVESTON",40020,2566,50397,92983
"2000","TEXAS","GARZA",454,14,1302,1770
"2000","TEXAS","GILLESPIE",1511,313,8096,9920
"2000","TEXAS","GLASSCOCK",39,4,528,571
"2000","TEXAS","GOLIAD",1233,51,2108,3392
"2000","TEXAS","GONZALES",1877,100,4092,6069
"2000","TEXAS","GRAY",1376,77,6732,8185
"2000","TEXAS","GRAYSON",13647,697,25596,39940
"2000","TEXAS","GREGG",11244,450,26739,38433
"2000","TEXAS","GRIMES",2450,155,4197,6802
"2000","TEXAS","GUADALUPE",8311,757,21499,30567
"2000","TEXAS","HALE",2158,84,6868,9110
"2000","TEXAS","HALL",472,8,966,1446
"2000","TEXAS","HAMILTON",878,51,2447,3376
"2000","TEXAS","HANSFORD",198,16,1874,2088
"2000","TEXAS","HARDEMAN",566,15,976,1557
"2000","TEXAS","HARDIN",5595,279,11962,17836
"2000","TEXAS","HARRIS",418267,27396,529159,974822
"2000","TEXAS","HARRISON",8878,258,13834,22970
"2000","TEXAS","HARTLEY",359,27,1645,2031
"2000","TEXAS","HASKELL",1401,38,1488,2927
"2000","TEXAS","HAYS",11387,2760,20170,34317
"2000","TEXAS","HEMPHILL",251,20,1203,1474
"2000","TEXAS","HENDERSON",8704,316,16607,25627
"2000","TEXAS","HIDALGO",61390,1359,38301,101050
"2000","TEXAS","HILL",3524,157,7054,10735
"2000","TEXAS","HOCKLEY",1419,76,5250,6745
"2000","TEXAS","HOOD",4704,372,12429,17505
"2000","TEXAS","HOPKINS",3692,142,7076,10910
"2000","TEXAS","HOUSTON",2833,95,5308,8236
"2000","TEXAS","HOWARD",2744,136,6668,9548
"2000","TEXAS","HUDSPETH",380,28,514,922
"2000","TEXAS","HUNT",7857,432,16177,24466
"2000","TEXAS","HUTCHINSON",1796,112,7443,9351
"2000","TEXAS","IRION",162,7,624,793
"2000","TEXAS","JACK",822,45,2107,2974
"2000","TEXAS","JACKSON",1446,45,3365,4856
"2000","TEXAS","JASPER",4533,138,7071,11742
"2000","TEXAS","JEFF DAVIS",283,69,708,1060
"2000","TEXAS","JEFFERSON",45409,1180,40320,86909
"2000","TEXAS","JIM HOGG",1512,22,623,2157
"2000","TEXAS","JIM WELLS",7418,107,4498,12023
"2000","TEXAS","JOHNSON",11778,746,26202,38726
"2000","TEXAS","JONES",1899,69,4080,6048
"2000","TEXAS","KARNES",1617,53,2638,4308
"2000","TEXAS","KAUFMAN",7455,318,15290,23063
"2000","TEXAS","KENDALL",1901,384,8788,11073
"2000","TEXAS","KENEDY",119,3,106,228
"2000","TEXAS","KENT",185,5,346,536
"2000","TEXAS","KERR",4002,589,14637,19228
"2000","TEXAS","KIMBLE",328,25,1313,1666
"2000","TEXAS","KING",14,3,120,137
"2000","TEXAS","KINNEY",486,26,932,1444
"2000","TEXAS","KLEBERG",4481,187,4526,9194
"2000","TEXAS","KNOX",617,12,947,1576
"2000","TEXAS","LA SALLE",1266,17,731,2014
"2000","TEXAS","LAMAR",5553,102,9775,15430
"2000","TEXAS","LAMB",1114,33,3451,4598
"2000","TEXAS","LAMPASAS",1569,119,4526,6214
"2000","TEXAS","LAVACA",2171,87,5288,7546
"2000","TEXAS","LEE",1733,104,3699,5536
"2000","TEXAS","LEON",1893,71,4362,6326
"2000","TEXAS","LIBERTY",7311,308,12458,20077
"2000","TEXAS","LIMESTONE",2768,95,4212,7075
"2000","TEXAS","LIPSCOMB",206,16,1072,1294
"2000","TEXAS","LIVE OAK",1114,62,2828,4004
"2000","TEXAS","LLANO",2143,189,6295,8627
"2000","TEXAS","LOVING",29,3,124,156
"2000","TEXAS","LUBBOCK",18469,1485,56054,76008
"2000","TEXAS","LYNN",562,15,1507,2084
"2000","TEXAS","MADISON",1241,49,2333,3623
"2000","TEXAS","MARION",1852,39,2039,3930
"2000","TEXAS","MARTIN",415,14,1520,1949
"2000","TEXAS","MASON",417,32,1352,1801
"2000","TEXAS","MATAGORDA",4696,179,7584,12459
"2000","TEXAS","MAVERICK",5995,91,3143,9229
"2000","TEXAS","MCCULLOCH",794,42,2084,2920
"2000","TEXAS","MCLENNAN",23462,1372,43955,68789
"2000","TEXAS","MCMULLEN",77,4,358,439
"2000","TEXAS","MEDINA",4025,258,8590,12873
"2000","TEXAS","MENARD",334,14,642,990
"2000","TEXAS","MIDLAND",7534,692,31514,39740
"2000","TEXAS","MILAM",3429,134,4706,8269
"2000","TEXAS","MILLS",548,28,1738,2314
"2000","TEXAS","MITCHELL",837,29,1708,2574
"2000","TEXAS","MONTAGUE",2256,123,4951,7330
"2000","TEXAS","MONTGOMERY",23286,2327,80600,106213
"2000","TEXAS","MOORE",1040,49,4201,5290
"2000","TEXAS","MORRIS",2455,53,2381,4889
"2000","TEXAS","MOTLEY",118,10,514,642
"2000","TEXAS","NACOGDOCHES",6204,450,13145,19799
"2000","TEXAS","NAVARRO",5366,166,8358,13890
"2000","TEXAS","NEWTON",2503,64,2423,4990
"2000","TEXAS","NOLAN",1874,101,3337,5312
"2000","TEXAS","NUECES",45349,2071,49906,97326
"2000","TEXAS","OCHILTREE",251,24,2687,2962
"2000","TEXAS","OLDHAM",108,7,659,774
"2000","TEXAS","ORANGE",11887,442,17325,29654
"2000","TEXAS","PALO PINTO",3263,165,5690,9118
"2000","TEXAS","PANOLA",3011,88,5975,9074
"2000","TEXAS","PARKER",8878,696,23651,33225
"2000","TEXAS","PARMER",447,23,2274,2744
"2000","TEXAS","PECOS",1539,64,2700,4303
"2000","TEXAS","POLK",6877,371,11746,18994
"2000","TEXAS","POTTER",7242,505,17629,25376
"2000","TEXAS","PRESIDIO",1064,75,618,1757
"2000","TEXAS","RAINS",1225,59,2049,3333
"2000","TEXAS","RANDALL",7209,660,33921,41790
"2000","TEXAS","REAGAN",282,14,959,1255
"2000","TEXAS","REAL",316,28,1146,1490
"2000","TEXAS","RED RIVER",2219,42,2941,5202
"2000","TEXAS","REEVES",1872,31,1273,3176
"2000","TEXAS","REFUGIO",1172,28,1721,2921
"2000","TEXAS","ROBERTS",72,5,472,549
"2000","TEXAS","ROBERTSON",3283,79,3007,6369
"2000","TEXAS","ROCKWALL",3642,344,13666,17652
"2000","TEXAS","RUNNELS",969,57,3020,4046
"2000","TEXAS","RUSK",4841,181,11611,16633
"2000","TEXAS","SABINE",1753,74,2764,4591
"2000","TEXAS","SAN AUGUSTINE",1636,53,2116,3805
"2000","TEXAS","SAN JACINTO",2946,145,4623,7714
"2000","TEXAS","SAN PATRICIO",7840,260,10599,18699
"2000","TEXAS","SAN SABA",618,24,1691,2333
"2000","TEXAS","SCHLEICHER",338,9,826,1173
"2000","TEXAS","SCURRY",1193,73,4060,5326
"2000","TEXAS","SHACKELFORD",264,17,1066,1347
"2000","TEXAS","SHELBY",3227,86,5692,9005
"2000","TEXAS","SHERMAN",144,21,998,1163
"2000","TEXAS","SMITH",16470,834,43320,60624
"2000","TEXAS","SOMERVELL",752,46,2120,2918
"2000","TEXAS","STARR",6505,48,1911,8464
"2000","TEXAS","STEPHENS",811,55,2425,3291
"2000","TEXAS","STERLING",132,7,520,659
"2000","TEXAS","STONEWALL",294,9,496,799
"2000","TEXAS","SUTTON",468,9,1063,1540
"2000","TEXAS","SWISHER",856,33,1612,2501
"2000","TEXAS","TARRANT",173758,11710,286921,472389
"2000","TEXAS","TAYLOR",10504,815,31701,43020
"2000","TEXAS","TERRELL",219,15,243,477
"2000","TEXAS","TERRY",1108,36,2910,4054
"2000","TEXAS","THROCKMORTON",228,6,608,842
"2000","TEXAS","TITUS",3008,100,4995,8103
"2000","TEXAS","TOM GREEN",9288,605,24733,34626
"2000","TEXAS","TRAVIS",125526,34502,141235,301263
"2000","TEXAS","TRINITY",2142,62,3093,5297
"2000","TEXAS","TYLER",2775,105,4236,7116
"2000","TEXAS","UPSHUR",4180,180,8448,12808
"2000","TEXAS","UPTON",266,25,982,1273
"2000","TEXAS","UVALDE",3436,129,4855,8420
"2000","TEXAS","VAL VERDE",5056,195,6223,11474
"2000","TEXAS","VAN ZANDT",5245,263,12383,17891
"2000","TEXAS","VICTORIA",8176,445,18787,27408
"2000","TEXAS","WALKER",4943,355,9076,14374
"2000","TEXAS","WALLER",5046,126,5686,10858
"2000","TEXAS","WARD",1256,84,2534,3874
"2000","TEXAS","WASHINGTON",2996,168,8645,11809
"2000","TEXAS","WEBB",18120,375,13076,31571
"2000","TEXAS","WHARTON",4838,133,8455,13426
"2000","TEXAS","WHEELER",579,23,1787,2389
"2000","TEXAS","WICHITA",14108,803,27802,42713
"2000","TEXAS","WILBARGER",1356,83,3138,4577
"2000","TEXAS","WILLACY",3218,55,1789,5062
"2000","TEXAS","WILLIAMSON",26591,4303,65041,95935
"2000","TEXAS","WILSON",3997,192,7509,11698
"2000","TEXAS","WINKLER",556,19,1468,2043
"2000","TEXAS","WISE",4830,304,11234,16368
"2000","TEXAS","WOOD",3893,181,9810,13884
"2000","TEXAS","YOAKUM",531,23,1911,2465
"2000","TEXAS","YOUNG",1843,89,5022,6954
"2000","TEXAS","ZAPATA",1638,25,953,2616
"2000","TEXAS","ZAVALA",2616,24,751,3391
"2000","UTAH","BEAVER",541,58,1653,2252
"2000","UTAH","BOX ELDER",2555,640,12288,15483
"2000","UTAH","CACHE",5170,2052,25920,33142
"2000","UTAH","CARBON",3298,328,3758,7384
"2000","UTAH","DAGGETT",104,14,317,435
"2000","UTAH","DAVIS",18845,4635,64375,87855
"2000","UTAH","DUCHESNE",779,145,3622,4546
"2000","UTAH","EMERY",958,197,3243,4398
"2000","UTAH","GARFIELD",178,71,1719,1968
"2000","UTAH","GRAND",1158,634,1822,3614
"2000","UTAH","IRON",1789,699,10106,12594
"2000","UTAH","JUAB",619,143,2023,2785
"2000","UTAH","KANE",387,161,2254,2802
"2000","UTAH","MILLARD",696,229,3850,4775
"2000","UTAH","MORGAN",553,154,2464,3171
"2000","UTAH","PIUTE",133,22,626,781
"2000","UTAH","RICH",152,15,736,903
"2000","UTAH","SALT LAKE",107576,28097,171585,307258
"2000","UTAH","SAN JUAN",1838,185,2721,4744
"2000","UTAH","SANPETE",1211,438,5781,7430
"2000","UTAH","SEVIER",1046,268,5763,7077
"2000","UTAH","SUMMIT",4601,1352,6168,12121
"2000","UTAH","TOOELE",4001,672,7807,12480
"2000","UTAH","UINTAH",1387,277,6733,8397
"2000","UTAH","UTAH",16445,5556,98255,120256
"2000","UTAH","WASATCH",1476,380,3819,5675
"2000","UTAH","WASHINGTON",5465,1515,25481,32461
"2000","UTAH","WAYNE",202,70,953,1225
"2000","UTAH","WEBER",19890,3598,39254,62742
"2000","VERMONT","ADDISON",8936,1538,6953,17427
"2000","VERMONT","BENNINGTON",9021,1372,7284,17677
"2000","VERMONT","CALEDONIA",5859,1036,6746,13641
"2000","VERMONT","CHITTENDEN",39156,6756,26105,72017
"2000","VERMONT","ESSEX",1129,199,1564,2892
"2000","VERMONT","FRANKLIN",9514,1285,8395,19194
"2000","VERMONT","GRAND ISLE",1835,253,1550,3638
"2000","VERMONT","LAMOILLE",5676,1114,4456,11246
"2000","VERMONT","ORANGE",6694,1143,6858,14695
"2000","VERMONT","ORLEANS",5472,861,5799,12132
"2000","VERMONT","RUTLAND",13990,1826,13546,29362
"2000","VERMONT","WASHINGTON",15281,3020,11448,29749
"2000","VERMONT","WINDHAM",11319,2814,7358,21491
"2000","VERMONT","WINDSOR",15140,2294,11713,29147
"2000","VIRGINIA","ACCOMACK",5092,481,6352,11925
"2000","VIRGINIA","ALBEMARLE",16255,2300,18291,36846
"2000","VIRGINIA","ALEXANDRIA",33633,2523,19043,55199
"2000","VIRGINIA","ALLEGHANY",2214,101,2808,5123
"2000","VIRGINIA","AMELIA",1754,87,2947,4788
"2000","VIRGINIA","AMHERST",4812,240,6660,11712
"2000","VIRGINIA","APPOMATTOX",2132,141,3654,5927
"2000","VIRGINIA","ARLINGTON",50260,4744,28555,83559
"2000","VIRGINIA","AUGUSTA",6643,884,17744,25271
"2000","VIRGINIA","BATH",822,77,1311,2210
"2000","VIRGINIA","BEDFORD",9238,859,18493,28590
"2000","VIRGINIA","BLAND",851,78,1759,2688
"2000","VIRGINIA","BOTETOURT",4627,346,8867,13840
"2000","VIRGINIA","BRISTOL",2646,138,3495,6279
"2000","VIRGINIA","BRUNSWICK",3387,49,2561,5997
"2000","VIRGINIA","BUCHANAN",5745,244,3867,9856
"2000","VIRGINIA","BUCKINGHAM",2561,155,2738,5454
"2000","VIRGINIA","BUENA VISTA",941,54,980,1975
"2000","VIRGINIA","CAMPBELL",6659,506,13162,20327
"2000","VIRGINIA","CAROLINE",4314,164,3873,8351
"2000","VIRGINIA","CARROLL",3638,221,7142,11001
"2000","VIRGINIA","CHARLES CITY",1981,62,1023,3066
"2000","VIRGINIA","CHARLOTTE",2017,122,2855,4994
"2000","VIRGINIA","CHARLOTTESVILLE",7762,1428,4034,13224
"2000","VIRGINIA","CHESAPEAKE",33578,1323,39684,74585
"2000","VIRGINIA","CHESTERFIELD",38638,2389,69924,110951
"2000","VIRGINIA","CLARKE",2166,235,2883,5284
"2000","VIRGINIA","COLONIAL HEIGHTS",2100,163,5519,7782
"2000","VIRGINIA","COVINGTON",1168,80,966,2214
"2000","VIRGINIA","CRAIG",851,62,1580,2493
"2000","VIRGINIA","CULPEPER",4364,440,7440,12244
"2000","VIRGINIA","CUMBERLAND",1405,128,1974,3507
"2000","VIRGINIA","DANVILLE",8221,659,9427,18307
"2000","VIRGINIA","DICKENSON",3951,153,3122,7226
"2000","VIRGINIA","DINWIDDIE",4001,176,4959,9136
"2000","VIRGINIA","EMPORIA",1116,26,938,2080
"2000","VIRGINIA","ESSEX",1750,86,1995,3831
"2000","VIRGINIA","FAIRFAX",200862,15526,206943,423331
"2000","VIRGINIA","FALLS CHURCH",3109,353,2131,5593
"2000","VIRGINIA","FAUQUIER",8296,729,14456,23481
"2000","VIRGINIA","FLOYD",1957,359,3423,5739
"2000","VIRGINIA","FLUVANNA",3431,313,4962,8706
"2000","VIRGINIA","FRANKLIN",8908,494,12618,22020
"2000","VIRGINIA","FREDERICK",7158,660,14574,22392
"2000","VIRGINIA","FREDERICKSBURG",3360,386,2935,6681
"2000","VIRGINIA","GALAX",996,57,1160,2213
"2000","VIRGINIA","GILES",3004,242,3574,6820
"2000","VIRGINIA","GLOUCESTER",4553,428,8718,13699
"2000","VIRGINIA","GOOCHLAND",3197,202,5378,8777
"2000","VIRGINIA","GRAYSON",2467,149,4236,6852
"2000","VIRGINIA","GREENE",1774,263,3375,5412
"2000","VIRGINIA","GREENSVILLE",2314,27,1565,3906
"2000","VIRGINIA","HALIFAX",5963,377,7732,14072
"2000","VIRGINIA","HAMPTON",27490,836,19561,47887
"2000","VIRGINIA","HANOVER",12044,927,28614,41585
"2000","VIRGINIA","HARRISONBURG",3482,735,5741,9958
"2000","VIRGINIA","HENRICO",48645,2720,62887,114252
"2000","VIRGINIA","HENRY",8898,695,11870,21463
"2000","VIRGINIA","HIGHLAND",453,42,942,1437
"2000","VIRGINIA","HOPEWELL",3024,205,3749,6978
"2000","VIRGINIA","ISLE OF WIGHT",5162,201,7587,12950
"2000","VIRGINIA","JAMES CITY",9090,774,14628,24492
"2000","VIRGINIA","KING AND QUEEN",1387,49,1423,2859
"2000","VIRGINIA","KING GEORGE",2070,192,3590,5852
"2000","VIRGINIA","KING WILLIAM",2125,97,3547,5769
"2000","VIRGINIA","LANCASTER",1937,107,3411,5455
"2000","VIRGINIA","LEE",4031,166,4551,8748
"2000","VIRGINIA","LEXINGTON",1048,135,957,2140
"2000","VIRGINIA","LOUDOUN",30938,2262,42453,75653
"2000","VIRGINIA","LOUISA",4309,326,5461,10096
"2000","VIRGINIA","LUNENBURG",2026,55,2510,4591
"2000","VIRGINIA","LYNCHBURG",10374,614,12518,23506
"2000","VIRGINIA","MADISON",1844,243,2940,5027
"2000","VIRGINIA","MANASSAS",5262,396,6752,12410
"2000","VIRGINIA","MANASSAS PARK",1048,72,1460,2580
"2000","VIRGINIA","MARTINSVILLE",3048,86,2560,5694
"2000","VIRGINIA","MATHEWS",1499,159,2951,4609
"2000","VIRGINIA","MECKLENBURG",4797,257,6600,11654
"2000","VIRGINIA","MIDDLESEX",1671,174,2844,4689
"2000","VIRGINIA","MONTGOMERY",11720,1449,13991,27160
"2000","VIRGINIA","NELSON",2907,325,2913,6145
"2000","VIRGINIA","NEW KENT",2055,125,3934,6114
"2000","VIRGINIA","NEWPORT NEWS",29779,1040,27006,57825
"2000","VIRGINIA","NORFOLK",38221,1805,21920,61946
"2000","VIRGINIA","NORTHAMPTON",2340,253,2299,4892
"2000","VIRGINIA","NORTHUMBERLAND",2118,125,3362,5605
"2000","VIRGINIA","NORTON",867,24,639,1530
"2000","VIRGINIA","NOTTOWAY",2460,162,2870,5492
"2000","VIRGINIA","ORANGE",4126,366,5991,10483
"2000","VIRGINIA","PAGE",2726,181,5089,7996
"2000","VIRGINIA","PATRICK",2254,230,4901,7385
"2000","VIRGINIA","PETERSBURG",8751,202,2109,11062
"2000","VIRGINIA","PITTSYLVANIA",7834,661,15760,24255
"2000","VIRGINIA","POQUOSON",1448,142,4271,5861
"2000","VIRGINIA","PORTSMOUTH",22286,541,12628,35455
"2000","VIRGINIA","POWHATAN",2708,183,6820,9711
"2000","VIRGINIA","PRINCE EDWARD",2922,227,3214,6363
"2000","VIRGINIA","PRINCE GEORGE",4182,139,6579,10900
"2000","VIRGINIA","PRINCE WILLIAM",44745,2978,52788,100511
"2000","VIRGINIA","PULASKI",5255,353,7089,12697
"2000","VIRGINIA","RADFORD",2063,195,2190,4448
"2000","VIRGINIA","RAPPAHANNOCK",1462,201,1850,3513
"2000","VIRGINIA","RICHMOND",43793,3033,22049,68875
"2000","VIRGINIA","ROANOKE",34061,1828,40370,76259
"2000","VIRGINIA","ROCKBRIDGE",2953,352,4522,7827
"2000","VIRGINIA","ROCKINGHAM",5834,678,17482,23994
"2000","VIRGINIA","RUSSELL",5442,285,5065,10792
"2000","VIRGINIA","SALEM",4348,234,6188,10770
"2000","VIRGINIA","SCOTT",3552,248,5535,9335
"2000","VIRGINIA","SHENANDOAH",4420,396,9636,14452
"2000","VIRGINIA","SMYTH",4836,324,6580,11740
"2000","VIRGINIA","SOUTHAMPTON",3359,62,3293,6714
"2000","VIRGINIA","SPOTSYLVANIA",13455,827,20739,35021
"2000","VIRGINIA","STAFFORD",12596,919,20731,34246
"2000","VIRGINIA","STAUNTON",3324,312,4878,8514
"2000","VIRGINIA","SUFFOLK",12471,354,11836,24661
"2000","VIRGINIA","SURRY",1845,72,1313,3230
"2000","VIRGINIA","SUSSEX",2006,155,1745,3906
"2000","VIRGINIA","TAZEWELL",7227,462,8655,16344
"2000","VIRGINIA","VIRGINIA BEACH",62268,3829,83674,149771
"2000","VIRGINIA","WARREN",4313,518,6335,11166
"2000","VIRGINIA","WASHINGTON",7549,609,12064,20222
"2000","VIRGINIA","WAYNESBORO",2737,281,4084,7102
"2000","VIRGINIA","WESTMORELAND",2922,172,2932,6026
"2000","VIRGINIA","WILLIAMSBURG",1724,224,1777,3725
"2000","VIRGINIA","WINCHESTER",3318,254,4314,7886
"2000","VIRGINIA","WISE",6412,394,6504,13310
"2000","VIRGINIA","WYTHE",3462,224,6539,10225
"2000","VIRGINIA","YORK",8622,649,15312,24583
"2000","WASHINGTON","ADAMS",1406,128,3440,4974
"2000","WASHINGTON","ASOTIN",2736,340,4909,7985
"2000","WASHINGTON","BENTON",19512,1896,38367,59775
"2000","WASHINGTON","CHELAN",8412,1177,16980,26569
"2000","WASHINGTON","CLALLAM",13779,2200,16251,32230
"2000","WASHINGTON","CLARK",61767,6544,67219,135530
"2000","WASHINGTON","COLUMBIA",515,68,1523,2106
"2000","WASHINGTON","COWLITZ",18233,1851,16873,36957
"2000","WASHINGTON","DOUGLAS",3822,517,8512,12851
"2000","WASHINGTON","FERRY",932,209,1896,3037
"2000","WASHINGTON","FRANKLIN",4653,365,8594,13612
"2000","WASHINGTON","GARFIELD",300,47,982,1329
"2000","WASHINGTON","GRANT",7073,892,15830,23795
"2000","WASHINGTON","GRAYS HARBOR",13304,1441,11225,25970
"2000","WASHINGTON","ISLAND",14778,1817,16408,33003
"2000","WASHINGTON","JEFFERSON",8281,1456,6095,15832
"2000","WASHINGTON","KING",476700,44207,273171,794078
"2000","WASHINGTON","KITSAP",50302,6128,46427,102857
"2000","WASHINGTON","KITTITAS",5516,843,7727,14086
"2000","WASHINGTON","KLICKITAT",3062,561,4557,8180
"2000","WASHINGTON","LEWIS",9891,1527,18565,29983
"2000","WASHINGTON","LINCOLN",1417,233,3546,5196
"2000","WASHINGTON","MASON",10876,1346,10257,22479
"2000","WASHINGTON","OKANOGAN",4335,1077,9384,14796
"2000","WASHINGTON","PACIFIC",4895,581,4042,9518
"2000","WASHINGTON","PEND OREILLE",1973,388,3076,5437
"2000","WASHINGTON","PIERCE",138249,12214,118431,268894
"2000","WASHINGTON","SAN JUAN",4426,993,3005,8424
"2000","WASHINGTON","SKAGIT",20432,2625,22163,45220
"2000","WASHINGTON","SKAMANIA",1753,344,2151,4248
"2000","WASHINGTON","SNOHOMISH",129612,12078,109615,251305
"2000","WASHINGTON","SPOKANE",74604,8186,89299,172089
"2000","WASHINGTON","STEVENS",5560,1136,11299,17995
"2000","WASHINGTON","THURSTON",50467,7016,39924,97407
"2000","WASHINGTON","WAHKIAKUM",803,135,1033,1971
"2000","WASHINGTON","WALLA WALLA",7188,870,13304,21362
"2000","WASHINGTON","WHATCOM",34033,5432,34287,73752
"2000","WASHINGTON","WHITMAN",6509,722,9003,16234
"2000","WASHINGTON","YAKIMA",25546,2335,39494,67375
"2000","WEST VIRGINIA","BARBOUR",2503,137,3411,6051
"2000","WEST VIRGINIA","BERKELEY",8797,594,13619,23010
"2000","WEST VIRGINIA","BOONE",5656,132,3353,9141
"2000","WEST VIRGINIA","BRAXTON",2719,80,2529,5328
"2000","WEST VIRGINIA","BROOKE",4678,532,4195,9405
"2000","WEST VIRGINIA","CABELL",14896,880,16440,32216
"2000","WEST VIRGINIA","CALHOUN",1112,78,1425,2615
"2000","WEST VIRGINIA","CLAY",1617,78,1887,3582
"2000","WEST VIRGINIA","DODDRIDGE",773,88,1955,2816
"2000","WEST VIRGINIA","FAYETTE",8371,351,5897,14619
"2000","WEST VIRGINIA","GILMER",1092,88,1560,2740
"2000","WEST VIRGINIA","GRANT",891,72,3571,4534
"2000","WEST VIRGINIA","GREENBRIER",5627,315,6866,12808
"2000","WEST VIRGINIA","HAMPSHIRE",2069,149,3879,6097
"2000","WEST VIRGINIA","HANCOCK",6249,765,6458,13472
"2000","WEST VIRGINIA","HARDY",1621,77,2816,4514
"2000","WEST VIRGINIA","HARRISON",13009,621,12948,26578
"2000","WEST VIRGINIA","JACKSON",4937,240,6341,11518
"2000","WEST VIRGINIA","JEFFERSON",6860,473,7045,14378
"2000","WEST VIRGINIA","KANAWHA",38524,1337,36809,76670
"2000","WEST VIRGINIA","LEWIS",2355,173,3606,6134
"2000","WEST VIRGINIA","LINCOLN",3939,136,3389,7464
"2000","WEST VIRGINIA","LOGAN",8927,178,5334,14439
"2000","WEST VIRGINIA","MARION",12315,586,9972,22873
"2000","WEST VIRGINIA","MARSHALL",6000,639,6859,13498
"2000","WEST VIRGINIA","MASON",4963,288,5972,11223
"2000","WEST VIRGINIA","MCDOWELL",4845,110,2348,7303
"2000","WEST VIRGINIA","MERCER",8347,322,10206,18875
"2000","WEST VIRGINIA","MINERAL",3341,261,6180,9782
"2000","WEST VIRGINIA","MINGO",6049,128,3866,10043
"2000","WEST VIRGINIA","MONONGALIA",12603,1169,13595,27367
"2000","WEST VIRGINIA","MONROE",2094,105,2940,5139
"2000","WEST VIRGINIA","MORGAN",1939,194,3639,5772
"2000","WEST VIRGINIA","NICHOLAS",4059,161,4359,8579
"2000","WEST VIRGINIA","OHIO",7653,704,9607,17964
"2000","WEST VIRGINIA","PENDLETON",1172,53,1996,3221
"2000","WEST VIRGINIA","PLEASANTS",1267,57,1884,3208
"2000","WEST VIRGINIA","POCAHONTAS",1392,105,1970,3467
"2000","WEST VIRGINIA","PRESTON",3515,317,6607,10439
"2000","WEST VIRGINIA","PUTNAM",7891,362,12173,20426
"2000","WEST VIRGINIA","RALEIGH",11047,427,12587,24061
"2000","WEST VIRGINIA","RANDOLPH",4028,266,5248,9542
"2000","WEST VIRGINIA","RITCHIE",1024,71,2717,3812
"2000","WEST VIRGINIA","ROANE",2332,121,3172,5625
"2000","WEST VIRGINIA","SUMMERS",2299,110,2304,4713
"2000","WEST VIRGINIA","TAYLOR",2473,115,3124,5712
"2000","WEST VIRGINIA","TUCKER",1319,92,1935,3346
"2000","WEST VIRGINIA","TYLER",1214,132,2582,3928
"2000","WEST VIRGINIA","UPSHUR",2770,188,5165,8123
"2000","WEST VIRGINIA","WAYNE",7940,308,7993,16241
"2000","WEST VIRGINIA","WEBSTER",1764,60,1484,3308
"2000","WEST VIRGINIA","WETZEL",2849,200,3239,6288
"2000","WEST VIRGINIA","WIRT",818,46,1518,2382
"2000","WEST VIRGINIA","WOOD",12664,765,20428,33857
"2000","WEST VIRGINIA","WYOMING",4289,116,3473,7878
"2000","WISCONSIN","ADAMS",4826,370,3920,9116
"2000","WISCONSIN","ASHLAND",4356,496,3038,7890
"2000","WISCONSIN","BARRON",8928,1128,9848,19904
"2000","WISCONSIN","BAYFIELD",4427,566,3266,8259
"2000","WISCONSIN","BROWN",49096,4415,54258,107769
"2000","WISCONSIN","BUFFALO",3237,366,3038,6641
"2000","WISCONSIN","BURNETT",3626,558,3967,8151
"2000","WISCONSIN","CALUMET",8202,908,10837,19947
"2000","WISCONSIN","CHIPPEWA",12102,1236,12835,26173
"2000","WISCONSIN","CLARK",5931,757,7461,14149
"2000","WISCONSIN","COLUMBIA",12636,964,11987,25587
"2000","WISCONSIN","CRAWFORD",4005,365,3024,7394
"2000","WISCONSIN","DANE",142317,14632,75790,232739
"2000","WISCONSIN","DODGE",14580,1437,21684,37701
"2000","WISCONSIN","DOOR",6560,850,7810,15220
"2000","WISCONSIN","DOUGLAS",13593,1183,6930,21706
"2000","WISCONSIN","DUNN",9172,1247,8911,19330
"2000","WISCONSIN","EAU CLAIRE",24078,2876,20921,47875
"2000","WISCONSIN","FLORENCE",816,61,1528,2405
"2000","WISCONSIN","FOND DU LAC",18181,1860,26548,46589
"2000","WISCONSIN","FOREST",2158,154,2404,4716
"2000","WISCONSIN","GRANT",10691,1025,10240,21956
"2000","WISCONSIN","GREEN",7863,623,6790,15276
"2000","WISCONSIN","GREEN LAKE",3301,355,5451,9107
"2000","WISCONSIN","IOWA",5842,478,4221,10541
"2000","WISCONSIN","IRON",1620,153,1734,3507
"2000","WISCONSIN","JACKSON",4380,367,3670,8417
"2000","WISCONSIN","JEFFERSON",15203,1692,19204,36099
"2000","WISCONSIN","JUNEAU",4813,495,4910,10218
"2000","WISCONSIN","KENOSHA",32429,2389,28891,63709
"2000","WISCONSIN","KEWAUNEE",4670,531,4883,10084
"2000","WISCONSIN","LA CROSSE",28455,2777,24327,55559
"2000","WISCONSIN","LAFAYETTE",3710,217,3336,7263
"2000","WISCONSIN","LANGLADE",4199,397,5125,9721
"2000","WISCONSIN","LINCOLN",6664,848,6727,14239
"2000","WISCONSIN","MANITOWOC",17667,1799,19358,38824
"2000","WISCONSIN","MARATHON",26546,2945,28883,58374
"2000","WISCONSIN","MARINETTE",8676,710,10535,19921
"2000","WISCONSIN","MARQUETTE",3437,235,3522,7194
"2000","WISCONSIN","MENOMINEE",949,59,225,1233
"2000","WISCONSIN","MILWAUKEE",252329,17717,163491,433537
"2000","WISCONSIN","MONROE",7460,658,8217,16335
"2000","WISCONSIN","OCONTO",7260,630,8706,16596
"2000","WISCONSIN","ONEIDA",8339,1040,9512,18891
"2000","WISCONSIN","OUTAGAMIE",32735,3547,39460,75742
"2000","WISCONSIN","OZAUKEE",15030,1566,31155,47751
"2000","WISCONSIN","PEPIN",1854,179,1631,3664
"2000","WISCONSIN","PIERCE",8559,1234,8169,17962
"2000","WISCONSIN","POLK",8961,1244,9557,19762
"2000","WISCONSIN","PORTAGE",17942,2604,13214,33760
"2000","WISCONSIN","PRICE",3413,381,4136,7930
"2000","WISCONSIN","RACINE",41563,3288,44014,88865
"2000","WISCONSIN","RICHLAND",3837,462,3994,8293
"2000","WISCONSIN","ROCK",40472,2465,27467,70404
"2000","WISCONSIN","RUSK",3161,447,3758,7366
"2000","WISCONSIN","SAUK",13035,1032,11586,25653
"2000","WISCONSIN","SAWYER",3333,462,3972,7767
"2000","WISCONSIN","SHAWANO",7335,720,9548,17603
"2000","WISCONSIN","SHEBOYGAN",23569,1984,29648,55201
"2000","WISCONSIN","ST. CROIX",13077,1637,15240,29954
"2000","WISCONSIN","TAYLOR",3254,460,5278,8992
"2000","WISCONSIN","TREMPEALEAU",6678,488,5002,12168
"2000","WISCONSIN","VERNON",6577,783,5684,13044
"2000","WISCONSIN","VILAS",4706,658,6958,12322
"2000","WISCONSIN","WALWORTH",15492,1984,22982,40458
"2000","WISCONSIN","WASHBURN",3695,438,3912,8045
"2000","WISCONSIN","WASHINGTON",18115,2135,41162,61412
"2000","WISCONSIN","WAUKESHA",64319,6310,133105,203734
"2000","WISCONSIN","WAUPACA",8787,1037,12980,22804
"2000","WISCONSIN","WAUSHARA",4239,438,5571,10248
"2000","WISCONSIN","WINNEBAGO",33983,3767,38330,76080
"2000","WISCONSIN","WOOD",15936,2022,17803,35761
"2000","WYOMING","ALBANY",5069,1268,7814,14151
"2000","WYOMING","BIG HORN",1004,194,3720,4918
"2000","WYOMING","CAMPBELL",1967,370,10203,12540
"2000","WYOMING","CARBON",2206,264,4498,6968
"2000","WYOMING","CONVERSE",1076,180,3919,5175
"2000","WYOMING","CROOK",361,88,2289,2738
"2000","WYOMING","FREMONT",4172,712,10560,15444
"2000","WYOMING","GOSHEN",1439,159,3922,5520
"2000","WYOMING","HOT SPRINGS",544,75,1733,2352
"2000","WYOMING","JOHNSON",555,109,2886,3550
"2000","WYOMING","LARAMIE",12162,1364,21797,35323
"2000","WYOMING","LINCOLN",1184,246,5415,6845
"2000","WYOMING","NATRONA",8646,1303,18439,28388
"2000","WYOMING","NIOBRARA",190,49,888,1127
"2000","WYOMING","PARK",2424,528,9884,12836
"2000","WYOMING","PLATTE",1249,199,2925,4373
"2000","WYOMING","SHERIDAN",3330,482,8424,12236
"2000","WYOMING","SUBLETTE",458,134,2624,3216
"2000","WYOMING","SWEETWATER",5521,745,9425,15691
"2000","WYOMING","TETON",4019,958,5454,10431
"2000","WYOMING","UINTA",1650,299,5469,7418
"2000","WYOMING","WASHAKIE",806,107,3138,4051
"2000","WYOMING","WESTON",449,90,2521,3060
"2004","ALABAMA","AUTAUGA",4758,127,15196,20081
"2004","ALABAMA","BALDWIN",15599,750,52971,69320
"2004","ALABAMA","BARBOUR",4832,46,5899,10777
"2004","ALABAMA","BIBB",2089,39,5472,7600
"2004","ALABAMA","BLOUNT",3938,180,17386,21504
"2004","ALABAMA","BULLOCK",3210,13,1494,4717
"2004","ALABAMA","BUTLER",3413,24,4979,8416
"2004","ALABAMA","CALHOUN",15083,352,29814,45249
"2004","ALABAMA","CHAMBERS",5347,63,7622,13032
"2004","ALABAMA","CHEROKEE",3040,86,5923,9049
"2004","ALABAMA","CHILTON",3778,86,12829,16693
"2004","ALABAMA","CHOCTAW",3303,27,3897,7227
"2004","ALABAMA","CLARKE",4627,37,6730,11394
"2004","ALABAMA","CLAY",1893,59,4624,6576
"2004","ALABAMA","CLEBURNE",1391,37,4370,5798
"2004","ALABAMA","COFFEE",4480,117,13019,17616
"2004","ALABAMA","COLBERT",10598,149,13188,23935
"2004","ALABAMA","CONECUH",2719,31,3271,6021
"2004","ALABAMA","COOSA",2055,41,2905,5001
"2004","ALABAMA","COVINGTON",3423,85,11119,14627
"2004","ALABAMA","CRENSHAW",1698,25,3777,5500
"2004","ALABAMA","CULLMAN",8045,328,26818,35191
"2004","ALABAMA","DALE",4484,126,13621,18231
"2004","ALABAMA","DALLAS",11175,63,7335,18573
"2004","ALABAMA","DEKALB",7092,139,16904,24135
"2004","ALABAMA","ELMORE",6471,153,22056,28680
"2004","ALABAMA","ESCAMBIA",3814,68,8513,12395
"2004","ALABAMA","ETOWAH",15328,353,26999,42680
"2004","ALABAMA","FAYETTE",2408,60,5534,8002
"2004","ALABAMA","FRANKLIN",4514,65,7690,12269
"2004","ALABAMA","GENEVA",2113,65,8342,10520
"2004","ALABAMA","GREENE",3764,26,958,4748
"2004","ALABAMA","HALE",4631,33,3281,7945
"2004","ALABAMA","HENRY",2452,28,4881,7361
"2004","ALABAMA","HOUSTON",9144,183,26874,36201
"2004","ALABAMA","JACKSON",8635,152,11534,20321
"2004","ALABAMA","JEFFERSON",132286,2001,158680,292967
"2004","ALABAMA","LAMAR",1956,35,4894,6885
"2004","ALABAMA","LAUDERDALE",14628,318,22161,37107
"2004","ALABAMA","LAWRENCE",6155,116,7730,14001
"2004","ALABAMA","LEE",16227,411,27972,44610
"2004","ALABAMA","LIMESTONE",9126,245,19702,29073
"2004","ALABAMA","LOWNDES",4233,2,1786,6021
"2004","ALABAMA","MACON",7800,37,1570,9407
"2004","ALABAMA","MADISON",52644,1245,77173,131062
"2004","ALABAMA","MARENGO",5037,30,5255,10322
"2004","ALABAMA","MARION",3808,84,8983,12875
"2004","ALABAMA","MARSHALL",8452,256,22783,31491
"2004","ALABAMA","MOBILE",63732,1025,92014,156771
"2004","ALABAMA","MONROE",3666,37,5831,9534
"2004","ALABAMA","MONTGOMERY",45160,393,44097,89650
"2004","ALABAMA","MORGAN",14131,399,32477,47007
"2004","ALABAMA","PERRY",3767,18,1738,5523
"2004","ALABAMA","PICKENS",3915,47,5170,9132
"2004","ALABAMA","PIKE",4334,66,7483,11883
"2004","ALABAMA","RANDOLPH",2817,57,6127,9001
"2004","ALABAMA","RUSSELL",8375,97,8337,16809
"2004","ALABAMA","SHELBY",14850,621,63435,78906
"2004","ALABAMA","ST. CLAIR",5456,205,23500,29161
"2004","ALABAMA","SUMTER",4527,26,1880,6433
"2004","ALABAMA","TALLADEGA",11374,193,18331,29898
"2004","ALABAMA","TALLAPOOSA",5451,109,12392,17952
"2004","ALABAMA","TUSCALOOSA",26447,506,42877,69830
"2004","ALABAMA","WALKER",9016,184,19167,28367
"2004","ALABAMA","WASHINGTON",3145,42,5060,8247
"2004","ALABAMA","WILCOX",3838,10,1834,5682
"2004","ALABAMA","WINSTON",2236,57,8130,10423
"2004","ALASKA","DISTRICT 1",3662,452,6303,10417
"2004","ALASKA","DISTRICT 10",3670,335,6745,10750
"2004","ALASKA","DISTRICT 11",3364,381,9280,13025
"2004","ALASKA","DISTRICT 12",3387,350,8108,11845
"2004","ALASKA","DISTRICT 13",4819,491,10702,16012
"2004","ALASKA","DISTRICT 14",4403,428,10717,15548
"2004","ALASKA","DISTRICT 15",4766,576,10058,15400
"2004","ALASKA","DISTRICT 16",4791,462,10587,15840
"2004","ALASKA","DISTRICT 17",4646,373,10491,15510
"2004","ALASKA","DISTRICT 18",4193,270,8424,12887
"2004","ALASKA","DISTRICT 19",5061,383,8014,13458
"2004","ALASKA","DISTRICT 2",4961,498,5943,11402
"2004","ALASKA","DISTRICT 20",4465,383,6632,11480
"2004","ALASKA","DISTRICT 21",5488,365,8818,14671
"2004","ALASKA","DISTRICT 22",5426,402,7207,13035
"2004","ALASKA","DISTRICT 23",5991,418,6576,12985
"2004","ALASKA","DISTRICT 24",5226,403,7622,13251
"2004","ALASKA","DISTRICT 25",5435,451,6892,12778
"2004","ALASKA","DISTRICT 26",6476,430,7776,14682
"2004","ALASKA","DISTRICT 27",5212,400,8500,14112
"2004","ALASKA","DISTRICT 28",5141,363,9073,14577
"2004","ALASKA","DISTRICT 29",4546,341,7743,12630
"2004","ALASKA","DISTRICT 3",6513,445,4790,11748
"2004","ALASKA","DISTRICT 30",5181,359,8733,14273
"2004","ALASKA","DISTRICT 31",5315,350,9605,15270
"2004","ALASKA","DISTRICT 32",6580,447,9783,16810
"2004","ALASKA","DISTRICT 33",3192,402,7344,10938
"2004","ALASKA","DISTRICT 34",3033,434,7886,11353
"2004","ALASKA","DISTRICT 35",5030,534,6007,11571
"2004","ALASKA","DISTRICT 36",3245,351,5645,9241
"2004","ALASKA","DISTRICT 37",1970,192,3046,5208
"2004","ALASKA","DISTRICT 38",2366,250,2459,5075
"2004","ALASKA","DISTRICT 39",2365,322,2881,5568
"2004","ALASKA","DISTRICT 4",4768,417,5802,10987
"2004","ALASKA","DISTRICT 40",2328,243,3217,5788
"2004","ALASKA","DISTRICT 5",4679,491,5439,10609
"2004","ALASKA","DISTRICT 6",3728,405,6177,10310
"2004","ALASKA","DISTRICT 7",5008,520,7693,13221
"2004","ALASKA","DISTRICT 8",5758,569,6615,12942
"2004","ALASKA","DISTRICT 9",4177,375,6934,11486
"2004","ALASKA","DISTRICT 99",0,0,0,0
"2004","ARIZONA","APACHE",15658,156,8384,24198
"2004","ARIZONA","COCHISE",17514,413,26556,44483
"2004","ARIZONA","COCONINO",29243,498,22526,52267
"2004","ARIZONA","GILA",8314,186,12343,20843
"2004","ARIZONA","GRAHAM",3185,68,7467,10720
"2004","ARIZONA","GREENLEE",1146,22,1899,3067
"2004","ARIZONA","LA PAZ",1849,48,3158,5055
"2004","ARIZONA","MARICOPA",504849,8447,679455,1192751
"2004","ARIZONA","MOHAVE",20503,510,36794,57807
"2004","ARIZONA","NAVAJO",14815,251,17277,32343
"2004","ARIZONA","PIMA",193128,2670,171109,366907
"2004","ARIZONA","PINAL",27252,364,37006,64622
"2004","ARIZONA","SANTA CRUZ",6909,91,4668,11668
"2004","ARIZONA","YAVAPAI",33127,794,53468,87389
"2004","ARIZONA","YUMA",16032,249,22184,38465
"2004","ARKANSAS","ARKANSAS",3110,47,3789,6946
"2004","ARKANSAS","ASHLEY",3881,64,4567,8512
"2004","ARKANSAS","BAXTER",7129,273,11128,18530
"2004","ARKANSAS","BENTON",20756,794,46571,68121
"2004","ARKANSAS","BOONE",4640,344,9793,14777
"2004","ARKANSAS","BRADLEY",2206,32,2011,4249
"2004","ARKANSAS","CALHOUN",942,20,1341,2303
"2004","ARKANSAS","CARROLL",4161,136,6184,10481
"2004","ARKANSAS","CHICOT",2993,39,1725,4757
"2004","ARKANSAS","CLARK",4985,77,4127,9189
"2004","ARKANSAS","CLAY",3264,73,2759,6096
"2004","ARKANSAS","CLEBURNE",4702,132,7001,11835
"2004","ARKANSAS","CLEVELAND",1450,37,2009,3496
"2004","ARKANSAS","COLUMBIA",4108,72,5729,9909
"2004","ARKANSAS","CONWAY",4259,97,4293,8649
"2004","ARKANSAS","CRAIGHEAD",13665,318,15818,29801
"2004","ARKANSAS","CRAWFORD",6764,246,13391,20401
"2004","ARKANSAS","CRITTENDEN",8277,93,6930,15300
"2004","ARKANSAS","CROSS",3135,75,3864,7074
"2004","ARKANSAS","DALLAS",1667,17,1699,3383
"2004","ARKANSAS","DESHA",2851,67,1729,4647
"2004","ARKANSAS","DREW",2952,35,3262,6249
"2004","ARKANSAS","FAULKNER",14538,634,21514,36686
"2004","ARKANSAS","FRANKLIN",3008,100,4181,7289
"2004","ARKANSAS","FULTON",2370,63,2522,4955
"2004","ARKANSAS","GARLAND",18040,380,21734,40154
"2004","ARKANSAS","GRANT",2524,41,4205,6770
"2004","ARKANSAS","GREENE",6561,154,7232,13947
"2004","ARKANSAS","HEMPSTEAD",3817,55,3580,7452
"2004","ARKANSAS","HOT SPRING",5903,203,5962,12068
"2004","ARKANSAS","HOWARD",2166,41,2736,4943
"2004","ARKANSAS","INDEPENDENCE",5443,138,7430,13011
"2004","ARKANSAS","IZARD",2586,74,2833,5493
"2004","ARKANSAS","JACKSON",3515,80,2624,6219
"2004","ARKANSAS","JEFFERSON",19675,600,10218,30493
"2004","ARKANSAS","JOHNSON",3622,111,4311,8044
"2004","ARKANSAS","LAFAYETTE",1567,20,1604,3191
"2004","ARKANSAS","LAWRENCE",3544,120,2951,6615
"2004","ARKANSAS","LEE",2548,40,1492,4080
"2004","ARKANSAS","LINCOLN",2149,39,1921,4109
"2004","ARKANSAS","LITTLE RIVER",2677,42,2575,5294
"2004","ARKANSAS","LOGAN",3361,114,5076,8551
"2004","ARKANSAS","LONOKE",7454,178,14398,22030
"2004","ARKANSAS","MADISON",2421,90,3873,6384
"2004","ARKANSAS","MARION",2602,138,4127,6867
"2004","ARKANSAS","MILLER",6139,91,8448,14678
"2004","ARKANSAS","MISSISSIPPI",7593,439,6121,14153
"2004","ARKANSAS","MONROE",2049,32,1586,3667
"2004","ARKANSAS","MONTGOMERY",1524,67,2367,3958
"2004","ARKANSAS","NEVADA",1694,31,1752,3477
"2004","ARKANSAS","NEWTON",1506,93,2779,4378
"2004","ARKANSAS","OUACHITA",5188,117,5345,10650
"2004","ARKANSAS","PERRY",1921,75,2435,4431
"2004","ARKANSAS","PHILLIPS",5642,65,3161,8868
"2004","ARKANSAS","PIKE",1310,44,2013,3367
"2004","ARKANSAS","POINSETT",4069,99,3555,7723
"2004","ARKANSAS","POLK",2473,134,5192,7799
"2004","ARKANSAS","POPE",7100,188,13614,20902
"2004","ARKANSAS","PRAIRIE",1562,32,2030,3624
"2004","ARKANSAS","PULASKI",82755,1386,67617,151758
"2004","ARKANSAS","RANDOLPH",3412,97,3158,6667
"2004","ARKANSAS","SALINE",14153,359,24864,39376
"2004","ARKANSAS","SCOTT",1473,51,2514,4038
"2004","ARKANSAS","SEARCY",1370,57,2565,3992
"2004","ARKANSAS","SEBASTIAN",16479,429,27303,44211
"2004","ARKANSAS","SEVIER",2035,50,2516,4601
"2004","ARKANSAS","SHARP",3265,108,4097,7470
"2004","ARKANSAS","ST. FRANCIS",5684,89,3815,9588
"2004","ARKANSAS","STONE",2255,106,3188,5549
"2004","ARKANSAS","UNION",7071,259,10502,17832
"2004","ARKANSAS","VAN BUREN",3310,76,3988,7374
"2004","ARKANSAS","WASHINGTON",27597,780,35726,64103
"2004","ARKANSAS","WHITE",9129,295,17001,26425
"2004","ARKANSAS","WOODRUFF",1972,33,1021,3026
"2004","ARKANSAS","YELL",2913,68,3678,6659
"2004","CALIFORNIA","ALAMEDA",422585,7246,130911,560742
"2004","CALIFORNIA","ALPINE",373,15,311,699
"2004","CALIFORNIA","AMADOR",6211,189,10479,16879
"2004","CALIFORNIA","BUTTE",42448,1625,51662,95735
"2004","CALIFORNIA","CALAVERAS",8286,419,13601,22306
"2004","CALIFORNIA","COLUSA",1947,77,4142,6166
"2004","CALIFORNIA","CONTRA COSTA",257254,4277,150608,412139
"2004","CALIFORNIA","DEL NORTE",3892,173,5356,9421
"2004","CALIFORNIA","EL DORADO",32242,1158,52878,86278
"2004","CALIFORNIA","FRESNO",103154,2018,141988,247160
"2004","CALIFORNIA","GLENN",2995,132,6308,9435
"2004","CALIFORNIA","HUMBOLDT",37988,1808,25714,65510
"2004","CALIFORNIA","IMPERIAL",13955,319,11628,25902
"2004","CALIFORNIA","INYO",3021,138,4559,7718
"2004","CALIFORNIA","KERN",68603,1838,140417,210858
"2004","CALIFORNIA","KINGS",10833,257,21003,32093
"2004","CALIFORNIA","LAKE",9679,302,8185,18166
"2004","CALIFORNIA","LASSEN",3158,153,8126,11437
"2004","CALIFORNIA","LOS ANGELES",1907736,37686,1076225,3021647
"2004","CALIFORNIA","MADERA",13481,428,24871,38780
"2004","CALIFORNIA","MARIN",99070,1471,34378,134919
"2004","CALIFORNIA","MARIPOSA",3251,172,5215,8638
"2004","CALIFORNIA","MENDOCINO",24385,839,12955,38179
"2004","CALIFORNIA","MERCED",24491,681,32773,57945
"2004","CALIFORNIA","MODOC",1149,72,3235,4456
"2004","CALIFORNIA","MONO",2628,81,2621,5330
"2004","CALIFORNIA","MONTEREY",75241,1465,47838,124544
"2004","CALIFORNIA","NAPA",33666,740,22059,56465
"2004","CALIFORNIA","NEVADA",24220,729,28790,53739
"2004","CALIFORNIA","ORANGE",419239,12225,641832,1073296
"2004","CALIFORNIA","PLACER",55573,1403,95969,152945
"2004","CALIFORNIA","PLUMAS",4129,144,6905,11178
"2004","CALIFORNIA","RIVERSIDE",228806,5603,322473,556882
"2004","CALIFORNIA","SACRAMENTO",236657,4569,235539,476765
"2004","CALIFORNIA","SAN BENITO",9851,176,8698,18725
"2004","CALIFORNIA","SAN BERNARDINO",227789,5682,289306,522777
"2004","CALIFORNIA","SAN DIEGO",526437,11114,596033,1133584
"2004","CALIFORNIA","SAN FRANCISCO",296772,4802,54355,355929
"2004","CALIFORNIA","SAN JOAQUIN",87012,1515,100978,189505
"2004","CALIFORNIA","SAN LUIS OBISPO",58742,1910,67995,128647
"2004","CALIFORNIA","SAN MATEO",197922,2840,83315,284077
"2004","CALIFORNIA","SANTA BARBARA",90314,2005,76806,169125
"2004","CALIFORNIA","SANTA CLARA",386100,7420,209094,602614
"2004","CALIFORNIA","SANTA CRUZ",89102,2277,30354,121733
"2004","CALIFORNIA","SHASTA",24339,983,52249,77571
"2004","CALIFORNIA","SIERRA",646,50,1249,1945
"2004","CALIFORNIA","SISKIYOU",7880,310,12673,20863
"2004","CALIFORNIA","SOLANO",85096,1349,62301,148746
"2004","CALIFORNIA","SONOMA",148261,3612,68204,220077
"2004","CALIFORNIA","STANISLAUS",58829,1278,85407,145514
"2004","CALIFORNIA","SUTTER",9602,289,20254,30145
"2004","CALIFORNIA","TEHAMA",7504,329,15572,23405
"2004","CALIFORNIA","TRINITY",2782,137,3560,6479
"2004","CALIFORNIA","TULARE",32494,846,65399,98739
"2004","CALIFORNIA","TUOLUMNE",10104,339,15745,26188
"2004","CALIFORNIA","VENTURA",148859,3736,160314,312909
"2004","CALIFORNIA","YOLO",42885,1119,28005,72009
"2004","CALIFORNIA","YUBA",5687,257,12076,18020
"2004","COLORADO","ADAMS",69122,1638,65912,136672
"2004","COLORADO","ALAMOSA",3017,73,3179,6269
"2004","COLORADO","ARAPAHOE",110262,2434,119475,232171
"2004","COLORADO","ARCHULETA",2141,97,3601,5839
"2004","COLORADO","BACA",483,23,1680,2186
"2004","COLORADO","BENT",785,32,1338,2155
"2004","COLORADO","BOULDER",105564,2107,51586,159257
"2004","COLORADO","BROOMFIELD",10935,293,12007,23235
"2004","COLORADO","CHAFFEE",3766,128,4875,8769
"2004","COLORADO","CHEYENNE",198,13,923,1134
"2004","COLORADO","CLEAR CREEK",2989,102,2522,5613
"2004","COLORADO","CONEJOS",1894,42,1864,3800
"2004","COLORADO","COSTILLA",1170,23,566,1759
"2004","COLORADO","CROWLEY",478,9,1006,1493
"2004","COLORADO","CUSTER",739,32,1657,2428
"2004","COLORADO","DELTA",4224,213,9722,14159
"2004","COLORADO","DENVER",166135,2634,69903,238672
"2004","COLORADO","DOLORES",333,28,785,1146
"2004","COLORADO","DOUGLAS",39661,888,80651,121200
"2004","COLORADO","EAGLE",9744,234,8533,18511
"2004","COLORADO","EL PASO",77648,2777,161361,241786
"2004","COLORADO","ELBERT",2834,138,8389,11361
"2004","COLORADO","FREMONT",5933,277,12313,18523
"2004","COLORADO","GARFIELD",9228,296,11123,20647
"2004","COLORADO","GILPIN",1807,60,1329,3196
"2004","COLORADO","GRAND",3243,106,4260,7609
"2004","COLORADO","GUNNISON",4782,159,3479,8420
"2004","COLORADO","HINSDALE",236,11,355,602
"2004","COLORADO","HUERFANO",1663,39,1700,3402
"2004","COLORADO","JACKSON",210,14,710,934
"2004","COLORADO","JEFFERSON",126558,4091,140644,271293
"2004","COLORADO","KIOWA",172,8,712,892
"2004","COLORADO","KIT CARSON",729,52,2721,3502
"2004","COLORADO","LA PLATA",13409,377,11704,25490
"2004","COLORADO","LAKE",1623,65,1261,2949
"2004","COLORADO","LARIMER",68266,2285,75884,146435
"2004","COLORADO","LAS ANIMAS",3300,91,3196,6587
"2004","COLORADO","LINCOLN",503,15,1819,2337
"2004","COLORADO","LOGAN",2491,107,6168,8766
"2004","COLORADO","MESA",19564,782,41539,61885
"2004","COLORADO","MINERAL",227,9,383,619
"2004","COLORADO","MOFFAT",1355,123,4247,5725
"2004","COLORADO","MONTEZUMA",3867,160,6988,11015
"2004","COLORADO","MONTROSE",4776,225,11218,16219
"2004","COLORADO","MORGAN",3039,110,6787,9936
"2004","COLORADO","OTERO",3164,69,4947,8180
"2004","COLORADO","OURAY",1278,39,1402,2719
"2004","COLORADO","PARK",3445,129,4781,8355
"2004","COLORADO","PHILLIPS",582,26,1717,2325
"2004","COLORADO","PITKIN",6335,136,2784,9255
"2004","COLORADO","PROWERS",1308,45,3392,4745
"2004","COLORADO","PUEBLO",35369,696,31117,67182
"2004","COLORADO","RIO BLANCO",566,34,2403,3003
"2004","COLORADO","RIO GRANDE",2006,69,3448,5523
"2004","COLORADO","ROUTT",6392,170,5199,11761
"2004","COLORADO","SAGUACHE",1594,46,1163,2803
"2004","COLORADO","SAN JUAN",253,17,216,486
"2004","COLORADO","SAN MIGUEL",2876,64,1079,4019
"2004","COLORADO","SEDGWICK",374,15,971,1360
"2004","COLORADO","SUMMIT",8144,221,5370,13735
"2004","COLORADO","TELLER",3556,190,8094,11840
"2004","COLORADO","WASHINGTON",455,25,2050,2530
"2004","COLORADO","WELD",31868,1193,55591,88652
"2004","COLORADO","YUMA",1064,39,3456,4559
"2004","CONNECTICUT","FAIRFIELD",205902,5460,189605,400967
"2004","CONNECTICUT","HARTFORD",229902,6987,154919,391808
"2004","CONNECTICUT","LITCHFIELD",44647,1861,50160,96668
"2004","CONNECTICUT","MIDDLESEX",47292,1440,35252,83984
"2004","CONNECTICUT","NEW HAVEN",199060,6942,160390,366392
"2004","CONNECTICUT","NEW LONDON",66062,2367,49931,118360
"2004","CONNECTICUT","STATEWIDE WRITEIN",0,0,0,0
"2004","CONNECTICUT","TOLLAND",39146,1338,31245,71729
"2004","CONNECTICUT","WINDHAM",25477,1060,22324,48861
"2004","DELAWARE","KENT",23872,527,31578,55977
"2004","DELAWARE","NEW CASTLE",146171,2203,93070,241444
"2004","DELAWARE","SUSSEX",30098,648,47003,77749
"2004","DISTRICT OF COLUMBIA","DISTRICT OF COLUMBIA",202970,3360,21256,227586
"2004","FLORIDA","ALACHUA",62504,1062,47762,111328
"2004","FLORIDA","BAKER",2180,37,7738,9955
"2004","FLORIDA","BAY",21068,552,53404,75024
"2004","FLORIDA","BRADFORD",3244,54,7557,10855
"2004","FLORIDA","BREVARD",110309,2085,153068,265462
"2004","FLORIDA","BROWARD",453873,8325,244674,706872
"2004","FLORIDA","CALHOUN",2116,65,3782,5963
"2004","FLORIDA","CHARLOTTE",34256,1102,44428,79786
"2004","FLORIDA","CITRUS",29277,690,39500,69467
"2004","FLORIDA","CLAY",18971,446,62078,81495
"2004","FLORIDA","COLLIER",43892,1160,83631,128683
"2004","FLORIDA","COLUMBIA",8031,202,16758,24991
"2004","FLORIDA","DESOTO",3913,73,5524,9510
"2004","FLORIDA","DIXIE",1960,48,4434,6442
"2004","FLORIDA","DUVAL",158610,2261,220190,381061
"2004","FLORIDA","ESCAMBIA",48329,1383,93566,143278
"2004","FLORIDA","FLAGLER",18578,269,19633,38480
"2004","FLORIDA","FRANKLIN",2401,58,3472,5931
"2004","FLORIDA","GADSDEN",14629,102,6253,20984
"2004","FLORIDA","GILCHRIST",2017,62,4936,7015
"2004","FLORIDA","GLADES",1718,27,2443,4188
"2004","FLORIDA","GULF",2407,65,4805,7277
"2004","FLORIDA","HAMILTON",2260,27,2792,5079
"2004","FLORIDA","HARDEE",2149,51,5049,7249
"2004","FLORIDA","HENDRY",3960,58,5757,9775
"2004","FLORIDA","HERNANDO",37187,725,42635,80547
"2004","FLORIDA","HIGHLANDS",15347,271,25878,41496
"2004","FLORIDA","HILLSBOROUGH",214132,3514,245576,463222
"2004","FLORIDA","HOLMES",1810,78,6412,8300
"2004","FLORIDA","INDIAN RIVER",23956,520,36938,61414
"2004","FLORIDA","JACKSON",7555,130,12122,19807
"2004","FLORIDA","JEFFERSON",4135,45,3298,7478
"2004","FLORIDA","LAFAYETTE",845,20,2460,3325
"2004","FLORIDA","LAKE",48221,1340,74389,123950
"2004","FLORIDA","LEE",93860,2631,144176,240667
"2004","FLORIDA","LEON",83873,891,51615,136379
"2004","FLORIDA","LEVY",6074,168,10410,16652
"2004","FLORIDA","LIBERTY",1070,24,1927,3021
"2004","FLORIDA","MADISON",4050,63,4191,8304
"2004","FLORIDA","MANATEE",61262,1041,81318,143621
"2004","FLORIDA","MARION",57271,1123,81283,139677
"2004","FLORIDA","MARTIN",30208,883,41362,72453
"2004","FLORIDA","MIAMI-DADE",409732,3899,361095,774726
"2004","FLORIDA","MONROE",19654,414,19467,39535
"2004","FLORIDA","NASSAU",8573,387,23783,32743
"2004","FLORIDA","OKALOOSA",19368,695,69693,89756
"2004","FLORIDA","OKEECHOBEE",5153,59,6978,12190
"2004","FLORIDA","ORANGE",193354,2151,192539,388044
"2004","FLORIDA","OSCEOLA",38633,454,43117,82204
"2004","FLORIDA","PALM BEACH",328687,3247,212688,544622
"2004","FLORIDA","PASCO",84749,2937,103230,190916
"2004","FLORIDA","PINELLAS",225460,4211,225686,455357
"2004","FLORIDA","POLK",86009,1262,123559,210830
"2004","FLORIDA","PUTNAM",12412,250,18311,30973
"2004","FLORIDA","SANTA ROSA",14659,589,52059,67307
"2004","FLORIDA","SARASOTA",88442,2518,104692,195652
"2004","FLORIDA","SEMINOLE",76971,1052,108172,186195
"2004","FLORIDA","ST. JOHNS",26399,695,59196,86290
"2004","FLORIDA","ST. LUCIE",51835,636,47592,100063
"2004","FLORIDA","SUMTER",11584,458,19800,31842
"2004","FLORIDA","SUWANNEE",4522,127,11153,15802
"2004","FLORIDA","TAYLOR",3049,65,5467,8581
"2004","FLORIDA","UNION",1251,28,3396,4675
"2004","FLORIDA","VOLUSIA",115519,1496,111924,228939
"2004","FLORIDA","WAKULLA",4896,90,6777,11763
"2004","FLORIDA","WALTON",6213,208,17555,23976
"2004","FLORIDA","WASHINGTON",2912,85,7369,10366
"2004","GEORGIA","APPLING",1848,27,4494,6369
"2004","GEORGIA","ATKINSON",799,5,1666,2470
"2004","GEORGIA","BACON",930,7,2853,3790
"2004","GEORGIA","BAKER",936,7,821,1764
"2004","GEORGIA","BALDWIN",6775,63,7709,14547
"2004","GEORGIA","BANKS",1149,31,4410,5590
"2004","GEORGIA","BARROW",4095,112,13520,17727
"2004","GEORGIA","BARTOW",7741,180,22311,30232
"2004","GEORGIA","BEN HILL",2180,25,3331,5536
"2004","GEORGIA","BERRIEN",1638,37,3917,5592
"2004","GEORGIA","BIBB",29322,258,28107,57687
"2004","GEORGIA","BLECKLEY",1281,19,3167,4467
"2004","GEORGIA","BRANTLEY",1258,27,4333,5618
"2004","GEORGIA","BROOKS",2193,8,2912,5113
"2004","GEORGIA","BRYAN",2590,30,7363,9983
"2004","GEORGIA","BULLOCH",6840,79,12252,19171
"2004","GEORGIA","BURKE",4213,34,4232,8479
"2004","GEORGIA","BUTTS",2572,43,5119,7734
"2004","GEORGIA","CALHOUN",1119,10,890,2019
"2004","GEORGIA","CAMDEN",4637,50,9488,14175
"2004","GEORGIA","CANDLER",1096,7,2048,3151
"2004","GEORGIA","CARROLL",10224,217,24837,35278
"2004","GEORGIA","CATOOSA",5807,91,16406,22304
"2004","GEORGIA","CHARLTON",1064,12,2311,3387
"2004","GEORGIA","CHATHAM",45630,401,45484,91515
"2004","GEORGIA","CHATTAHOOCHEE",773,10,905,1688
"2004","GEORGIA","CHATTOOGA",2809,46,4992,7847
"2004","GEORGIA","CHEROKEE",14824,525,58238,73587
"2004","GEORGIA","CLARKE",21718,465,15052,37235
"2004","GEORGIA","CLAY",798,2,509,1309
"2004","GEORGIA","CLAYTON",56113,327,23106,79546
"2004","GEORGIA","CLINCH",750,14,1501,2265
"2004","GEORGIA","COBB",103955,2051,173467,279473
"2004","GEORGIA","COFFEE",3979,42,8306,12327
"2004","GEORGIA","COLQUITT",3378,56,8296,11730
"2004","GEORGIA","COLUMBIA",11442,153,35549,47144
"2004","GEORGIA","COOK",1733,18,3065,4816
"2004","GEORGIA","COWETA",10647,216,31682,42545
"2004","GEORGIA","CRAWFORD",1552,20,2830,4402
"2004","GEORGIA","CRISP",2357,28,3865,6250
"2004","GEORGIA","DADE",1823,39,4368,6230
"2004","GEORGIA","DAWSON",1407,57,6649,8113
"2004","GEORGIA","DECATUR",3577,26,5348,8951
"2004","GEORGIA","DEKALB",200787,1782,73570,276139
"2004","GEORGIA","DODGE",2384,27,4584,6995
"2004","GEORGIA","DOOLY",1973,18,1853,3844
"2004","GEORGIA","DOUGHERTY",19805,131,13711,33647
"2004","GEORGIA","DOUGLAS",15997,222,25846,42065
"2004","GEORGIA","EARLY",1701,17,2495,4213
"2004","GEORGIA","ECHOLS",231,3,757,991
"2004","GEORGIA","EFFINGHAM",3613,51,12503,16167
"2004","GEORGIA","ELBERT",2984,46,4626,7656
"2004","GEORGIA","EMANUEL",2774,28,4666,7468
"2004","GEORGIA","EVANS",1213,10,2291,3514
"2004","GEORGIA","FANNIN",2727,61,6862,9650
"2004","GEORGIA","FAYETTE",14887,295,37346,52528
"2004","GEORGIA","FLOYD",10038,187,21400,31625
"2004","GEORGIA","FORSYTH",9201,358,47267,56826
"2004","GEORGIA","FRANKLIN",2245,39,5218,7502
"2004","GEORGIA","FULTON",199436,2216,134372,336024
"2004","GEORGIA","GILMER",2510,74,7414,9998
"2004","GEORGIA","GLASCOCK",250,3,1016,1269
"2004","GEORGIA","GLYNN",8962,122,18608,27692
"2004","GEORGIA","GORDON",4028,76,11671,15775
"2004","GEORGIA","GRADY",3092,31,5068,8191
"2004","GEORGIA","GREENE",2774,29,4069,6872
"2004","GEORGIA","GWINNETT",81708,1764,160445,243917
"2004","GEORGIA","HABERSHAM",2750,61,10434,13245
"2004","GEORGIA","HALL",10514,299,38883,49696
"2004","GEORGIA","HANCOCK",2715,13,822,3550
"2004","GEORGIA","HARALSON",2434,56,7703,10193
"2004","GEORGIA","HARRIS",3400,53,8878,12331
"2004","GEORGIA","HART",3479,42,5500,9021
"2004","GEORGIA","HEARD",1148,19,2788,3955
"2004","GEORGIA","HENRY",21096,298,42759,64153
"2004","GEORGIA","HOUSTON",15054,237,29862,45153
"2004","GEORGIA","IRWIN",1051,16,2347,3414
"2004","GEORGIA","JACKSON",3468,91,12611,16170
"2004","GEORGIA","JASPER",1558,25,3157,4740
"2004","GEORGIA","JEFF DAVIS",1277,18,3549,4844
"2004","GEORGIA","JEFFERSON",3447,22,3066,6535
"2004","GEORGIA","JENKINS",1494,11,1898,3403
"2004","GEORGIA","JOHNSON",1263,11,2279,3553
"2004","GEORGIA","JONES",3855,51,6939,10845
"2004","GEORGIA","LAMAR",2432,35,4027,6494
"2004","GEORGIA","LANIER",931,12,1641,2584
"2004","GEORGIA","LAURENS",6281,73,10883,17237
"2004","GEORGIA","LEE",2182,30,8201,10413
"2004","GEORGIA","LIBERTY",6619,50,6131,12800
"2004","GEORGIA","LINCOLN",1337,11,2309,3657
"2004","GEORGIA","LONG",1033,9,1994,3036
"2004","GEORGIA","LOWNDES",12516,125,18981,31622
"2004","GEORGIA","LUMPKIN",2091,74,6690,8855
"2004","GEORGIA","MACON",2906,20,1851,4777
"2004","GEORGIA","MADISON",2527,52,7254,9833
"2004","GEORGIA","MARION",1275,7,1670,2952
"2004","GEORGIA","MCDUFFIE",2899,28,4846,7773
"2004","GEORGIA","MCINTOSH",2523,18,2837,5378
"2004","GEORGIA","MERIWETHER",3709,36,4402,8147
"2004","GEORGIA","MILLER",736,11,1694,2441
"2004","GEORGIA","MITCHELL",3360,22,3885,7267
"2004","GEORGIA","MONROE",3216,45,6522,9783
"2004","GEORGIA","MONTGOMERY",1007,11,2150,3168
"2004","GEORGIA","MORGAN",2304,36,4902,7242
"2004","GEORGIA","MURRAY",2899,45,7745,10689
"2004","GEORGIA","MUSCOGEE",32867,231,30850,63948
"2004","GEORGIA","NEWTON",10939,132,18095,29166
"2004","GEORGIA","OCONEE",3789,105,10276,14170
"2004","GEORGIA","OGLETHORPE",1899,41,3688,5628
"2004","GEORGIA","PAULDING",9420,204,30843,40467
"2004","GEORGIA","PEACH",3961,30,4554,8545
"2004","GEORGIA","PICKENS",2444,68,8115,10627
"2004","GEORGIA","PIERCE",1234,9,4680,5923
"2004","GEORGIA","PIKE",1506,42,5193,6741
"2004","GEORGIA","POLK",3868,60,8467,12395
"2004","GEORGIA","PULASKI",1294,15,2202,3511
"2004","GEORGIA","PUTNAM",2880,39,5188,8107
"2004","GEORGIA","QUITMAN",543,13,409,965
"2004","GEORGIA","RABUN",1918,57,4650,6625
"2004","GEORGIA","RANDOLPH",1612,17,1418,3047
"2004","GEORGIA","RICHMOND",39262,256,29764,69282
"2004","GEORGIA","ROCKDALE",12136,164,18856,31156
"2004","GEORGIA","SCHLEY",464,3,1063,1530
"2004","GEORGIA","SCREVEN",2534,29,3360,5923
"2004","GEORGIA","SEMINOLE",1278,19,1977,3274
"2004","GEORGIA","SPALDING",7460,86,13461,21007
"2004","GEORGIA","STEPHENS",2714,42,6904,9660
"2004","GEORGIA","STEWART",1220,14,797,2031
"2004","GEORGIA","SUMTER",5562,37,5688,11287
"2004","GEORGIA","TALBOT",1830,10,1103,2943
"2004","GEORGIA","TALIAFERRO",612,4,335,951
"2004","GEORGIA","TATTNALL",1787,19,4657,6463
"2004","GEORGIA","TAYLOR",1458,11,1912,3381
"2004","GEORGIA","TELFAIR",1590,14,2171,3775
"2004","GEORGIA","TERRELL",1951,14,1859,3824
"2004","GEORGIA","THOMAS",5997,49,9659,15705
"2004","GEORGIA","TIFT",3864,37,8619,12520
"2004","GEORGIA","TOOMBS",2567,50,6196,8813
"2004","GEORGIA","TOWNS",1430,24,3823,5277
"2004","GEORGIA","TREUTLEN",1052,13,1691,2756
"2004","GEORGIA","TROUP",7630,99,14183,21912
"2004","GEORGIA","TURNER",1135,10,1815,2960
"2004","GEORGIA","TWIGGS",2220,33,2112,4365
"2004","GEORGIA","UNION",2327,51,6847,9225
"2004","GEORGIA","UPSON",3424,28,6634,10086
"2004","GEORGIA","WALKER",5986,127,15340,21453
"2004","GEORGIA","WALTON",5887,143,21594,27624
"2004","GEORGIA","WARE",3449,42,7790,11281
"2004","GEORGIA","WARREN",1360,8,1121,2489
"2004","GEORGIA","WASHINGTON",3733,33,4081,7847
"2004","GEORGIA","WAYNE",2683,40,6819,9542
"2004","GEORGIA","WEBSTER",515,4,485,1004
"2004","GEORGIA","WHEELER",847,10,1192,2049
"2004","GEORGIA","WHITE",2016,64,7403,9483
"2004","GEORGIA","WHITFIELD",6933,126,19297,26356
"2004","GEORGIA","WILCOX",902,6,1705,2613
"2004","GEORGIA","WILKES",2028,25,2490,4543
"2004","GEORGIA","WILKINSON",2235,18,2261,4514
"2004","GEORGIA","WORTH",2219,24,5105,7348
"2004","HAWAII","HAWAII",35116,554,22032,57702
"2004","HAWAII","HONOLULU",152500,1890,144157,298547
"2004","HAWAII","KAUAI",14916,220,9740,24876
"2004","HAWAII","MAUI",28803,440,18187,47430
"2004","IDAHO","ADA",58523,1838,94641,155002
"2004","IDAHO","ADAMS",555,40,1468,2063
"2004","IDAHO","BANNOCK",12903,461,21479,34843
"2004","IDAHO","BEAR LAKE",494,40,2506,3040
"2004","IDAHO","BENEWAH",1148,76,2823,4047
"2004","IDAHO","BINGHAM",3605,225,12734,16564
"2004","IDAHO","BLAINE",5992,120,4034,10146
"2004","IDAHO","BOISE",970,56,2501,3527
"2004","IDAHO","BONNER",6649,335,10697,17681
"2004","IDAHO","BONNEVILLE",8356,467,30048,38871
"2004","IDAHO","BOUNDARY",1268,98,3012,4378
"2004","IDAHO","BUTTE",321,8,1077,1406
"2004","IDAHO","CAMAS",139,6,450,595
"2004","IDAHO","CANYON",13415,678,41599,55692
"2004","IDAHO","CARIBOU",491,37,2753,3281
"2004","IDAHO","CASSIA",1153,106,6562,7821
"2004","IDAHO","CLARK",46,5,302,353
"2004","IDAHO","CLEARWATER",1117,78,2839,4034
"2004","IDAHO","CUSTER",559,37,1762,2358
"2004","IDAHO","ELMORE",1959,89,6011,8059
"2004","IDAHO","FRANKLIN",456,71,4527,5054
"2004","IDAHO","FREMONT",741,63,4965,5769
"2004","IDAHO","GEM",1628,90,5416,7134
"2004","IDAHO","GOODING",1278,74,3973,5325
"2004","IDAHO","IDAHO",1689,259,6017,7965
"2004","IDAHO","JEFFERSON",1084,119,7703,8906
"2004","IDAHO","JEROME",1344,59,5177,6580
"2004","IDAHO","KOOTENAI",17584,839,36173,54596
"2004","IDAHO","LATAH",8430,431,8686,17547
"2004","IDAHO","LEMHI",915,59,3079,4053
"2004","IDAHO","LEWIS",440,21,1359,1820
"2004","IDAHO","LINCOLN",466,21,1388,1875
"2004","IDAHO","MADISON",826,118,10693,11637
"2004","IDAHO","MINIDOKA",1331,72,5797,7200
"2004","IDAHO","NEZ PERCE",6476,215,11009,17700
"2004","IDAHO","ONEIDA",304,40,1789,2133
"2004","IDAHO","OWYHEE",685,46,2859,3590
"2004","IDAHO","PAYETTE",1848,76,6256,8180
"2004","IDAHO","POWER",829,24,2105,2958
"2004","IDAHO","SHOSHONE",2331,84,2922,5337
"2004","IDAHO","TETON",1416,39,2235,3690
"2004","IDAHO","TWIN FALLS",6458,305,19672,26435
"2004","IDAHO","VALLEY",1843,66,2863,4772
"2004","IDAHO","WASHINGTON",1033,52,3274,4359
"2004","ILLINOIS","ADAMS",10511,132,20834,31477
"2004","ILLINOIS","ALEXANDER",2016,26,1831,3873
"2004","ILLINOIS","BOND",3228,73,4068,7369
"2004","ILLINOIS","BOONE",8286,123,11132,19541
"2004","ILLINOIS","BROWN",895,11,1679,2585
"2004","ILLINOIS","BUREAU",7961,119,9822,17902
"2004","ILLINOIS","CALHOUN",1367,22,1317,2706
"2004","ILLINOIS","CARROLL",3537,64,4534,8135
"2004","ILLINOIS","CASS",2492,45,3163,5700
"2004","ILLINOIS","CHAMPAIGN",41524,1014,39896,82434
"2004","ILLINOIS","CHRISTIAN",6112,111,9044,15267
"2004","ILLINOIS","CLARK",2877,48,5082,8007
"2004","ILLINOIS","CLAY",2101,37,4416,6554
"2004","ILLINOIS","CLINTON",6797,115,10219,17131
"2004","ILLINOIS","COLES",9566,199,13015,22780
"2004","ILLINOIS","COOK",1439724,12305,597405,2049434
"2004","ILLINOIS","CRAWFORD",3194,55,6083,9332
"2004","ILLINOIS","CUMBERLAND",1862,57,3497,5416
"2004","ILLINOIS","DE WITT",2836,42,4920,7798
"2004","ILLINOIS","DEKALB",19263,410,21095,40768
"2004","ILLINOIS","DOUGLAS",2767,71,5702,8540
"2004","ILLINOIS","DUPAGE",180097,3447,218902,402446
"2004","ILLINOIS","EDGAR",3093,78,5258,8429
"2004","ILLINOIS","EDWARDS",930,22,2412,3364
"2004","ILLINOIS","EFFINGHAM",4388,116,11774,16278
"2004","ILLINOIS","FAYETTE",3571,98,5880,9549
"2004","ILLINOIS","FORD",1912,56,4511,6479
"2004","ILLINOIS","FRANKLIN",8816,148,10388,19352
"2004","ILLINOIS","FULTON",9080,137,7818,17035
"2004","ILLINOIS","GALLATIN",1573,33,1619,3225
"2004","ILLINOIS","GREENE",2457,52,3559,6068
"2004","ILLINOIS","GRUNDY",8463,170,11198,19831
"2004","ILLINOIS","HAMILTON",1814,47,2653,4514
"2004","ILLINOIS","HANCOCK",3975,87,5837,9899
"2004","ILLINOIS","HARDIN",923,13,1501,2437
"2004","ILLINOIS","HENDERSON",2269,27,1857,4153
"2004","ILLINOIS","HENRY",11877,152,13212,25241
"2004","ILLINOIS","IROQUOIS",3832,89,9914,13835
"2004","ILLINOIS","JACKSON",14300,336,11190,25826
"2004","ILLINOIS","JASPER",1781,26,3529,5336
"2004","ILLINOIS","JEFFERSON",6713,75,10160,16948
"2004","ILLINOIS","JERSEY",4597,105,5435,10137
"2004","ILLINOIS","JO DAVIESS",5311,99,6174,11584
"2004","ILLINOIS","JOHNSON",1813,55,3997,5865
"2004","ILLINOIS","KANE",75922,1434,94359,171715
"2004","ILLINOIS","KANKAKEE",20003,294,24739,45036
"2004","ILLINOIS","KENDALL",12374,254,19774,32402
"2004","ILLINOIS","KNOX",13403,194,11111,24708
"2004","ILLINOIS","LAKE",134352,1862,139081,275295
"2004","ILLINOIS","LASALLE",24263,365,26101,50729
"2004","ILLINOIS","LAWRENCE",2518,49,4162,6729
"2004","ILLINOIS","LEE",6416,153,9307,15876
"2004","ILLINOIS","LIVINGSTON",5632,91,10316,16039
"2004","ILLINOIS","LOGAN",4273,82,9112,13467
"2004","ILLINOIS","MACON",23341,287,28118,51746
"2004","ILLINOIS","MACOUPIN",11193,179,11413,22785
"2004","ILLINOIS","MADISON",63399,895,59384,123678
"2004","ILLINOIS","MARION",7694,117,9413,17224
"2004","ILLINOIS","MARSHALL",2806,44,3734,6584
"2004","ILLINOIS","MASON",3215,61,3907,7183
"2004","ILLINOIS","MASSAC",2805,41,4578,7424
"2004","ILLINOIS","MCDONOUGH",7119,154,7656,14929
"2004","ILLINOIS","MCHENRY",50330,1206,76412,127948
"2004","ILLINOIS","MCLEAN",29877,467,41276,71620
"2004","ILLINOIS","MENARD",2137,29,4408,6574
"2004","ILLINOIS","MERCER",4512,57,4405,8974
"2004","ILLINOIS","MONROE",6788,114,9468,16370
"2004","ILLINOIS","MONTGOMERY",5979,100,6851,12930
"2004","ILLINOIS","MORGAN",5650,138,9392,15180
"2004","ILLINOIS","MOULTRIE",2388,50,4028,6466
"2004","ILLINOIS","OGLE",9018,155,14918,24091
"2004","ILLINOIS","PEORIA",41121,599,41051,82771
"2004","ILLINOIS","PERRY",4770,66,5589,10425
"2004","ILLINOIS","PIATT",3124,70,5392,8586
"2004","ILLINOIS","PIKE",2849,99,5032,7980
"2004","ILLINOIS","POPE",918,18,1500,2436
"2004","ILLINOIS","PULASKI",1372,16,1720,3108
"2004","ILLINOIS","PUTNAM",1704,25,1623,3352
"2004","ILLINOIS","RANDOLPH",6771,109,8076,14956
"2004","ILLINOIS","RICHLAND",2529,67,5153,7749
"2004","ILLINOIS","ROCK ISLAND",39880,429,29663,69972
"2004","ILLINOIS","SALINE",4697,60,7057,11814
"2004","ILLINOIS","SANGAMON",38630,841,55904,95375
"2004","ILLINOIS","SCHUYLER",1594,34,2403,4031
"2004","ILLINOIS","SCOTT",927,13,1696,2636
"2004","ILLINOIS","SHELBY",3744,80,6753,10577
"2004","ILLINOIS","ST. CLAIR",62410,576,50203,113189
"2004","ILLINOIS","STARK",1189,31,1841,3061
"2004","ILLINOIS","STEPHENSON",8913,195,12212,21320
"2004","ILLINOIS","TAZEWELL",25814,466,36058,62338
"2004","ILLINOIS","UNION",3735,51,5333,9119
"2004","ILLINOIS","VERMILION",14726,257,18731,33714
"2004","ILLINOIS","WABASH",1752,42,4212,6006
"2004","ILLINOIS","WARREN",3938,45,4474,8457
"2004","ILLINOIS","WASHINGTON",2986,46,5072,8104
"2004","ILLINOIS","WAYNE",2139,46,6102,8287
"2004","ILLINOIS","WHITE",3071,50,5180,8301
"2004","ILLINOIS","WHITESIDE",13723,191,12959,26873
"2004","ILLINOIS","WILL",115625,1686,129098,246409
"2004","ILLINOIS","WILLIAMSON",11685,189,18086,29960
"2004","ILLINOIS","WINNEBAGO",59740,903,60782,121425
"2004","ILLINOIS","WOODFORD",6005,99,12698,18802
"2004","INDIANA","ADAMS",3512,94,9734,13340
"2004","INDIANA","ALLEN",46710,886,82013,129609
"2004","INDIANA","BARTHOLOMEW",9191,231,19093,28515
"2004","INDIANA","BENTON",1135,60,2797,3992
"2004","INDIANA","BLACKFORD",1903,30,3447,5380
"2004","INDIANA","BOONE",5636,207,17055,22898
"2004","INDIANA","BROWN",2730,88,4512,7330
"2004","INDIANA","CARROLL",2689,81,5868,8638
"2004","INDIANA","CASS",4315,136,9480,13931
"2004","INDIANA","CLARK",17648,194,24495,42337
"2004","INDIANA","CLAY",3333,89,7361,10783
"2004","INDIANA","CLINTON",3335,71,8471,11877
"2004","INDIANA","CRAWFORD",1932,33,2609,4574
"2004","INDIANA","DAVIESS",2573,90,7936,10599
"2004","INDIANA","DEARBORN",6596,142,14231,20969
"2004","INDIANA","DECATUR",2621,79,7499,10199
"2004","INDIANA","DEKALB",4810,125,10468,15403
"2004","INDIANA","DELAWARE",20436,439,27064,47939
"2004","INDIANA","DUBOIS",5210,130,11726,17066
"2004","INDIANA","ELKHART",17966,447,42967,61380
"2004","INDIANA","FAYETTE",3626,81,5761,9468
"2004","INDIANA","FLOYD",13857,156,19877,33890
"2004","INDIANA","FOUNTAIN",2477,67,5260,7804
"2004","INDIANA","FRANKLIN",2925,90,6977,9992
"2004","INDIANA","FULTON",2607,69,6027,8703
"2004","INDIANA","GIBSON",5378,103,9133,14614
"2004","INDIANA","GRANT",8509,182,18769,27460
"2004","INDIANA","GREENE",4606,137,8609,13352
"2004","INDIANA","HAMILTON",26388,631,77887,104906
"2004","INDIANA","HANCOCK",6912,184,20771,27867
"2004","INDIANA","HARRISON",6171,124,11015,17310
"2004","INDIANA","HENDRICKS",13548,324,38430,52302
"2004","INDIANA","HENRY",7176,191,13137,20504
"2004","INDIANA","HOWARD",12998,309,23714,37021
"2004","INDIANA","HUNTINGTON",3877,133,11617,15627
"2004","INDIANA","JACKSON",5092,134,11083,16309
"2004","INDIANA","JASPER",3678,110,8056,11844
"2004","INDIANA","JAY",2740,65,5427,8232
"2004","INDIANA","JEFFERSON",5117,91,7763,12971
"2004","INDIANA","JENNINGS",3538,115,6864,10517
"2004","INDIANA","JOHNSON",13109,381,37765,51255
"2004","INDIANA","KNOX",5649,107,9990,15746
"2004","INDIANA","KOSCIUSKO",5977,247,22136,28360
"2004","INDIANA","LAGRANGE",2523,50,6430,9003
"2004","INDIANA","LAKE",114743,1376,71903,188022
"2004","INDIANA","LAPORTE",21114,576,20916,42606
"2004","INDIANA","LAWRENCE",5346,145,12207,17698
"2004","INDIANA","MADISON",21882,447,32526,54855
"2004","INDIANA","MARION",162249,2517,156072,320838
"2004","INDIANA","MARSHALL",5593,147,12074,17814
"2004","INDIANA","MARTIN",1522,60,3414,4996
"2004","INDIANA","MIAMI",3886,142,9600,13628
"2004","INDIANA","MONROE",26965,668,22834,50467
"2004","INDIANA","MONTGOMERY",3536,111,10901,14548
"2004","INDIANA","MORGAN",6650,182,19197,26029
"2004","INDIANA","NEWTON",2032,59,3757,5848
"2004","INDIANA","NOBLE",4703,117,10859,15679
"2004","INDIANA","OHIO",1139,23,1796,2958
"2004","INDIANA","ORANGE",2885,84,5683,8652
"2004","INDIANA","OWEN",2536,68,5000,7604
"2004","INDIANA","PARKE",2362,59,4550,6971
"2004","INDIANA","PERRY",4131,47,4137,8315
"2004","INDIANA","PIKE",2418,49,3745,6212
"2004","INDIANA","PORTER",29388,691,34794,64873
"2004","INDIANA","POSEY",4085,68,7833,11986
"2004","INDIANA","PULASKI",1750,67,3797,5614
"2004","INDIANA","PUTNAM",4103,125,8908,13136
"2004","INDIANA","RANDOLPH",3812,108,7172,11092
"2004","INDIANA","RIPLEY",3510,100,8224,11834
"2004","INDIANA","RUSH",2000,58,5363,7421
"2004","INDIANA","SCOTT",3822,62,4793,8677
"2004","INDIANA","SHELBY",4519,111,11397,16027
"2004","INDIANA","SPENCER",3920,70,5934,9924
"2004","INDIANA","ST. JOSEPH",52637,728,55254,108619
"2004","INDIANA","STARKE",3987,104,4846,8937
"2004","INDIANA","STEUBEN",4345,127,8433,12905
"2004","INDIANA","SULLIVAN",3341,54,4999,8394
"2004","INDIANA","SWITZERLAND",1479,31,2161,3671
"2004","INDIANA","TIPPECANOE",20818,645,30897,52360
"2004","INDIANA","TIPTON",2203,61,5628,7892
"2004","INDIANA","UNION",1045,33,2266,3344
"2004","INDIANA","VANDERBURGH",28767,424,41463,70654
"2004","INDIANA","VERMILLION",3424,57,3536,7017
"2004","INDIANA","VIGO",18426,330,20988,39744
"2004","INDIANA","WABASH",3920,75,9607,13602
"2004","INDIANA","WARREN",1356,39,2565,3960
"2004","INDIANA","WARRICK",8980,115,16930,26025
"2004","INDIANA","WASHINGTON",3879,86,6915,10880
"2004","INDIANA","WAYNE",10775,296,16586,27657
"2004","INDIANA","WELLS",3112,74,9168,12354
"2004","INDIANA","WHITE",3277,115,6974,10366
"2004","INDIANA","WHITLEY",3880,89,9512,13481
"2004","IOWA","ADAIR",1844,32,2402,4278
"2004","IOWA","ADAMS",977,31,1317,2325
"2004","IOWA","ALLAMAKEE",3449,83,3530,7062
"2004","IOWA","APPANOOSE",3063,47,3340,6450
"2004","IOWA","AUDUBON",1608,26,1958,3592
"2004","IOWA","BENTON",6747,96,6658,13501
"2004","IOWA","BLACK HAWK",35392,469,28046,63907
"2004","IOWA","BOONE",7027,112,6870,14009
"2004","IOWA","BREMER",6025,89,6665,12779
"2004","IOWA","BUCHANAN",5608,70,4797,10475
"2004","IOWA","BUENA VISTA",3520,83,4887,8490
"2004","IOWA","BUTLER",3001,57,4417,7475
"2004","IOWA","CALHOUN",2243,44,3255,5542
"2004","IOWA","CARROLL",4689,73,5762,10524
"2004","IOWA","CASS",2679,68,4796,7543
"2004","IOWA","CEDAR",4747,78,4869,9694
"2004","IOWA","CERRO GORDO",13372,184,10960,24516
"2004","IOWA","CHEROKEE",2988,50,3758,6796
"2004","IOWA","CHICKASAW",3708,58,3040,6806
"2004","IOWA","CLARKE",2323,43,2200,4566
"2004","IOWA","CLAY",3547,143,4898,8588
"2004","IOWA","CLAYTON",4736,120,4312,9168
"2004","IOWA","CLINTON",13813,205,10666,24684
"2004","IOWA","CRAWFORD",3220,67,3955,7242
"2004","IOWA","DALLAS",10917,193,15183,26293
"2004","IOWA","DAVIS",1731,39,2148,3918
"2004","IOWA","DECATUR",1859,64,2088,4011
"2004","IOWA","DELAWARE",4227,65,4908,9200
"2004","IOWA","DES MOINES",12456,197,8221,20874
"2004","IOWA","DICKINSON",4140,76,5337,9553
"2004","IOWA","DUBUQUE",26561,382,20100,47043
"2004","IOWA","EMMET",2405,54,2697,5156
"2004","IOWA","FAYETTE",5185,79,5128,10392
"2004","IOWA","FLOYD",4349,73,3745,8167
"2004","IOWA","FRANKLIN",2340,53,3128,5521
"2004","IOWA","FREMONT",1510,39,2362,3911
"2004","IOWA","GREENE",2459,36,2618,5113
"2004","IOWA","GRUNDY",2386,34,4429,6849
"2004","IOWA","GUTHRIE",2614,55,3325,5994
"2004","IOWA","HAMILTON",3895,73,4367,8335
"2004","IOWA","HANCOCK",2484,53,3368,5905
"2004","IOWA","HARDIN",4015,59,4875,8949
"2004","IOWA","HARRISON",2906,94,4680,7680
"2004","IOWA","HENRY",4127,110,5220,9457
"2004","IOWA","HOWARD",2614,55,2028,4697
"2004","IOWA","HUMBOLDT",2146,42,3162,5350
"2004","IOWA","IDA",1415,17,2342,3774
"2004","IOWA","IOWA",3841,69,4544,8454
"2004","IOWA","JACKSON",5656,113,4242,10011
"2004","IOWA","JASPER",10430,170,9462,20062
"2004","IOWA","JEFFERSON",4490,143,3648,8281
"2004","IOWA","JOHNSON",41847,811,22715,65373
"2004","IOWA","JONES",5054,90,4834,9978
"2004","IOWA","KEOKUK",2294,67,3119,5480
"2004","IOWA","KOSSUTH",4132,84,5042,9258
"2004","IOWA","LEE",10152,234,7472,17858
"2004","IOWA","LINN",60442,856,49442,110740
"2004","IOWA","LOUISA",2297,47,2572,4916
"2004","IOWA","LUCAS",1987,41,2543,4571
"2004","IOWA","LYON",1303,47,4751,6101
"2004","IOWA","MADISON",3380,86,4538,8004
"2004","IOWA","MAHASKA",3790,80,6858,10728
"2004","IOWA","MARION",6574,132,9990,16696
"2004","IOWA","MARSHALL",9443,164,9557,19164
"2004","IOWA","MILLS",2308,76,4556,6940
"2004","IOWA","MITCHELL",2785,49,2646,5480
"2004","IOWA","MONONA",2397,46,2575,5018
"2004","IOWA","MONROE",1855,41,2067,3963
"2004","IOWA","MONTGOMERY",1899,56,3601,5556
"2004","IOWA","MUSCATINE",9542,155,9020,18717
"2004","IOWA","O'BRIEN",2330,73,5328,7731
"2004","IOWA","OSCEOLA",934,37,2295,3266
"2004","IOWA","PAGE",2211,59,5243,7513
"2004","IOWA","PALO ALTO",2482,35,2674,5191
"2004","IOWA","PLYMOUTH",4278,134,7810,12222
"2004","IOWA","POCAHONTAS",1822,50,2441,4313
"2004","IOWA","POLK",105218,1572,95828,202618
"2004","IOWA","POTTAWATTAMIE",16906,356,24558,41820
"2004","IOWA","POWESHIEK",5043,83,4965,10091
"2004","IOWA","RINGGOLD",1286,26,1466,2778
"2004","IOWA","SAC",2215,31,3128,5374
"2004","IOWA","SCOTT",42122,642,39958,82722
"2004","IOWA","SHELBY",2355,59,4256,6670
"2004","IOWA","SIOUX",2259,82,14229,16570
"2004","IOWA","STORY",23296,537,20819,44652
"2004","IOWA","TAMA",4487,58,4456,9001
"2004","IOWA","TAYLOR",1252,30,1908,3190
"2004","IOWA","UNION",2747,66,3165,5978
"2004","IOWA","VAN BUREN",1568,57,2211,3836
"2004","IOWA","WAPELLO",9125,179,7403,16707
"2004","IOWA","WARREN",10730,163,12160,23053
"2004","IOWA","WASHINGTON",4595,116,5977,10688
"2004","IOWA","WAYNE",1379,21,1733,3133
"2004","IOWA","WEBSTER",9561,111,8959,18631
"2004","IOWA","WINNEBAGO",2707,70,3175,5952
"2004","IOWA","WINNESHIEK",5354,106,5324,10784
"2004","IOWA","WOODBURY",21455,289,22451,44195
"2004","IOWA","WORTH",2286,42,1795,4123
"2004","IOWA","WRIGHT",2930,42,3631,6603
"2004","KANSAS","ALLEN",1922,84,3867,5873
"2004","KANSAS","ANDERSON",1295,68,2500,3863
"2004","KANSAS","ATCHISON",3120,118,3880,7118
"2004","KANSAS","BARBER",588,33,1782,2403
"2004","KANSAS","BARTON",2874,166,8666,11706
"2004","KANSAS","BOURBON",2216,98,4372,6686
"2004","KANSAS","BROWN",1268,58,3092,4418
"2004","KANSAS","BUTLER",7495,347,18438,26280
"2004","KANSAS","CHASE",418,28,1055,1501
"2004","KANSAS","CHAUTAUQUA",404,27,1529,1960
"2004","KANSAS","CHEROKEE",3726,104,6083,9913
"2004","KANSAS","CHEYENNE",320,19,1353,1692
"2004","KANSAS","CLARK",257,20,1014,1291
"2004","KANSAS","CLAY",793,43,3174,4010
"2004","KANSAS","CLOUD",1210,72,3221,4503
"2004","KANSAS","COFFEY",1093,56,3259,4408
"2004","KANSAS","COMANCHE",200,11,770,981
"2004","KANSAS","COWLEY",4818,222,9407,14447
"2004","KANSAS","CRAWFORD",7617,284,8626,16527
"2004","KANSAS","DECATUR",355,30,1355,1740
"2004","KANSAS","DICKINSON",2364,132,6295,8791
"2004","KANSAS","DONIPHAN",1065,47,2491,3603
"2004","KANSAS","DOUGLAS",28634,933,20544,50111
"2004","KANSAS","EDWARDS",386,26,1084,1496
"2004","KANSAS","ELK",369,27,1119,1515
"2004","KANSAS","ELLIS",4033,263,7891,12187
"2004","KANSAS","ELLSWORTH",801,42,2259,3102
"2004","KANSAS","FINNEY",2351,103,7479,9933
"2004","KANSAS","FORD",2286,98,6632,9016
"2004","KANSAS","FRANKLIN",3921,164,7391,11476
"2004","KANSAS","GEARY",2531,94,4703,7328
"2004","KANSAS","GOVE",247,24,1196,1467
"2004","KANSAS","GRAHAM",334,24,1082,1440
"2004","KANSAS","GRANT",561,28,2169,2758
"2004","KANSAS","GRAY",408,21,1816,2245
"2004","KANSAS","GREELEY",138,13,584,735
"2004","KANSAS","GREENWOOD",911,51,2282,3244
"2004","KANSAS","HAMILTON",229,13,888,1130
"2004","KANSAS","HARPER",727,49,2154,2930
"2004","KANSAS","HARVEY",5331,245,9534,15110
"2004","KANSAS","HASKELL",227,16,1356,1599
"2004","KANSAS","HODGEMAN",223,7,953,1183
"2004","KANSAS","JACKSON",2064,94,3730,5888
"2004","KANSAS","JEFFERSON",3253,132,5408,8793
"2004","KANSAS","JEWELL",385,35,1495,1915
"2004","KANSAS","JOHNSON",97866,2718,158103,258687
"2004","KANSAS","KEARNY",272,6,1177,1455
"2004","KANSAS","KINGMAN",904,59,2801,3764
"2004","KANSAS","KIOWA",256,34,1275,1565
"2004","KANSAS","LABETTE",3615,124,5400,9139
"2004","KANSAS","LANE",181,10,823,1014
"2004","KANSAS","LEAVENWORTH",11039,343,15949,27331
"2004","KANSAS","LINCOLN",391,41,1368,1800
"2004","KANSAS","LINN",1631,62,3048,4741
"2004","KANSAS","LOGAN",248,20,1255,1523
"2004","KANSAS","LYON",5234,255,7951,13440
"2004","KANSAS","MARION",1536,107,4516,6159
"2004","KANSAS","MARSHALL",1789,58,3261,5108
"2004","KANSAS","MCPHERSON",3589,183,9595,13367
"2004","KANSAS","MEADE",356,17,1748,2121
"2004","KANSAS","MIAMI",4838,165,9013,14016
"2004","KANSAS","MITCHELL",693,47,2609,3349
"2004","KANSAS","MONTGOMERY",4338,180,9598,14116
"2004","KANSAS","MORRIS",931,44,1961,2936
"2004","KANSAS","MORTON",276,13,1287,1576
"2004","KANSAS","NEMAHA",1355,81,4027,5463
"2004","KANSAS","NEOSHO",2424,102,4705,7231
"2004","KANSAS","NESS",382,29,1407,1818
"2004","KANSAS","NORTON",473,34,2092,2599
"2004","KANSAS","OSAGE",2537,126,4800,7463
"2004","KANSAS","OSBORNE",454,34,1587,2075
"2004","KANSAS","OTTAWA",595,43,2333,2971
"2004","KANSAS","PAWNEE",773,43,2172,2988
"2004","KANSAS","PHILLIPS",557,34,2256,2847
"2004","KANSAS","POTTAWATOMIE",2176,321,6326,8823
"2004","KANSAS","PRATT",1200,63,3121,4384
"2004","KANSAS","RAWLINS",289,17,1414,1720
"2004","KANSAS","RENO",9114,462,17748,27324
"2004","KANSAS","REPUBLIC",607,44,2238,2889
"2004","KANSAS","RICE",1130,64,3182,4376
"2004","KANSAS","RILEY",7908,331,12672,20911
"2004","KANSAS","ROOKS",534,55,2121,2710
"2004","KANSAS","RUSH",517,46,1226,1789
"2004","KANSAS","RUSSELL",810,44,2671,3525
"2004","KANSAS","SALINE",7524,406,15111,23041
"2004","KANSAS","SCOTT",347,28,1924,2299
"2004","KANSAS","SEDGWICK",64839,2459,110381,177679
"2004","KANSAS","SEWARD",1122,45,4272,5439
"2004","KANSAS","SHAWNEE",36264,1125,44188,81577
"2004","KANSAS","SHERIDAN",239,23,1144,1406
"2004","KANSAS","SHERMAN",632,42,2088,2762
"2004","KANSAS","SMITH",540,27,1803,2370
"2004","KANSAS","STAFFORD",506,31,1649,2186
"2004","KANSAS","STANTON",165,5,796,966
"2004","KANSAS","STEVENS",310,19,1936,2265
"2004","KANSAS","SUMNER",3217,179,7092,10488
"2004","KANSAS","THOMAS",816,47,3007,3870
"2004","KANSAS","TREGO",434,27,1225,1686
"2004","KANSAS","WABAUNSEE",1001,72,2531,3604
"2004","KANSAS","WALLACE",112,22,742,876
"2004","KANSAS","WASHINGTON",643,49,2498,3190
"2004","KANSAS","WICHITA",183,10,869,1062
"2004","KANSAS","WILSON",1060,75,3263,4398
"2004","KANSAS","WOODSON",530,29,1204,1763
"2004","KANSAS","WYANDOTTE",34923,559,17919,53401
"2004","KENTUCKY","ADAIR",1764,55,5628,7447
"2004","KENTUCKY","ALLEN",1923,38,5202,7163
"2004","KENTUCKY","ANDERSON",3141,87,6363,9591
"2004","KENTUCKY","BALLARD",1759,29,2389,4177
"2004","KENTUCKY","BARREN",5216,102,10822,16140
"2004","KENTUCKY","BATH",2608,42,2269,4919
"2004","KENTUCKY","BELL",4210,70,6722,11002
"2004","KENTUCKY","BOONE",12391,362,32329,45082
"2004","KENTUCKY","BOURBON",3198,66,4953,8217
"2004","KENTUCKY","BOYD",10132,144,11501,21777
"2004","KENTUCKY","BOYLE",4646,80,7764,12490
"2004","KENTUCKY","BRACKEN",1213,34,2363,3610
"2004","KENTUCKY","BREATHITT",3327,75,2542,5944
"2004","KENTUCKY","BRECKINRIDGE",2884,56,5580,8520
"2004","KENTUCKY","BULLITT",9043,151,19433,28627
"2004","KENTUCKY","BUTLER",1436,33,4109,5578
"2004","KENTUCKY","CALDWELL",2245,38,4066,6349
"2004","KENTUCKY","CALLOWAY",5728,124,9293,15145
"2004","KENTUCKY","CAMPBELL",14253,382,25540,40175
"2004","KENTUCKY","CARLISLE",1102,9,1734,2845
"2004","KENTUCKY","CARROLL",1688,34,2175,3897
"2004","KENTUCKY","CARTER",5577,118,5422,11117
"2004","KENTUCKY","CASEY",1174,38,5109,6321
"2004","KENTUCKY","CHRISTIAN",6970,110,13935,21015
"2004","KENTUCKY","CLARK",5661,116,9540,15317
"2004","KENTUCKY","CLAY",1901,60,5726,7687
"2004","KENTUCKY","CLINTON",952,31,3369,4352
"2004","KENTUCKY","CRITTENDEN",1438,26,2726,4190
"2004","KENTUCKY","CUMBERLAND",848,35,2356,3239
"2004","KENTUCKY","DAVIESS",15788,323,25372,41483
"2004","KENTUCKY","EDMONSON",1856,30,3595,5481
"2004","KENTUCKY","ELLIOTT",2064,22,871,2957
"2004","KENTUCKY","ESTILL",1907,35,3633,5575
"2004","KENTUCKY","FAYETTE",57994,1176,66406,125576
"2004","KENTUCKY","FLEMING",2406,48,3749,6203
"2004","KENTUCKY","FLOYD",11132,141,6612,17885
"2004","KENTUCKY","FRANKLIN",11620,232,12281,24133
"2004","KENTUCKY","FULTON",1340,23,1527,2890
"2004","KENTUCKY","GALLATIN",1188,16,1869,3073
"2004","KENTUCKY","GARRARD",1841,33,4784,6658
"2004","KENTUCKY","GRANT",2818,55,5951,8824
"2004","KENTUCKY","GRAVES",6206,120,9903,16229
"2004","KENTUCKY","GRAYSON",2905,68,7170,10143
"2004","KENTUCKY","GREEN",1312,28,3866,5206
"2004","KENTUCKY","GREENUP",7630,109,8696,16435
"2004","KENTUCKY","HANCOCK",1709,34,2286,4029
"2004","KENTUCKY","HARDIN",11507,307,24627,36441
"2004","KENTUCKY","HARLAN",4332,79,6659,11070
"2004","KENTUCKY","HARRISON",2807,69,4855,7731
"2004","KENTUCKY","HART",2470,45,4269,6784
"2004","KENTUCKY","HENDERSON",8101,133,10467,18701
"2004","KENTUCKY","HENRY",2366,39,4094,6499
"2004","KENTUCKY","HICKMAN",926,21,1395,2342
"2004","KENTUCKY","HOPKINS",6420,109,12314,18843
"2004","KENTUCKY","JACKSON",769,40,4369,5178
"2004","KENTUCKY","JEFFERSON",170158,2626,164566,337350
"2004","KENTUCKY","JESSAMINE",5476,132,12972,18580
"2004","KENTUCKY","JOHNSON",3288,76,5940,9304
"2004","KENTUCKY","KENTON",22834,625,43664,67123
"2004","KENTUCKY","KNOTT",4685,61,2648,7394
"2004","KENTUCKY","KNOX",3822,98,8108,12028
"2004","KENTUCKY","LARUE",1823,34,4111,5968
"2004","KENTUCKY","LAUREL",5297,148,16819,22264
"2004","KENTUCKY","LAWRENCE",2705,53,3755,6513
"2004","KENTUCKY","LEE",878,24,2018,2920
"2004","KENTUCKY","LESLIE",1266,37,3661,4964
"2004","KENTUCKY","LETCHER",4192,72,4801,9065
"2004","KENTUCKY","LEWIS",1667,39,3778,5484
"2004","KENTUCKY","LINCOLN",2796,71,5996,8863
"2004","KENTUCKY","LIVINGSTON",2007,24,2675,4706
"2004","KENTUCKY","LOGAN",3768,61,6815,10644
"2004","KENTUCKY","LYON",1769,24,2132,3925
"2004","KENTUCKY","MADISON",11525,260,18922,30707
"2004","KENTUCKY","MAGOFFIN",2843,39,2836,5718
"2004","KENTUCKY","MARION",3399,50,3905,7354
"2004","KENTUCKY","MARSHALL",6383,89,9049,15521
"2004","KENTUCKY","MARTIN",1504,39,2996,4539
"2004","KENTUCKY","MASON",2644,54,4381,7079
"2004","KENTUCKY","MCCRACKEN",11361,218,18218,29797
"2004","KENTUCKY","MCCREARY",1530,42,4121,5693
"2004","KENTUCKY","MCLEAN",1823,28,2584,4435
"2004","KENTUCKY","MEADE",3724,75,7152,10951
"2004","KENTUCKY","MENIFEE",1284,29,1215,2528
"2004","KENTUCKY","MERCER",3224,59,6745,10028
"2004","KENTUCKY","METCALFE",1472,40,2645,4157
"2004","KENTUCKY","MONROE",1158,28,4657,5843
"2004","KENTUCKY","MONTGOMERY",4506,77,5647,10230
"2004","KENTUCKY","MORGAN",2532,58,2682,5272
"2004","KENTUCKY","MUHLENBERG",6636,94,6749,13479
"2004","KENTUCKY","NELSON",6524,159,10161,16844
"2004","KENTUCKY","NICHOLAS",1332,27,1700,3059
"2004","KENTUCKY","OHIO",3627,90,6311,10028
"2004","KENTUCKY","OLDHAM",8080,251,18801,27132
"2004","KENTUCKY","OWEN",1615,42,3084,4741
"2004","KENTUCKY","OWSLEY",430,11,1558,1999
"2004","KENTUCKY","PENDLETON",1940,40,4045,6025
"2004","KENTUCKY","PERRY",5400,68,6187,11655
"2004","KENTUCKY","PIKE",14002,157,12611,26770
"2004","KENTUCKY","POWELL",2249,24,2687,4960
"2004","KENTUCKY","PULASKI",5829,152,19535,25516
"2004","KENTUCKY","ROBERTSON",413,7,670,1090
"2004","KENTUCKY","ROCKCASTLE",1320,42,4804,6166
"2004","KENTUCKY","ROWAN",4556,87,4063,8706
"2004","KENTUCKY","RUSSELL",1772,40,6009,7821
"2004","KENTUCKY","SCOTT",6325,125,10600,17050
"2004","KENTUCKY","SHELBY",5277,127,10909,16313
"2004","KENTUCKY","SIMPSON",2730,40,4273,7043
"2004","KENTUCKY","SPENCER",1970,36,4816,6822
"2004","KENTUCKY","TAYLOR",2979,69,7247,10295
"2004","KENTUCKY","TODD",1491,21,3242,4754
"2004","KENTUCKY","TRIGG",2046,42,4023,6111
"2004","KENTUCKY","TRIMBLE",1428,30,2332,3790
"2004","KENTUCKY","UNION",2398,45,3534,5977
"2004","KENTUCKY","WARREN",14326,285,25100,39711
"2004","KENTUCKY","WASHINGTON",1724,33,3479,5236
"2004","KENTUCKY","WAYNE",2616,42,5027,7685
"2004","KENTUCKY","WEBSTER",2304,36,3207,5547
"2004","KENTUCKY","WHITLEY",3985,85,9559,13629
"2004","KENTUCKY","WOLFE",1744,26,1385,3155
"2004","KENTUCKY","WOODFORD",4480,85,6937,11502
"2004","LOUISIANA","ACADIA",8937,210,16083,25230
"2004","LOUISIANA","ALLEN",3791,193,5140,9124
"2004","LOUISIANA","ASCENSION",13955,484,24661,39100
"2004","LOUISIANA","ASSUMPTION",5585,184,4966,10735
"2004","LOUISIANA","AVOYELLES",6976,247,8302,15525
"2004","LOUISIANA","BEAUREGARD",3666,145,9470,13281
"2004","LOUISIANA","BIENVILLE",3399,146,3612,7157
"2004","LOUISIANA","BOSSIER",12317,348,30040,42705
"2004","LOUISIANA","CADDO",51739,564,54292,106595
"2004","LOUISIANA","CALCASIEU",32864,759,46075,79698
"2004","LOUISIANA","CALDWELL",1384,60,3308,4752
"2004","LOUISIANA","CAMERON",1367,83,3190,4640
"2004","LOUISIANA","CATAHOULA",1673,62,3219,4954
"2004","LOUISIANA","CLAIBORNE",2854,72,3704,6630
"2004","LOUISIANA","CONCORDIA",3446,107,5427,8980
"2004","LOUISIANA","DE SOTO",5026,99,6211,11336
"2004","LOUISIANA","EAST BATON ROUGE",82298,1401,99943,183642
"2004","LOUISIANA","EAST CARROLL",1980,58,1357,3395
"2004","LOUISIANA","EAST FELICIANA",4091,89,5021,9201
"2004","LOUISIANA","EVANGELINE",5757,273,7949,13979
"2004","LOUISIANA","FRANKLIN",2828,134,6141,9103
"2004","LOUISIANA","GRANT",1977,103,5911,7991
"2004","LOUISIANA","IBERIA",12426,427,19420,32273
"2004","LOUISIANA","IBERVILLE",8259,235,6333,14827
"2004","LOUISIANA","JACKSON",2525,84,5038,7647
"2004","LOUISIANA","JEFFERSON",72136,1645,117882,191663
"2004","LOUISIANA","JEFFERSON DAVIS",4745,207,8055,13007
"2004","LOUISIANA","LA SALLE",1155,68,5015,6238
"2004","LOUISIANA","LAFAYETTE",31210,981,57732,89923
"2004","LOUISIANA","LAFOURCHE",14417,713,22734,37864
"2004","LOUISIANA","LINCOLN",7242,185,10791,18218
"2004","LOUISIANA","LIVINGSTON",9895,382,33976,44253
"2004","LOUISIANA","MADISON",2334,48,2291,4673
"2004","LOUISIANA","MOREHOUSE",5336,164,7471,12971
"2004","LOUISIANA","NATCHITOCHES",7398,307,9261,16966
"2004","LOUISIANA","ORLEANS",152610,1646,42847,197103
"2004","LOUISIANA","OUACHITA",22016,678,41750,64444
"2004","LOUISIANA","PLAQUEMINES",4181,106,7866,12153
"2004","LOUISIANA","POINTE COUPEE",5712,130,5429,11271
"2004","LOUISIANA","RAPIDES",18904,673,34492,54069
"2004","LOUISIANA","RED RIVER",2140,70,2507,4717
"2004","LOUISIANA","RICHLAND",3082,112,5471,8665
"2004","LOUISIANA","SABINE",2743,122,6711,9576
"2004","LOUISIANA","ST. BERNARD",9956,285,19597,29838
"2004","LOUISIANA","ST. CHARLES",8856,234,14747,23837
"2004","LOUISIANA","ST. HELENA",3173,100,2235,5508
"2004","LOUISIANA","ST. JAMES",6407,156,4545,11108
"2004","LOUISIANA","ST. JOHN THE BAPTIST",10305,273,9039,19617
"2004","LOUISIANA","ST. LANDRY",18166,279,18315,36760
"2004","LOUISIANA","ST. MARTIN",10321,408,12095,22824
"2004","LOUISIANA","ST. MARY",9547,270,12877,22694
"2004","LOUISIANA","ST. TAMMANY",24665,788,75139,100592
"2004","LOUISIANA","TANGIPAHOA",15345,609,26181,42135
"2004","LOUISIANA","TENSAS",1469,41,1453,2963
"2004","LOUISIANA","TERREBONNE",13684,532,26358,40574
"2004","LOUISIANA","UNION",3089,172,7457,10718
"2004","LOUISIANA","VERMILION",9085,398,15069,24552
"2004","LOUISIANA","VERNON",4035,162,11032,15229
"2004","LOUISIANA","WASHINGTON",6554,281,11006,17841
"2004","LOUISIANA","WEBSTER",6833,546,11070,18449
"2004","LOUISIANA","WEST BATON ROUGE",4932,81,5822,10835
"2004","LOUISIANA","WEST CARROLL",1231,62,3740,5033
"2004","LOUISIANA","WEST FELICIANA",2214,72,2932,5218
"2004","LOUISIANA","WINN",2056,85,4366,6507
"2004","MAINE","ANDROSCOGGIN",30345,1044,24453,55842
"2004","MAINE","AROOSTOOK",18988,569,17152,36709
"2004","MAINE","CUMBERLAND",76911,2323,56251,135485
"2004","MAINE","FRANKLIN",9410,411,7315,17136
"2004","MAINE","HANCOCK",17299,645,13810,31754
"2004","MAINE","KENNEBEC",33167,1301,28363,62831
"2004","MAINE","KNOX",11430,952,9074,21456
"2004","MAINE","LINCOLN",10548,384,9676,20608
"2004","MAINE","MAINE UOCAVA",0,0,0,0
"2004","MAINE","OXFORD",16825,735,14354,31914
"2004","MAINE","PENOBSCOT",37775,1300,37339,76414
"2004","MAINE","PISCATAQUIS",4378,232,5261,9871
"2004","MAINE","SAGADAHOC",10341,451,9064,19856
"2004","MAINE","SOMERSET",13530,597,12926,27053
"2004","MAINE","WALDO",11259,438,10044,21741
"2004","MAINE","WASHINGTON",7998,291,8207,16496
"2004","MAINE","YORK",53949,1687,45708,101344
"2004","MARYLAND","ALLEGANY",10576,299,18980,29855
"2004","MARYLAND","ANNE ARUNDEL",103324,3112,133231,239667
"2004","MARYLAND","BALTIMORE",182474,4954,166051,353479
"2004","MARYLAND","BALTIMORE CITY",175022,2311,36230,213563
"2004","MARYLAND","CALVERT",15967,367,23017,39351
"2004","MARYLAND","CAROLINE",3810,150,7396,11356
"2004","MARYLAND","CARROLL",22974,1100,55275,79349
"2004","MARYLAND","CECIL",14680,438,22556,37674
"2004","MARYLAND","CHARLES",29354,445,28442,58241
"2004","MARYLAND","DORCHESTER",5411,127,7801,13339
"2004","MARYLAND","FREDERICK",39503,1157,59934,100594
"2004","MARYLAND","GARRETT",3291,108,9085,12484
"2004","MARYLAND","HARFORD",39685,1478,71565,112728
"2004","MARYLAND","HOWARD",72257,1829,59724,133810
"2004","MARYLAND","KENT",4278,107,4900,9285
"2004","MARYLAND","MONTGOMERY",273936,4955,136334,415225
"2004","MARYLAND","PRINCE GEORGE'S",260532,2410,55532,318474
"2004","MARYLAND","QUEEN ANNE'S",7070,235,14489,21794
"2004","MARYLAND","SOMERSET",4034,76,4884,8994
"2004","MARYLAND","ST. MARY'S",13776,415,23725,37916
"2004","MARYLAND","TALBOT",7367,209,11288,18864
"2004","MARYLAND","WASHINGTON",20387,600,36917,57904
"2004","MARYLAND","WICOMICO",15137,368,21998,37503
"2004","MARYLAND","WORCESTER",9648,232,15349,25229
"2004","MASSACHUSETTS","BARNSTABLE",72156,1465,58527,132148
"2004","MASSACHUSETTS","BERKSHIRE",47743,742,16806,65291
"2004","MASSACHUSETTS","BRISTOL",147854,2500,82524,232878
"2004","MASSACHUSETTS","DUKES",7265,130,2602,9997
"2004","MASSACHUSETTS","ESSEX",194068,4051,135114,333233
"2004","MASSACHUSETTS","FRANKLIN",25550,773,11058,37381
"2004","MASSACHUSETTS","HAMPDEN",113710,2004,70925,186639
"2004","MASSACHUSETTS","HAMPSHIRE",51680,1427,21315,74422
"2004","MASSACHUSETTS","MIDDLESEX",440862,10283,237815,688960
"2004","MASSACHUSETTS","NANTUCKET",3608,76,2040,5724
"2004","MASSACHUSETTS","NORFOLK",199392,3982,127763,331137
"2004","MASSACHUSETTS","PLYMOUTH",125178,2516,105603,233297
"2004","MASSACHUSETTS","SUFFOLK",182592,3130,54923,240645
"2004","MASSACHUSETTS","WORCESTER",192142,4400,144094,340636
"2004","MICHIGAN","ALCONA",2871,68,3592,6531
"2004","MICHIGAN","ALGER",2395,52,2318,4765
"2004","MICHIGAN","ALLEGAN",19355,530,34022,53907
"2004","MICHIGAN","ALPENA",7407,139,7665,15211
"2004","MICHIGAN","ANTRIM",5072,168,8379,13619
"2004","MICHIGAN","ARENAC",4076,69,4071,8216
"2004","MICHIGAN","BARAGA",1660,47,1977,3684
"2004","MICHIGAN","BARRY",11312,322,18638,30272
"2004","MICHIGAN","BAY",31049,562,25448,57059
"2004","MICHIGAN","BENZIE",4383,111,5284,9778
"2004","MICHIGAN","BERRIEN",32846,749,41076,74671
"2004","MICHIGAN","BRANCH",7004,179,10784,17967
"2004","MICHIGAN","CALHOUN",29891,683,32093,62667
"2004","MICHIGAN","CASS",9537,196,12964,22697
"2004","MICHIGAN","CHARLEVOIX",5729,196,8214,14139
"2004","MICHIGAN","CHEBOYGAN",5941,148,7798,13887
"2004","MICHIGAN","CHIPPEWA",7203,163,9122,16488
"2004","MICHIGAN","CLARE",6984,154,7088,14226
"2004","MICHIGAN","CLINTON",15483,335,21989,37807
"2004","MICHIGAN","CRAWFORD",3126,92,4017,7235
"2004","MICHIGAN","DELTA",9381,177,9680,19238
"2004","MICHIGAN","DICKINSON",5650,165,7734,13549
"2004","MICHIGAN","EATON",25411,563,29781,55755
"2004","MICHIGAN","EMMET",6846,194,10332,17372
"2004","MICHIGAN","GENESEE",128334,1571,83870,213775
"2004","MICHIGAN","GLADWIN",6343,114,6770,13227
"2004","MICHIGAN","GOGEBIC",4421,96,3935,8452
"2004","MICHIGAN","GRAND TRAVERSE",18256,489,27446,46191
"2004","MICHIGAN","GRATIOT",7377,168,9834,17379
"2004","MICHIGAN","HILLSDALE",7123,289,12804,20216
"2004","MICHIGAN","HOUGHTON",6731,231,8889,15851
"2004","MICHIGAN","HURON",7629,166,9671,17466
"2004","MICHIGAN","INGHAM",76877,1442,54734,133053
"2004","MICHIGAN","IONIA",10647,350,16621,27618
"2004","MICHIGAN","IOSCO",6557,148,7301,14006
"2004","MICHIGAN","IRON",3215,72,3224,6511
"2004","MICHIGAN","ISABELLA",12334,302,11754,24390
"2004","MICHIGAN","JACKSON",31025,741,40029,71795
"2004","MICHIGAN","KALAMAZOO",61462,1174,57147,119783
"2004","MICHIGAN","KALKASKA",3189,107,5084,8380
"2004","MICHIGAN","KENT",116909,2781,171201,290891
"2004","MICHIGAN","KEWEENAW",630,28,781,1439
"2004","MICHIGAN","LAKE",2675,68,2503,5246
"2004","MICHIGAN","LAPEER",18086,505,25556,44147
"2004","MICHIGAN","LEELANAU",6048,136,7733,13917
"2004","MICHIGAN","LENAWEE",20787,550,25675,47012
"2004","MICHIGAN","LIVINGSTON",33991,891,58860,93742
"2004","MICHIGAN","LUCE",1045,35,1749,2829
"2004","MICHIGAN","MACKINAC",2819,74,3706,6599
"2004","MICHIGAN","MACOMB",196160,4084,202166,402410
"2004","MICHIGAN","MANISTEE",6272,173,6295,12740
"2004","MICHIGAN","MARQUETTE",17412,386,14690,32488
"2004","MICHIGAN","MASON",6333,154,8124,14611
"2004","MICHIGAN","MECOSTA",7730,141,9710,17581
"2004","MICHIGAN","MENOMINEE",5326,151,5942,11419
"2004","MICHIGAN","MIDLAND",18355,551,24369,43275
"2004","MICHIGAN","MISSAUKEE",2319,47,5055,7421
"2004","MICHIGAN","MONROE",36089,573,37470,74132
"2004","MICHIGAN","MONTCALM",11471,295,14968,26734
"2004","MICHIGAN","MONTMORENCY",2196,67,3300,5563
"2004","MICHIGAN","MUSKEGON",44282,729,35302,80313
"2004","MICHIGAN","NEWAYGO",9057,208,13608,22873
"2004","MICHIGAN","OAKLAND",319387,5957,316633,641977
"2004","MICHIGAN","OCEANA",5441,179,6677,12297
"2004","MICHIGAN","OGEMAW",5215,127,5454,10796
"2004","MICHIGAN","ONTONAGON",1863,67,2262,4192
"2004","MICHIGAN","OSCEOLA",4467,122,6599,11188
"2004","MICHIGAN","OSCODA",1792,47,2570,4409
"2004","MICHIGAN","OTSEGO",4674,163,7470,12307
"2004","MICHIGAN","OTTAWA",35552,1043,92048,128643
"2004","MICHIGAN","PRESQUE ISLE",3432,102,3982,7516
"2004","MICHIGAN","ROSCOMMON",6810,185,7364,14359
"2004","MICHIGAN","SAGINAW",54887,800,47165,102852
"2004","MICHIGAN","SANILAC",7883,248,12632,20763
"2004","MICHIGAN","SCHOOLCRAFT",2137,37,2267,4441
"2004","MICHIGAN","SHIAWASSEE",16881,363,19407,36651
"2004","MICHIGAN","ST. CLAIR",36174,829,42740,79743
"2004","MICHIGAN","ST. JOSEPH",9648,251,15340,25239
"2004","MICHIGAN","TUSCOLA",12631,318,15389,28338
"2004","MICHIGAN","VAN BUREN",16151,389,17634,34174
"2004","MICHIGAN","WASHTENAW",109953,1856,61455,173264
"2004","MICHIGAN","WAYNE",600047,6931,257750,864728
"2004","MICHIGAN","WEXFORD",6034,160,8966,15160
"2004","MINNESOTA","AITKIN",4539,145,4768,9452
"2004","MINNESOTA","ANOKA",80226,1987,91853,174066
"2004","MINNESOTA","BECKER",6756,250,9795,16801
"2004","MINNESOTA","BELTRAMI",10592,302,10237,21131
"2004","MINNESOTA","BENTON",8059,282,10043,18384
"2004","MINNESOTA","BIG STONE",1536,48,1483,3067
"2004","MINNESOTA","BLUE EARTH",16865,517,15737,33119
"2004","MINNESOTA","BROWN",5158,225,8395,13778
"2004","MINNESOTA","CARLTON",11462,230,6642,18334
"2004","MINNESOTA","CARVER",16456,445,28510,45411
"2004","MINNESOTA","CASS",6835,200,8875,15910
"2004","MINNESOTA","CHIPPEWA",3424,93,3089,6606
"2004","MINNESOTA","CHISAGO",12219,336,15705,28260
"2004","MINNESOTA","CLAY",12989,383,14365,27737
"2004","MINNESOTA","CLEARWATER",1871,52,2438,4361
"2004","MINNESOTA","COOK",1733,81,1489,3303
"2004","MINNESOTA","COTTONWOOD",2726,86,3557,6369
"2004","MINNESOTA","CROW WING",14005,434,19106,33545
"2004","MINNESOTA","DAKOTA",104635,2252,108959,215846
"2004","MINNESOTA","DODGE",4117,158,5593,9868
"2004","MINNESOTA","DOUGLAS",8219,297,11793,20309
"2004","MINNESOTA","FARIBAULT",3767,120,4794,8681
"2004","MINNESOTA","FILLMORE",5825,179,5694,11698
"2004","MINNESOTA","FREEBORN",9733,252,7681,17666
"2004","MINNESOTA","GOODHUE",12103,371,13134,25608
"2004","MINNESOTA","GRANT",1856,70,1893,3819
"2004","MINNESOTA","HENNEPIN",383842,8007,255135,646984
"2004","MINNESOTA","HOUSTON",5276,175,5631,11082
"2004","MINNESOTA","HUBBARD",4741,155,6444,11340
"2004","MINNESOTA","ISANTI",7883,240,11190,19313
"2004","MINNESOTA","ITASCA",13290,372,10705,24367
"2004","MINNESOTA","JACKSON",2652,103,3024,5779
"2004","MINNESOTA","KANABEC",3592,129,4527,8248
"2004","MINNESOTA","KANDIYOHI",9337,308,11704,21349
"2004","MINNESOTA","KITTSON",1333,42,1307,2682
"2004","MINNESOTA","KOOCHICHING",3662,108,3539,7309
"2004","MINNESOTA","LAC QUI PARLE",2390,58,2093,4541
"2004","MINNESOTA","LAKE",4212,90,2769,7071
"2004","MINNESOTA","LAKE OF THE WOODS",921,51,1428,2400
"2004","MINNESOTA","LE SUEUR",6466,212,7746,14424
"2004","MINNESOTA","LINCOLN",1558,48,1736,3342
"2004","MINNESOTA","LYON",5292,178,7203,12673
"2004","MINNESOTA","MAHNOMEN",1339,37,1132,2508
"2004","MINNESOTA","MARSHALL",2308,67,3187,5562
"2004","MINNESOTA","MARTIN",4590,146,6311,11047
"2004","MINNESOTA","MCLEOD",6712,293,11407,18412
"2004","MINNESOTA","MEEKER",5292,188,6854,12334
"2004","MINNESOTA","MILLE LACS",5677,194,7194,13065
"2004","MINNESOTA","MORRISON",6794,266,9698,16758
"2004","MINNESOTA","MOWER",12334,297,7591,20222
"2004","MINNESOTA","MURRAY",2218,61,2719,4998
"2004","MINNESOTA","NICOLLET",8797,255,8689,17741
"2004","MINNESOTA","NOBLES",3898,147,5159,9204
"2004","MINNESOTA","NORMAN",1954,62,1794,3810
"2004","MINNESOTA","OLMSTED",33285,920,37371,71576
"2004","MINNESOTA","OTTER TAIL",12038,406,19734,32178
"2004","MINNESOTA","PENNINGTON",3117,133,3767,7017
"2004","MINNESOTA","PINE",7228,257,7033,14518
"2004","MINNESOTA","PIPESTONE",1900,66,3066,5032
"2004","MINNESOTA","POLK",6729,215,8724,15668
"2004","MINNESOTA","POPE",3301,96,3303,6700
"2004","MINNESOTA","RAMSEY",171846,3635,97096,272577
"2004","MINNESOTA","RED LAKE",963,49,1164,2176
"2004","MINNESOTA","REDWOOD",3104,137,4898,8139
"2004","MINNESOTA","RENVILLE",3787,132,4430,8349
"2004","MINNESOTA","RICE",16425,439,13881,30745
"2004","MINNESOTA","ROCK",2000,80,3111,5191
"2004","MINNESOTA","ROSEAU",2442,114,5355,7911
"2004","MINNESOTA","SAINT LOUIS",77694,1481,39866,119041
"2004","MINNESOTA","SCOTT",23958,626,36055,60639
"2004","MINNESOTA","SHERBURNE",15816,456,25182,41454
"2004","MINNESOTA","SIBLEY",3109,171,4669,7949
"2004","MINNESOTA","STEARNS",32659,1192,41726,75577
"2004","MINNESOTA","STEELE",7994,312,10389,18695
"2004","MINNESOTA","STEVENS",2821,98,3030,5949
"2004","MINNESOTA","SWIFT",3165,89,2481,5735
"2004","MINNESOTA","TODD",5034,235,6945,12214
"2004","MINNESOTA","TRAVERSE",1026,39,1076,2141
"2004","MINNESOTA","WABASHA",5548,167,6120,11835
"2004","MINNESOTA","WADENA",2791,88,4214,7093
"2004","MINNESOTA","WASECA",4179,164,5457,9800
"2004","MINNESOTA","WASHINGTON",61395,1303,65751,128449
"2004","MINNESOTA","WATONWAN",2514,99,2970,5583
"2004","MINNESOTA","WILKIN",1169,55,2303,3527
"2004","MINNESOTA","WINONA",14231,489,12686,27406
"2004","MINNESOTA","WRIGHT",22618,740,36176,59534
"2004","MINNESOTA","YELLOW MEDICINE",2799,81,2878,5758
"2004","MISSISSIPPI","ADAMS",7844,45,6487,14376
"2004","MISSISSIPPI","ALCORN",5425,151,8605,14181
"2004","MISSISSIPPI","AMITE",2973,38,4106,7117
"2004","MISSISSIPPI","ATTALA",3014,49,4882,7945
"2004","MISSISSIPPI","BENTON",2234,33,1962,4229
"2004","MISSISSIPPI","BOLIVAR",8560,145,4722,13427
"2004","MISSISSIPPI","CALHOUN",2211,24,4096,6331
"2004","MISSISSIPPI","CARROLL",1897,28,3652,5577
"2004","MISSISSIPPI","CHICKASAW",4078,72,4193,8343
"2004","MISSISSIPPI","CHOCTAW",1290,20,2598,3908
"2004","MISSISSIPPI","CLAIBORNE",4338,42,941,5321
"2004","MISSISSIPPI","CLARKE",2377,34,5027,7438
"2004","MISSISSIPPI","CLAY",4732,46,4333,9111
"2004","MISSISSIPPI","COAHOMA",6741,132,3643,10516
"2004","MISSISSIPPI","COPIAH",4902,54,6316,11272
"2004","MISSISSIPPI","COVINGTON",3135,49,5010,8194
"2004","MISSISSIPPI","DESOTO",13247,297,35437,48981
"2004","MISSISSIPPI","FORREST",9781,189,15966,25936
"2004","MISSISSIPPI","FRANKLIN",1566,24,2883,4473
"2004","MISSISSIPPI","GEORGE",1715,53,6182,7950
"2004","MISSISSIPPI","GREENE",1419,29,3827,5275
"2004","MISSISSIPPI","GRENADA",4154,52,5844,10050
"2004","MISSISSIPPI","HANCOCK",5023,195,12332,17550
"2004","MISSISSIPPI","HARRISON",22555,474,38781,61810
"2004","MISSISSIPPI","HINDS",51370,626,34269,86265
"2004","MISSISSIPPI","HOLMES",6170,49,1925,8144
"2004","MISSISSIPPI","HUMPHREYS",2975,50,1626,4651
"2004","MISSISSIPPI","ISSAQUENA",510,15,437,962
"2004","MISSISSIPPI","ITAWAMBA",2771,74,6751,9596
"2004","MISSISSIPPI","JACKSON",15046,333,34035,49414
"2004","MISSISSIPPI","JASPER",4081,37,3808,7926
"2004","MISSISSIPPI","JEFFERSON",2798,15,627,3440
"2004","MISSISSIPPI","JEFFERSON DAVIS",2955,138,2667,5760
"2004","MISSISSIPPI","JONES",7344,142,19032,26518
"2004","MISSISSIPPI","KEMPER",2454,28,2107,4589
"2004","MISSISSIPPI","LAFAYETTE",6218,166,9004,15388
"2004","MISSISSIPPI","LAMAR",3876,130,16288,20294
"2004","MISSISSIPPI","LAUDERDALE",10026,134,19395,29555
"2004","MISSISSIPPI","LAWRENCE",2355,48,4119,6522
"2004","MISSISSIPPI","LEAKE",3212,35,4926,8173
"2004","MISSISSIPPI","LEE",9895,237,19878,30010
"2004","MISSISSIPPI","LEFLORE",7240,17,4427,11684
"2004","MISSISSIPPI","LINCOLN",4372,65,9889,14326
"2004","MISSISSIPPI","LOWNDES",7904,202,12642,20748
"2004","MISSISSIPPI","MADISON",12942,191,24015,37148
"2004","MISSISSIPPI","MARION",3828,59,7845,11732
"2004","MISSISSIPPI","MARSHALL",8472,82,5932,14486
"2004","MISSISSIPPI","MONROE",6149,87,9223,15459
"2004","MISSISSIPPI","MONTGOMERY",2422,21,2953,5396
"2004","MISSISSIPPI","NESHOBA",2515,37,7581,10133
"2004","MISSISSIPPI","NEWTON",2274,42,6156,8472
"2004","MISSISSIPPI","NOXUBEE",4293,29,1698,6020
"2004","MISSISSIPPI","OKTIBBEHA",4178,79,5485,9742
"2004","MISSISSIPPI","PANOLA",6540,56,6734,13330
"2004","MISSISSIPPI","PEARL RIVER",4392,117,14612,19121
"2004","MISSISSIPPI","PERRY",1259,22,3729,5010
"2004","MISSISSIPPI","PIKE",7578,90,8547,16215
"2004","MISSISSIPPI","PONTOTOC",2591,95,8375,11061
"2004","MISSISSIPPI","PRENTISS",3306,67,6503,9876
"2004","MISSISSIPPI","QUITMAN",2032,24,1360,3416
"2004","MISSISSIPPI","RANKIN",10738,656,41971,53365
"2004","MISSISSIPPI","SCOTT",3780,31,6364,10175
"2004","MISSISSIPPI","SHARKEY",1553,413,1115,3081
"2004","MISSISSIPPI","SIMPSON",3262,5,6810,10077
"2004","MISSISSIPPI","SMITH",1493,47,5566,7106
"2004","MISSISSIPPI","STONE",1502,56,4072,5630
"2004","MISSISSIPPI","SUNFLOWER",6057,114,3492,9663
"2004","MISSISSIPPI","TALLAHATCHIE",3377,59,2725,6161
"2004","MISSISSIPPI","TATE",4279,59,6663,11001
"2004","MISSISSIPPI","TIPPAH",2983,82,6048,9113
"2004","MISSISSIPPI","TISHOMINGO",2775,102,5288,8165
"2004","MISSISSIPPI","TUNICA",1934,36,845,2815
"2004","MISSISSIPPI","UNION",2710,67,7422,10199
"2004","MISSISSIPPI","WALTHALL",2550,36,3873,6459
"2004","MISSISSIPPI","WARREN",8244,100,11773,20117
"2004","MISSISSIPPI","WASHINGTON",10562,282,7031,17875
"2004","MISSISSIPPI","WAYNE",3155,39,5333,8527
"2004","MISSISSIPPI","WEBSTER",1318,16,3668,5002
"2004","MISSISSIPPI","WILKINSON",2794,31,1563,4388
"2004","MISSISSIPPI","WINSTON",3960,47,5375,9382
"2004","MISSISSIPPI","YALOBUSHA",2656,37,3278,5971
"2004","MISSISSIPPI","YAZOO",4798,301,5595,10694
"2004","MISSOURI","ADAIR",4938,99,6367,11404
"2004","MISSOURI","ANDREW",3069,62,5135,8266
"2004","MISSOURI","ATCHISON",1005,14,2137,3156
"2004","MISSOURI","AUDRAIN",4318,71,6294,10683
"2004","MISSOURI","BARRY",4223,105,9599,13927
"2004","MISSOURI","BARTON",1373,46,4572,5991
"2004","MISSOURI","BATES",3398,64,5004,8466
"2004","MISSOURI","BENTON",3381,53,5575,9009
"2004","MISSOURI","BOLLINGER",1754,39,4102,5895
"2004","MISSOURI","BOONE",37643,602,37801,76046
"2004","MISSOURI","BUCHANAN",17799,339,19812,37950
"2004","MISSOURI","BUTLER",4666,79,11696,16441
"2004","MISSOURI","CALDWELL",1645,30,2593,4268
"2004","MISSOURI","CALLAWAY",6559,106,11108,17773
"2004","MISSOURI","CAMDEN",6296,101,13122,19519
"2004","MISSOURI","CAPE GIRARDEAU",10568,183,23814,34565
"2004","MISSOURI","CARROLL",1568,18,3155,4741
"2004","MISSOURI","CARTER",964,18,1797,2779
"2004","MISSOURI","CASS",16681,283,27253,44217
"2004","MISSOURI","CEDAR",1910,55,4238,6203
"2004","MISSOURI","CHARITON",1892,27,2421,4340
"2004","MISSOURI","CHRISTIAN",9059,187,22102,31348
"2004","MISSOURI","CLARK",1794,43,1899,3736
"2004","MISSOURI","CLAY",44670,597,51193,96460
"2004","MISSOURI","CLINTON",4165,88,5287,9540
"2004","MISSOURI","COLE",11753,196,24752,36701
"2004","MISSOURI","COOPER",2400,50,5058,7508
"2004","MISSOURI","CRAWFORD",3632,63,5686,9381
"2004","MISSOURI","DADE",1104,22,2963,4089
"2004","MISSOURI","DALLAS",2407,64,4788,7259
"2004","MISSOURI","DAVIESS",1402,41,2351,3794
"2004","MISSOURI","DEKALB",1707,38,2941,4686
"2004","MISSOURI","DENT",1865,70,4369,6304
"2004","MISSOURI","DOUGLAS",1741,88,4498,6327
"2004","MISSOURI","DUNKLIN",4901,56,6720,11677
"2004","MISSOURI","FRANKLIN",18556,333,26429,45318
"2004","MISSOURI","GASCONADE",2355,63,4753,7171
"2004","MISSOURI","GENTRY",1201,26,2085,3312
"2004","MISSOURI","GREENE",46657,724,77885,125266
"2004","MISSOURI","GRUNDY",1561,75,3172,4808
"2004","MISSOURI","HARRISON",1279,40,2729,4048
"2004","MISSOURI","HENRY",4461,55,6361,10877
"2004","MISSOURI","HICKORY",2043,32,2791,4866
"2004","MISSOURI","HOLT",811,16,1864,2691
"2004","MISSOURI","HOWARD",1972,34,2915,4921
"2004","MISSOURI","HOWELL",5118,164,11097,16379
"2004","MISSOURI","IRON",2157,45,2477,4679
"2004","MISSOURI","JACKSON",79029,1102,94439,174570
"2004","MISSOURI","JASPER",13002,237,31846,45085
"2004","MISSOURI","JEFFERSON",46057,583,46624,93264
"2004","MISSOURI","JOHNSON",7790,189,12257,20236
"2004","MISSOURI","KANSAS CITY",104625,737,36061,141423
"2004","MISSOURI","KNOX",761,10,1207,1978
"2004","MISSOURI","LACLEDE",4213,78,10578,14869
"2004","MISSOURI","LAFAYETTE",6412,114,9656,16182
"2004","MISSOURI","LAWRENCE",4506,106,11194,15806
"2004","MISSOURI","LEWIS",1754,28,2862,4644
"2004","MISSOURI","LINCOLN",8368,155,11316,19839
"2004","MISSOURI","LINN",2440,36,3422,5898
"2004","MISSOURI","LIVINGSTON",2278,39,4029,6346
"2004","MISSOURI","MACON",2856,41,4673,7570
"2004","MISSOURI","MADISON",1972,41,2905,4918
"2004","MISSOURI","MARIES",1563,36,2825,4424
"2004","MISSOURI","MARION",4568,70,7815,12453
"2004","MISSOURI","MCDONALD",2215,67,5443,7725
"2004","MISSOURI","MERCER",582,28,1207,1817
"2004","MISSOURI","MILLER",2959,75,7797,10831
"2004","MISSOURI","MISSISSIPPI",2374,21,2903,5298
"2004","MISSOURI","MONITEAU",1913,35,4743,6691
"2004","MISSOURI","MONROE",1647,28,2632,4307
"2004","MISSOURI","MONTGOMERY",2147,50,3563,5760
"2004","MISSOURI","MORGAN",3053,61,5657,8771
"2004","MISSOURI","NEW MADRID",3716,37,4154,7907
"2004","MISSOURI","NEWTON",6564,138,17187,23889
"2004","MISSOURI","NODAWAY",3830,63,6226,10119
"2004","MISSOURI","OREGON",1823,81,2769,4673
"2004","MISSOURI","OSAGE",1673,23,4975,6671
"2004","MISSOURI","OZARK",1561,63,3083,4707
"2004","MISSOURI","PEMISCOT",3381,27,3398,6806
"2004","MISSOURI","PERRY",2621,43,5583,8247
"2004","MISSOURI","PETTIS",5801,92,11603,17496
"2004","MISSOURI","PHELPS",6666,160,11874,18700
"2004","MISSOURI","PIKE",3670,56,4314,8040
"2004","MISSOURI","PLATTE",18412,256,23302,41970
"2004","MISSOURI","POLK",3775,92,8586,12453
"2004","MISSOURI","PULASKI",3551,52,8618,12221
"2004","MISSOURI","PUTNAM",772,13,1660,2445
"2004","MISSOURI","RALLS",2031,17,2986,5034
"2004","MISSOURI","RANDOLPH",3586,61,6551,10198
"2004","MISSOURI","RAY",5034,81,5673,10788
"2004","MISSOURI","REYNOLDS",1449,19,1896,3364
"2004","MISSOURI","RIPLEY",1907,53,3693,5653
"2004","MISSOURI","SALINE",4479,71,5389,9939
"2004","MISSOURI","SCHUYLER",894,13,1124,2031
"2004","MISSOURI","SCOTLAND",828,17,1352,2197
"2004","MISSOURI","SCOTT",6057,61,11330,17448
"2004","MISSOURI","SHANNON",1618,38,2511,4167
"2004","MISSOURI","SHELBY",1201,21,2280,3502
"2004","MISSOURI","ST. CHARLES",66855,807,95826,163488
"2004","MISSOURI","ST. CLAIR",1841,26,3098,4965
"2004","MISSOURI","ST. FRANCOIS",10748,98,12087,22933
"2004","MISSOURI","ST. LOUIS CITY",116133,712,27793,144638
"2004","MISSOURI","ST. LOUIS COUNTY",295284,2730,244969,542983
"2004","MISSOURI","STE. GENEVIEVE",4281,74,3791,8146
"2004","MISSOURI","STODDARD",3946,64,9242,13252
"2004","MISSOURI","STONE",4578,77,10534,15189
"2004","MISSOURI","SULLIVAN",1178,31,1880,3089
"2004","MISSOURI","TANEY",5601,101,13578,19280
"2004","MISSOURI","TEXAS",3664,120,7234,11018
"2004","MISSOURI","VERNON",3206,54,5732,8992
"2004","MISSOURI","WARREN",5461,88,7883,13432
"2004","MISSOURI","WASHINGTON",4459,78,4641,9178
"2004","MISSOURI","WAYNE",2250,35,3919,6204
"2004","MISSOURI","WEBSTER",4657,93,10194,14944
"2004","MISSOURI","WORTH",436,5,691,1132
"2004","MISSOURI","WRIGHT",2188,68,6090,8346
"2004","MONTANA","BEAVERHEAD",1103,72,3067,4242
"2004","MONTANA","BIG HORN",2215,68,2028,4311
"2004","MONTANA","BLAINE",1300,44,1424,2768
"2004","MONTANA","BROADWATER",533,42,1778,2353
"2004","MONTANA","CARBON",1847,132,3342,5321
"2004","MONTANA","CARTER",76,10,623,709
"2004","MONTANA","CASCADE",13701,730,19028,33459
"2004","MONTANA","CHOUTEAU",946,62,1913,2921
"2004","MONTANA","CUSTER",1630,121,3297,5048
"2004","MONTANA","DANIELS",326,29,764,1119
"2004","MONTANA","DAWSON",1494,106,2884,4484
"2004","MONTANA","DEER LODGE",2700,118,1725,4543
"2004","MONTANA","FALLON",289,24,1178,1491
"2004","MONTANA","FERGUS",1582,120,4425,6127
"2004","MONTANA","FLATHEAD",11587,1072,26019,38678
"2004","MONTANA","GALLATIN",16405,1044,22392,39841
"2004","MONTANA","GARFIELD",52,13,590,655
"2004","MONTANA","GLACIER",2641,93,1828,4562
"2004","MONTANA","GOLDEN VALLEY",119,7,396,522
"2004","MONTANA","GRANITE",404,57,1144,1605
"2004","MONTANA","HILL",2997,155,3505,6657
"2004","MONTANA","JEFFERSON",1881,143,3844,5868
"2004","MONTANA","JUDITH BASIN",322,20,944,1286
"2004","MONTANA","LAKE",4960,371,7245,12576
"2004","MONTANA","LEWIS AND CLARK",12717,631,16494,29842
"2004","MONTANA","LIBERTY",281,18,734,1033
"2004","MONTANA","LINCOLN",2320,238,5889,8447
"2004","MONTANA","MADISON",983,82,2868,3933
"2004","MONTANA","MCCONE",320,26,791,1137
"2004","MONTANA","MEAGHER",247,28,698,973
"2004","MONTANA","MINERAL",542,53,1242,1837
"2004","MONTANA","MISSOULA",26983,1480,23989,52452
"2004","MONTANA","MUSSELSHELL",538,46,1663,2247
"2004","MONTANA","PARK",3199,247,4771,8217
"2004","MONTANA","PETROLEUM",55,9,228,292
"2004","MONTANA","PHILLIPS",456,37,1677,2170
"2004","MONTANA","PONDERA",956,51,1853,2860
"2004","MONTANA","POWDER RIVER",154,19,856,1029
"2004","MONTANA","POWELL",761,76,1993,2830
"2004","MONTANA","PRAIRIE",181,9,546,736
"2004","MONTANA","RAVALLI",6144,443,13279,19866
"2004","MONTANA","RICHLAND",1120,78,3110,4308
"2004","MONTANA","ROOSEVELT",2195,71,1762,4028
"2004","MONTANA","ROSEBUD",1520,83,1982,3585
"2004","MONTANA","SANDERS",1502,190,3461,5153
"2004","MONTANA","SHERIDAN",846,33,1159,2038
"2004","MONTANA","SILVER BOW",9307,396,6381,16084
"2004","MONTANA","STILLWATER",1025,98,3090,4213
"2004","MONTANA","SWEET GRASS",445,29,1509,1983
"2004","MONTANA","TETON",1047,80,2232,3359
"2004","MONTANA","TOOLE",690,38,1583,2311
"2004","MONTANA","TREASURE",121,13,348,482
"2004","MONTANA","VALLEY",1431,111,2476,4018
"2004","MONTANA","WHEATLAND",250,23,706,979
"2004","MONTANA","WIBAUX",144,9,407,560
"2004","MONTANA","YELLOWSTONE",24120,1263,40903,66286
"2004","NEBRASKA","ADAMS",3791,262,9233,13286
"2004","NEBRASKA","ANTELOPE",613,50,2761,3424
"2004","NEBRASKA","ARTHUR",24,2,240,266
"2004","NEBRASKA","BANNER",56,2,379,437
"2004","NEBRASKA","BLAINE",38,0,301,339
"2004","NEBRASKA","BOONE",546,40,2309,2895
"2004","NEBRASKA","BOX BUTTE",1657,99,3396,5152
"2004","NEBRASKA","BOYD",228,9,911,1148
"2004","NEBRASKA","BROWN",268,39,1426,1733
"2004","NEBRASKA","BUFFALO",4100,286,14222,18608
"2004","NEBRASKA","BURT",1272,47,2349,3668
"2004","NEBRASKA","BUTLER",1068,84,3016,4168
"2004","NEBRASKA","CASS",3619,147,7763,11529
"2004","NEBRASKA","CEDAR",1083,66,3387,4536
"2004","NEBRASKA","CHASE",302,19,1652,1973
"2004","NEBRASKA","CHERRY",483,50,2509,3042
"2004","NEBRASKA","CHEYENNE",893,62,3791,4746
"2004","NEBRASKA","CLAY",743,51,2543,3337
"2004","NEBRASKA","COLFAX",990,54,2589,3633
"2004","NEBRASKA","CUMING",966,53,3330,4349
"2004","NEBRASKA","CUSTER",1040,54,4518,5612
"2004","NEBRASKA","DAKOTA",3027,62,3526,6615
"2004","NEBRASKA","DAWES",1119,66,2809,3994
"2004","NEBRASKA","DAWSON",1728,79,6149,7956
"2004","NEBRASKA","DEUEL",222,11,820,1053
"2004","NEBRASKA","DIXON",938,43,2028,3009
"2004","NEBRASKA","DODGE",5250,206,10716,16172
"2004","NEBRASKA","DOUGLAS",83330,2928,120813,207071
"2004","NEBRASKA","DUNDY",186,9,858,1053
"2004","NEBRASKA","FILLMORE",828,51,2314,3193
"2004","NEBRASKA","FRANKLIN",412,25,1277,1714
"2004","NEBRASKA","FRONTIER",275,32,1160,1467
"2004","NEBRASKA","FURNAS",492,25,1950,2467
"2004","NEBRASKA","GAGE",3655,154,6575,10384
"2004","NEBRASKA","GARDEN",201,12,970,1183
"2004","NEBRASKA","GARFIELD",196,15,806,1017
"2004","NEBRASKA","GOSPER",222,7,890,1119
"2004","NEBRASKA","GRANT",41,3,352,396
"2004","NEBRASKA","GREELEY",361,22,865,1248
"2004","NEBRASKA","HALL",6228,334,14592,21154
"2004","NEBRASKA","HAMILTON",1012,69,3785,4866
"2004","NEBRASKA","HARLAN",398,32,1467,1897
"2004","NEBRASKA","HAYES",66,8,524,598
"2004","NEBRASKA","HITCHCOCK",296,19,1171,1486
"2004","NEBRASKA","HOLT",894,63,4217,5174
"2004","NEBRASKA","HOOKER",64,5,392,461
"2004","NEBRASKA","HOWARD",900,59,2020,2979
"2004","NEBRASKA","JEFFERSON",1352,59,2600,4011
"2004","NEBRASKA","JOHNSON",885,39,1470,2394
"2004","NEBRASKA","KEARNEY",707,51,2621,3379
"2004","NEBRASKA","KEITH",743,38,3356,4137
"2004","NEBRASKA","KEYA PAHA",98,9,442,549
"2004","NEBRASKA","KIMBALL",366,20,1491,1877
"2004","NEBRASKA","KNOX",1086,65,3062,4213
"2004","NEBRASKA","LANCASTER",52747,1998,69764,124509
"2004","NEBRASKA","LINCOLN",4905,238,11056,16199
"2004","NEBRASKA","LOGAN",67,5,357,429
"2004","NEBRASKA","LOUP",68,4,314,386
"2004","NEBRASKA","MADISON",2934,174,10981,14089
"2004","NEBRASKA","MCPHERSON",49,4,259,312
"2004","NEBRASKA","MERRICK",833,53,2771,3657
"2004","NEBRASKA","MORRILL",495,43,1755,2293
"2004","NEBRASKA","NANCE",459,35,1237,1731
"2004","NEBRASKA","NEMAHA",1066,54,2595,3715
"2004","NEBRASKA","NUCKOLLS",541,46,1884,2471
"2004","NEBRASKA","OTOE",2275,93,5018,7386
"2004","NEBRASKA","PAWNEE",481,16,986,1483
"2004","NEBRASKA","PERKINS",262,11,1285,1558
"2004","NEBRASKA","PHELPS",830,41,3872,4743
"2004","NEBRASKA","PIERCE",546,28,2824,3398
"2004","NEBRASKA","PLATTE",2657,200,11130,13987
"2004","NEBRASKA","POLK",549,32,2146,2727
"2004","NEBRASKA","RED WILLOW",1055,74,4129,5258
"2004","NEBRASKA","RICHARDSON",1297,57,2924,4278
"2004","NEBRASKA","ROCK",130,13,740,883
"2004","NEBRASKA","SALINE",2420,75,3071,5566
"2004","NEBRASKA","SARPY",17455,716,40163,58334
"2004","NEBRASKA","SAUNDERS",2884,164,6441,9489
"2004","NEBRASKA","SCOTTS BLUFF",3843,169,10378,14390
"2004","NEBRASKA","SEWARD",2114,98,5353,7565
"2004","NEBRASKA","SHERIDAN",430,33,2136,2599
"2004","NEBRASKA","SHERMAN",541,30,1072,1643
"2004","NEBRASKA","SIOUX",123,9,677,809
"2004","NEBRASKA","STANTON",559,27,2159,2745
"2004","NEBRASKA","THAYER",764,39,2075,2878
"2004","NEBRASKA","THOMAS",60,6,378,444
"2004","NEBRASKA","THURSTON",1212,21,1154,2387
"2004","NEBRASKA","VALLEY",564,26,1801,2391
"2004","NEBRASKA","WASHINGTON",2754,113,7083,9950
"2004","NEBRASKA","WAYNE",1059,55,2971,4085
"2004","NEBRASKA","WEBSTER",557,42,1403,2002
"2004","NEBRASKA","WHEELER",81,6,366,453
"2004","NEBRASKA","YORK",1304,100,5393,6797
"2004","NEVADA","CARSON CITY",9441,494,13171,23106
"2004","NEVADA","CHURCHILL",2705,197,7335,10237
"2004","NEVADA","CLARK",281767,8293,255337,545397
"2004","NEVADA","DOUGLAS",8275,431,15192,23898
"2004","NEVADA","ELKO",3050,321,11938,15309
"2004","NEVADA","ESMERALDA",99,15,367,481
"2004","NEVADA","EUREKA",144,23,571,738
"2004","NEVADA","HUMBOLDT",1361,110,3896,5367
"2004","NEVADA","LANDER",414,37,1602,2053
"2004","NEVADA","LINCOLN",418,50,1579,2047
"2004","NEVADA","LYON",5637,378,11136,17151
"2004","NEVADA","MINERAL",931,60,1336,2327
"2004","NEVADA","NYE",5616,407,8487,14510
"2004","NEVADA","PERSHING",538,38,1341,1917
"2004","NEVADA","STOREY",871,44,1253,2168
"2004","NEVADA","WASHOE",74841,2693,81545,159079
"2004","NEVADA","WHITE PINE",1082,116,2604,3802
"2004","NEW HAMPSHIRE","BELKNAP",14080,298,17920,32298
"2004","NEW HAMPSHIRE","CARROLL",13319,289,14614,28222
"2004","NEW HAMPSHIRE","CHESHIRE",24438,436,16463,41337
"2004","NEW HAMPSHIRE","COOS",8585,191,8143,16919
"2004","NEW HAMPSHIRE","GRAFTON",26180,505,20277,46962
"2004","NEW HAMPSHIRE","HILLSBOROUGH",94121,1582,99724,195427
"2004","NEW HAMPSHIRE","MERRIMACK",39975,620,36060,76655
"2004","NEW HAMPSHIRE","ROCKINGHAM",75437,1260,82069,158766
"2004","NEW HAMPSHIRE","STRAFFORD",32942,513,25825,59280
"2004","NEW HAMPSHIRE","SULLIVAN",11434,220,10142,21796
"2004","NEW JERSEY","ATLANTIC",55746,864,49487,106097
"2004","NEW JERSEY","BERGEN",207666,2745,189833,400244
"2004","NEW JERSEY","BURLINGTON",110411,1609,95936,207956
"2004","NEW JERSEY","CAMDEN",137765,1741,81427,220933
"2004","NEW JERSEY","CAPE MAY",21475,455,28832,50762
"2004","NEW JERSEY","CUMBERLAND",27875,948,24362,53185
"2004","NEW JERSEY","ESSEX",203681,2293,83374,289348
"2004","NEW JERSEY","GLOUCESTER",66835,1096,60033,127964
"2004","NEW JERSEY","HUDSON",127447,1353,60646,189446
"2004","NEW JERSEY","HUNTERDON",26050,742,39888,66680
"2004","NEW JERSEY","MERCER",91580,1326,56604,149510
"2004","NEW JERSEY","MIDDLESEX",166628,2685,126492,295805
"2004","NEW JERSEY","MONMOUTH",133773,2516,163650,299939
"2004","NEW JERSEY","MORRIS",98066,1847,135241,235154
"2004","NEW JERSEY","OCEAN",99839,2263,152204,254306
"2004","NEW JERSEY","PASSAIC",94962,1149,75200,171311
"2004","NEW JERSEY","SALEM",13749,311,15721,29781
"2004","NEW JERSEY","SOMERSET",66476,1295,72508,140279
"2004","NEW JERSEY","SUSSEX",23990,900,44506,69396
"2004","NEW JERSEY","UNION",119372,1498,82517,203387
"2004","NEW JERSEY","WARREN",18044,622,29542,48208
"2004","NEW MEXICO","BERNALILLO",132252,3105,121454,256811
"2004","NEW MEXICO","CATRON",551,15,1427,1993
"2004","NEW MEXICO","CHAVES",6726,206,14773,21705
"2004","NEW MEXICO","CIBOLA",3913,97,3477,7487
"2004","NEW MEXICO","COLFAX",2824,62,3082,5968
"2004","NEW MEXICO","CURRY",3541,96,10649,14286
"2004","NEW MEXICO","DE BACA",281,6,706,993
"2004","NEW MEXICO","DONA ANA",31762,650,29548,61960
"2004","NEW MEXICO","EDDY",6880,122,13268,20270
"2004","NEW MEXICO","GRANT",7095,162,6135,13392
"2004","NEW MEXICO","GUADALUPE",1340,13,914,2267
"2004","NEW MEXICO","HARDING",259,5,380,644
"2004","NEW MEXICO","HIDALGO",861,22,1081,1964
"2004","NEW MEXICO","LEA",3646,105,14430,18181
"2004","NEW MEXICO","LINCOLN",2822,122,6070,9014
"2004","NEW MEXICO","LOS ALAMOS",5206,181,5810,11197
"2004","NEW MEXICO","LUNA",3340,89,4164,7593
"2004","NEW MEXICO","MCKINLEY",13051,221,7351,20623
"2004","NEW MEXICO","MORA",1876,22,928,2826
"2004","NEW MEXICO","OTERO",6433,265,14066,20764
"2004","NEW MEXICO","QUAY",1422,34,2661,4117
"2004","NEW MEXICO","RIO ARRIBA",9753,97,5149,14999
"2004","NEW MEXICO","ROOSEVELT",2082,65,4997,7144
"2004","NEW MEXICO","SAN JUAN",14843,638,29525,45006
"2004","NEW MEXICO","SAN MIGUEL",8683,120,3313,12116
"2004","NEW MEXICO","SANDOVAL",21421,492,22628,44541
"2004","NEW MEXICO","SANTA FE",47074,660,18466,66200
"2004","NEW MEXICO","SIERRA",1926,69,3162,5157
"2004","NEW MEXICO","SOCORRO",4025,130,3696,7851
"2004","NEW MEXICO","TAOS",10987,182,3666,14835
"2004","NEW MEXICO","TORRANCE",2386,95,4026,6507
"2004","NEW MEXICO","UNION",411,16,1454,1881
"2004","NEW MEXICO","VALENCIA",11270,268,14474,26012
"2004","NEW YORK","ALBANY",86213,8617,52369,147199
"2004","NEW YORK","ALLEGANY",6392,984,11894,19270
"2004","NEW YORK","BRONX",276938,12253,53738,342929
"2004","NEW YORK","BROOME",44496,5294,42100,91890
"2004","NEW YORK","CATTARAUGUS",13087,2147,19028,34262
"2004","NEW YORK","CAYUGA",16913,2513,16626,36052
"2004","NEW YORK","CHAUTAUQUA",26369,3839,30734,60942
"2004","NEW YORK","CHEMUNG",16639,1694,20742,39075
"2004","NEW YORK","CHENANGO",9003,1194,11144,21341
"2004","NEW YORK","CLINTON",17040,2063,14633,33736
"2004","NEW YORK","COLUMBIA",15238,2540,13325,31103
"2004","NEW YORK","CORTLAND",10354,1321,11085,22760
"2004","NEW YORK","DELAWARE",8425,1267,11474,21166
"2004","NEW YORK","DUTCHESS",56533,8025,59323,123881
"2004","NEW YORK","ERIE",240563,31377,173198,445138
"2004","NEW YORK","ESSEX",8474,1218,9390,19082
"2004","NEW YORK","FRANKLIN",9286,927,8103,18316
"2004","NEW YORK","FULTON",8919,1254,12042,22215
"2004","NEW YORK","GENESEE",9970,1909,15701,27580
"2004","NEW YORK","GREENE",8607,1632,12159,22398
"2004","NEW YORK","HAMILTON",1120,214,2358,3692
"2004","NEW YORK","HERKIMER",11383,1662,15265,28310
"2004","NEW YORK","JEFFERSON",16342,2210,20248,38800
"2004","NEW YORK","KINGS",494165,34415,159200,687780
"2004","NEW YORK","LEWIS",4417,632,6348,11397
"2004","NEW YORK","LIVINGSTON",11107,1956,16885,29948
"2004","NEW YORK","MADISON",12665,2038,15584,30287
"2004","NEW YORK","MONROE",168088,21519,153374,342981
"2004","NEW YORK","MONTGOMERY",9175,1283,10763,21221
"2004","NEW YORK","NASSAU",317283,27558,273502,618343
"2004","NEW YORK","NEW YORK",509841,27023,104883,641747
"2004","NEW YORK","NIAGARA",45644,6411,44525,96580
"2004","NEW YORK","ONEIDA",39658,6142,49569,95369
"2004","NEW YORK","ONONDAGA",112618,13848,88123,214589
"2004","NEW YORK","ONTARIO",20503,2988,26611,50102
"2004","NEW YORK","ORANGE",61642,8021,75010,144673
"2004","NEW YORK","ORLEANS",5734,1043,9796,16573
"2004","NEW YORK","OSWEGO",23261,3671,24675,51607
"2004","NEW YORK","OTSEGO",12402,1482,12768,26652
"2004","NEW YORK","PUTNAM",18892,3274,24397,46563
"2004","NEW YORK","QUEENS",422609,24505,157948,605062
"2004","NEW YORK","RENSSELAER",34741,5483,32290,72514
"2004","NEW YORK","RICHMOND",66255,8569,85302,160126
"2004","NEW YORK","ROCKLAND",62391,7330,61510,131231
"2004","NEW YORK","SARATOGA",47367,5797,53709,106873
"2004","NEW YORK","SCHENECTADY",34762,4705,30002,69469
"2004","NEW YORK","SCHOHARIE",5455,954,8148,14557
"2004","NEW YORK","SCHUYLER",3290,573,4727,8590
"2004","NEW YORK","SENECA",6771,951,7603,15325
"2004","NEW YORK","ST. LAWRENCE",22173,2272,17310,41755
"2004","NEW YORK","STEUBEN",14090,2128,26066,42284
"2004","NEW YORK","SUFFOLK",307011,39515,292186,638712
"2004","NEW YORK","SULLIVAN",14447,2121,14398,30966
"2004","NEW YORK","TIOGA",9415,1144,13343,23902
"2004","NEW YORK","TOMPKINS",25659,3204,13539,42402
"2004","NEW YORK","ULSTER",45530,6948,35234,87712
"2004","NEW YORK","WARREN",13054,1792,16213,31059
"2004","NEW YORK","WASHINGTON",10295,1660,13148,25103
"2004","NEW YORK","WAYNE",15093,2981,23126,41200
"2004","NEW YORK","WESTCHESTER",224992,19517,151261,395770
"2004","NEW YORK","WYOMING",5894,1085,11185,18164
"2004","NEW YORK","YATES",4062,596,6053,10711
"2004","NORTH CAROLINA","ALAMANCE",20686,187,33302,54175
"2004","NORTH CAROLINA","ALEXANDER",4618,54,10928,15600
"2004","NORTH CAROLINA","ALLEGHANY",1922,22,2883,4827
"2004","NORTH CAROLINA","ANSON",5413,16,3796,9225
"2004","NORTH CAROLINA","ASHE",4477,54,7292,11823
"2004","NORTH CAROLINA","AVERY",1805,41,5678,7524
"2004","NORTH CAROLINA","BEAUFORT",7025,65,12432,19522
"2004","NORTH CAROLINA","BERTIE",4938,37,3057,8032
"2004","NORTH CAROLINA","BLADEN",6109,30,6174,12313
"2004","NORTH CAROLINA","BRUNSWICK",14903,149,22925,37977
"2004","NORTH CAROLINA","BUNCOMBE",51868,654,52491,105013
"2004","NORTH CAROLINA","BURKE",11728,112,18922,30762
"2004","NORTH CAROLINA","CABARRUS",19803,241,40780,60824
"2004","NORTH CAROLINA","CALDWELL",9999,163,21186,31348
"2004","NORTH CAROLINA","CAMDEN",1339,11,2480,3830
"2004","NORTH CAROLINA","CARTERET",7732,127,17716,25575
"2004","NORTH CAROLINA","CASWELL",4539,30,4868,9437
"2004","NORTH CAROLINA","CATAWBA",18858,228,39602,58688
"2004","NORTH CAROLINA","CHATHAM",12897,133,12892,25922
"2004","NORTH CAROLINA","CHEROKEE",3635,47,7517,11199
"2004","NORTH CAROLINA","CHOWAN",2406,13,2967,5386
"2004","NORTH CAROLINA","CLAY",1628,29,3209,4866
"2004","NORTH CAROLINA","CLEVELAND",14215,114,22750,37079
"2004","NORTH CAROLINA","COLUMBUS",10343,75,10773,21191
"2004","NORTH CAROLINA","CRAVEN",14019,162,23575,37756
"2004","NORTH CAROLINA","CUMBERLAND",45788,299,49139,95226
"2004","NORTH CAROLINA","CURRITUCK",2909,54,6013,8976
"2004","NORTH CAROLINA","DARE",6136,67,9345,15548
"2004","NORTH CAROLINA","DAVIDSON",17191,230,42075,59496
"2004","NORTH CAROLINA","DAVIE",4233,75,12372,16680
"2004","NORTH CAROLINA","DUPLIN",6923,49,9611,16583
"2004","NORTH CAROLINA","DURHAM",74524,513,34614,109651
"2004","NORTH CAROLINA","EDGECOMBE",12877,39,8163,21079
"2004","NORTH CAROLINA","FORSYTH",63340,491,75294,139125
"2004","NORTH CAROLINA","FRANKLIN",9286,92,11540,20918
"2004","NORTH CAROLINA","GASTON",20254,249,43252,63755
"2004","NORTH CAROLINA","GATES",2121,8,1924,4053
"2004","NORTH CAROLINA","GRAHAM",1272,22,2693,3987
"2004","NORTH CAROLINA","GRANVILLE",9057,53,9491,18601
"2004","NORTH CAROLINA","GREENE",2665,7,3800,6472
"2004","NORTH CAROLINA","GUILFORD",100042,1018,98254,199314
"2004","NORTH CAROLINA","HALIFAX",11528,31,8088,19647
"2004","NORTH CAROLINA","HARNETT",11563,86,20922,32571
"2004","NORTH CAROLINA","HAYWOOD",11237,150,14545,25932
"2004","NORTH CAROLINA","HENDERSON",15003,206,28025,43234
"2004","NORTH CAROLINA","HERTFORD",5141,49,2942,8132
"2004","NORTH CAROLINA","HOKE",5794,37,5257,11088
"2004","NORTH CAROLINA","HYDE",1048,10,1235,2293
"2004","NORTH CAROLINA","IREDELL",18065,233,38675,56973
"2004","NORTH CAROLINA","JACKSON",6737,86,7351,14174
"2004","NORTH CAROLINA","JOHNSTON",17266,188,36903,54357
"2004","NORTH CAROLINA","JONES",1893,13,2607,4513
"2004","NORTH CAROLINA","LEE",7657,52,11834,19543
"2004","NORTH CAROLINA","LENOIR",10207,33,12939,23179
"2004","NORTH CAROLINA","LINCOLN",9434,93,20052,29579
"2004","NORTH CAROLINA","MACON",5489,87,9448,15024
"2004","NORTH CAROLINA","MADISON",4234,54,5175,9463
"2004","NORTH CAROLINA","MARTIN",5102,16,5334,10452
"2004","NORTH CAROLINA","MCDOWELL",5330,82,10590,16002
"2004","NORTH CAROLINA","MECKLENBURG",166828,1190,155084,323102
"2004","NORTH CAROLINA","MITCHELL",2080,32,5686,7798
"2004","NORTH CAROLINA","MONTGOMERY",4313,22,5745,10080
"2004","NORTH CAROLINA","MOORE",13555,113,24714,38382
"2004","NORTH CAROLINA","NASH",15693,78,21902,37673
"2004","NORTH CAROLINA","NEW HANOVER",35572,324,45351,81247
"2004","NORTH CAROLINA","NORTHAMPTON",5584,10,3176,8770
"2004","NORTH CAROLINA","ONSLOW",11250,137,25890,37277
"2004","NORTH CAROLINA","ORANGE",42910,472,20771,64153
"2004","NORTH CAROLINA","PAMLICO",2335,24,3679,6038
"2004","NORTH CAROLINA","PASQUOTANK",6984,55,6609,13648
"2004","NORTH CAROLINA","PENDER",6999,49,10037,17085
"2004","NORTH CAROLINA","PERQUIMANS",1971,22,2965,4958
"2004","NORTH CAROLINA","PERSON",6198,43,8973,15214
"2004","NORTH CAROLINA","PITT",24924,129,28590,53643
"2004","NORTH CAROLINA","POLK",3787,94,5140,9021
"2004","NORTH CAROLINA","RANDOLPH",12966,173,37771,50910
"2004","NORTH CAROLINA","RICHMOND",8383,53,7709,16145
"2004","NORTH CAROLINA","ROBESON",17868,94,15909,33871
"2004","NORTH CAROLINA","ROCKINGHAM",14430,118,22840,37388
"2004","NORTH CAROLINA","ROWAN",16735,217,34915,51867
"2004","NORTH CAROLINA","RUTHERFORD",8184,131,16343,24658
"2004","NORTH CAROLINA","SAMPSON",9649,39,12600,22288
"2004","NORTH CAROLINA","SCOTLAND",6386,20,5141,11547
"2004","NORTH CAROLINA","STANLY",7650,89,17814,25553
"2004","NORTH CAROLINA","STOKES",5767,64,13583,19414
"2004","NORTH CAROLINA","SURRY",8304,101,17587,25992
"2004","NORTH CAROLINA","SWAIN",2419,32,2593,5044
"2004","NORTH CAROLINA","TRANSYLVANIA",6097,105,9386,15588
"2004","NORTH CAROLINA","TYRRELL",731,4,855,1590
"2004","NORTH CAROLINA","UNION",17974,207,42820,61001
"2004","NORTH CAROLINA","VANCE",8762,31,6884,15677
"2004","NORTH CAROLINA","WAKE",169909,1611,177324,348844
"2004","NORTH CAROLINA","WARREN",5171,16,2840,8027
"2004","NORTH CAROLINA","WASHINGTON",2969,18,2484,5471
"2004","NORTH CAROLINA","WATAUGA",11232,159,12659,24050
"2004","NORTH CAROLINA","WAYNE",15076,87,24883,40046
"2004","NORTH CAROLINA","WILKES",7862,95,19197,27154
"2004","NORTH CAROLINA","WILSON",14206,65,16264,30535
"2004","NORTH CAROLINA","YADKIN",3451,46,11816,15313
"2004","NORTH CAROLINA","YANCEY",4434,57,4940,9431
"2004","NORTH DAKOTA","ADAMS",353,23,915,1291
"2004","NORTH DAKOTA","BARNES",2186,86,3541,5813
"2004","NORTH DAKOTA","BENSON",1196,48,1002,2246
"2004","NORTH DAKOTA","BILLINGS",99,16,449,564
"2004","NORTH DAKOTA","BOTTINEAU",1168,38,2468,3674
"2004","NORTH DAKOTA","BOWMAN",397,39,1280,1716
"2004","NORTH DAKOTA","BURKE",336,21,808,1165
"2004","NORTH DAKOTA","BURLEIGH",11621,616,26577,38814
"2004","NORTH DAKOTA","CASS",26010,1082,39619,66711
"2004","NORTH DAKOTA","CAVALIER",887,35,1522,2444
"2004","NORTH DAKOTA","DICKEY",883,48,1890,2821
"2004","NORTH DAKOTA","DIVIDE",487,30,751,1268
"2004","NORTH DAKOTA","DUNN",571,25,1178,1774
"2004","NORTH DAKOTA","EDDY",534,24,655,1213
"2004","NORTH DAKOTA","EMMONS",611,53,1449,2113
"2004","NORTH DAKOTA","FOSTER",518,29,1219,1766
"2004","NORTH DAKOTA","GOLDEN VALLEY",195,13,719,927
"2004","NORTH DAKOTA","GRAND FORKS",12646,526,17298,30470
"2004","NORTH DAKOTA","GRANT",264,26,952,1242
"2004","NORTH DAKOTA","GRIGGS",505,27,907,1439
"2004","NORTH DAKOTA","HETTINGER",405,45,1044,1494
"2004","NORTH DAKOTA","KIDDER",433,34,902,1369
"2004","NORTH DAKOTA","LAMOURE",712,31,1592,2335
"2004","NORTH DAKOTA","LOGAN",265,21,844,1130
"2004","NORTH DAKOTA","MCHENRY",1030,46,1744,2820
"2004","NORTH DAKOTA","MCINTOSH",436,32,1254,1722
"2004","NORTH DAKOTA","MCKENZIE",847,18,1897,2762
"2004","NORTH DAKOTA","MCLEAN",1664,72,3014,4750
"2004","NORTH DAKOTA","MERCER",1245,87,3285,4617
"2004","NORTH DAKOTA","MORTON",4073,235,8325,12633
"2004","NORTH DAKOTA","MOUNTRAIL",1465,38,1527,3030
"2004","NORTH DAKOTA","NELSON",778,37,1107,1922
"2004","NORTH DAKOTA","OLIVER",310,19,790,1119
"2004","NORTH DAKOTA","PEMBINA",1321,69,2466,3856
"2004","NORTH DAKOTA","PIERCE",686,34,1475,2195
"2004","NORTH DAKOTA","RAMSEY",1885,72,2943,4900
"2004","NORTH DAKOTA","RANSOM",1199,51,1352,2602
"2004","NORTH DAKOTA","RENVILLE",497,19,953,1469
"2004","NORTH DAKOTA","RICHLAND",2821,130,5264,8215
"2004","NORTH DAKOTA","ROLETTE",2564,88,1392,4044
"2004","NORTH DAKOTA","SARGENT",1021,32,1147,2200
"2004","NORTH DAKOTA","SHERIDAN",200,17,727,944
"2004","NORTH DAKOTA","SIOUX",804,17,319,1140
"2004","NORTH DAKOTA","SLOPE",89,8,335,432
"2004","NORTH DAKOTA","STARK",3013,167,7220,10400
"2004","NORTH DAKOTA","STEELE",616,11,586,1213
"2004","NORTH DAKOTA","STUTSMAN",3438,167,6517,10122
"2004","NORTH DAKOTA","TOWNER",606,31,754,1391
"2004","NORTH DAKOTA","TRAILL",1651,54,2543,4248
"2004","NORTH DAKOTA","WALSH",1905,87,3194,5186
"2004","NORTH DAKOTA","WARD",8236,368,17008,25612
"2004","NORTH DAKOTA","WELLS",858,49,1654,2561
"2004","NORTH DAKOTA","WILLIAMS",2512,139,6278,8929
"2004","OHIO","ADAMS",4280,66,7653,11999
"2004","OHIO","ALLEN",16483,206,32585,49274
"2004","OHIO","ASHLAND",8555,194,16171,24920
"2004","OHIO","ASHTABULA",24061,309,21039,45409
"2004","OHIO","ATHENS",18997,200,10847,30044
"2004","OHIO","AUGLAIZE",5904,115,17012,23031
"2004","OHIO","BELMONT",17574,157,15589,33320
"2004","OHIO","BROWN",7140,105,12647,19892
"2004","OHIO","BUTLER",56234,702,109866,166802
"2004","OHIO","CARROLL",6298,117,7695,14110
"2004","OHIO","CHAMPAIGN",6967,90,11718,18775
"2004","OHIO","CLARK",33534,331,34938,68803
"2004","OHIO","CLERMONT",25885,211,62946,89042
"2004","OHIO","CLINTON",5417,59,12938,18414
"2004","OHIO","COLUMBIANA",23426,283,25754,49463
"2004","OHIO","COSHOCTON",6878,87,9277,16242
"2004","OHIO","CRAWFORD",7773,143,13885,21801
"2004","OHIO","CUYAHOGA",448486,3674,221606,673766
"2004","OHIO","DARKE",7849,161,18307,26317
"2004","OHIO","DEFIANCE",6975,144,11393,18512
"2004","OHIO","DELAWARE",27048,265,53142,80455
"2004","OHIO","ERIE",21408,67,18601,40076
"2004","OHIO","FAIRFIELD",24774,384,42697,67855
"2004","OHIO","FAYETTE",4334,47,7375,11756
"2004","OHIO","FRANKLIN",285800,2772,237252,525824
"2004","OHIO","FULTON",8224,90,13639,21953
"2004","OHIO","GALLIA",5364,51,8577,13992
"2004","OHIO","GEAUGA",19840,221,30358,50419
"2004","OHIO","GREENE",30530,365,48377,79272
"2004","OHIO","GUERNSEY",7768,111,9961,17840
"2004","OHIO","HAMILTON",199499,1731,222404,423634
"2004","OHIO","HANCOCK",10343,162,25101,35606
"2004","OHIO","HARDIN",4889,60,8436,13385
"2004","OHIO","HARRISON",3780,55,4274,8109
"2004","OHIO","HENRY",5110,92,9901,15103
"2004","OHIO","HIGHLAND",6194,76,12212,18482
"2004","OHIO","HOCKING",6173,88,6935,13196
"2004","OHIO","HOLMES",2695,57,8466,11218
"2004","OHIO","HURON",10585,173,14834,25592
"2004","OHIO","JACKSON",5699,49,8585,14333
"2004","OHIO","JEFFERSON",19019,163,17184,36366
"2004","OHIO","KNOX",9828,157,17081,27066
"2004","OHIO","LAKE",59049,581,62193,121823
"2004","OHIO","LAWRENCE",12111,138,15457,27706
"2004","OHIO","LICKING",30051,351,49014,79416
"2004","OHIO","LOGAN",6825,102,14471,21398
"2004","OHIO","LORAIN",78965,569,61196,140730
"2004","OHIO","LUCAS",132536,547,87106,220189
"2004","OHIO","MADISON",6200,78,11120,17398
"2004","OHIO","MAHONING",83069,950,48712,132731
"2004","OHIO","MARION",11930,157,17171,29258
"2004","OHIO","MEDINA",36264,420,48183,84867
"2004","OHIO","MEIGS",4437,61,6273,10771
"2004","OHIO","MERCER",5117,122,15649,20888
"2004","OHIO","MIAMI",17611,164,34005,51780
"2004","OHIO","MONROE",4243,62,3424,7729
"2004","OHIO","MONTGOMERY",142977,1215,138361,282553
"2004","OHIO","MORGAN",2873,70,3757,6700
"2004","OHIO","MORROW",5775,79,10475,16329
"2004","OHIO","MUSKINGUM",16421,191,22251,38863
"2004","OHIO","NOBLE",2654,45,3841,6540
"2004","OHIO","OTTAWA",11114,68,12075,23257
"2004","OHIO","PAULDING",3610,64,6205,9879
"2004","OHIO","PERRY",7257,76,7855,15188
"2004","OHIO","PICKAWAY",8578,112,14160,22850
"2004","OHIO","PIKE",5989,67,6519,12575
"2004","OHIO","PORTAGE",40674,389,35583,76646
"2004","OHIO","PREBLE",7274,119,13733,21126
"2004","OHIO","PUTNAM",4392,87,14370,18849
"2004","OHIO","RICHLAND",24645,330,36892,61867
"2004","OHIO","ROSS",13977,463,17229,31669
"2004","OHIO","SANDUSKY",12653,104,16198,28955
"2004","OHIO","SCIOTO",16823,117,18257,35197
"2004","OHIO","SENECA",10958,148,15885,26991
"2004","OHIO","SHELBY",6534,116,16204,22854
"2004","OHIO","STARK",95338,907,92211,188456
"2004","OHIO","SUMMIT",156578,1173,118553,276304
"2004","OHIO","TRUMBULL",66673,495,40976,108144
"2004","OHIO","TUSCARAWAS",18854,225,23825,42904
"2004","OHIO","UNION",6665,96,15869,22630
"2004","OHIO","VAN WERT",4094,54,10678,14826
"2004","OHIO","VINTON",2651,28,3251,5930
"2004","OHIO","WARREN",26043,341,68035,94419
"2004","OHIO","WASHINGTON",12475,146,17480,30101
"2004","OHIO","WAYNE",19786,183,31879,51848
"2004","OHIO","WILLIAMS",6481,118,12040,18639
"2004","OHIO","WOOD",29401,353,33592,63346
"2004","OHIO","WYANDOT",3707,81,7256,11044
"2004","OKLAHOMA","ADAIR",2562,0,4971,7533
"2004","OKLAHOMA","ALFALFA",470,0,2201,2671
"2004","OKLAHOMA","ATOKA",1946,0,3142,5088
"2004","OKLAHOMA","BEAVER",297,0,2272,2569
"2004","OKLAHOMA","BECKHAM",1931,0,5454,7385
"2004","OKLAHOMA","BLAINE",1222,0,3199,4421
"2004","OKLAHOMA","BRYAN",5745,0,8615,14360
"2004","OKLAHOMA","CADDO",3916,0,6491,10407
"2004","OKLAHOMA","CANADIAN",9712,0,33297,43009
"2004","OKLAHOMA","CARTER",6466,0,12178,18644
"2004","OKLAHOMA","CHEROKEE",8623,0,9569,18192
"2004","OKLAHOMA","CHOCTAW",2639,0,3168,5807
"2004","OKLAHOMA","CIMARRON",184,0,1242,1426
"2004","OKLAHOMA","CLEVELAND",34007,0,65720,99727
"2004","OKLAHOMA","COAL",1203,0,1396,2599
"2004","OKLAHOMA","COMANCHE",12022,0,21170,33192
"2004","OKLAHOMA","COTTON",898,0,1742,2640
"2004","OKLAHOMA","CRAIG",2504,0,3894,6398
"2004","OKLAHOMA","CREEK",9929,0,18848,28777
"2004","OKLAHOMA","CUSTER",2801,0,7839,10640
"2004","OKLAHOMA","DELAWARE",5591,0,10017,15608
"2004","OKLAHOMA","DEWEY",408,0,1843,2251
"2004","OKLAHOMA","ELLIS",395,0,1685,2080
"2004","OKLAHOMA","GARFIELD",5586,0,17685,23271
"2004","OKLAHOMA","GARVIN",3707,0,7610,11317
"2004","OKLAHOMA","GRADY",5970,0,14136,20106
"2004","OKLAHOMA","GRANT",571,0,1950,2521
"2004","OKLAHOMA","GREER",719,0,1529,2248
"2004","OKLAHOMA","HARMON",354,0,838,1192
"2004","OKLAHOMA","HARPER",268,0,1397,1665
"2004","OKLAHOMA","HASKELL",2378,0,2946,5324
"2004","OKLAHOMA","HUGHES",2283,0,3066,5349
"2004","OKLAHOMA","JACKSON",2232,0,7024,9256
"2004","OKLAHOMA","JEFFERSON",1057,0,1546,2603
"2004","OKLAHOMA","JOHNSTON",1713,0,2635,4348
"2004","OKLAHOMA","KAY",5957,0,14121,20078
"2004","OKLAHOMA","KINGFISHER",1022,0,5630,6652
"2004","OKLAHOMA","KIOWA",1413,0,2610,4023
"2004","OKLAHOMA","LATIMER",1945,0,2535,4480
"2004","OKLAHOMA","LE FLORE",6741,0,10683,17424
"2004","OKLAHOMA","LINCOLN",4041,0,10149,14190
"2004","OKLAHOMA","LOGAN",4869,0,11474,16343
"2004","OKLAHOMA","LOVE",1538,0,2295,3833
"2004","OKLAHOMA","MAJOR",537,0,3122,3659
"2004","OKLAHOMA","MARSHALL",2088,0,3363,5451
"2004","OKLAHOMA","MAYES",6933,0,9946,16879
"2004","OKLAHOMA","MCCLAIN",3742,0,10041,13783
"2004","OKLAHOMA","MCCURTAIN",3684,0,7472,11156
"2004","OKLAHOMA","MCINTOSH",4488,0,4692,9180
"2004","OKLAHOMA","MURRAY",2130,0,3665,5795
"2004","OKLAHOMA","MUSKOGEE",12585,0,15124,27709
"2004","OKLAHOMA","NOBLE",1335,0,3993,5328
"2004","OKLAHOMA","NOWATA",1660,0,2805,4465
"2004","OKLAHOMA","OKFUSKEE",1743,0,2542,4285
"2004","OKLAHOMA","OKLAHOMA",97298,0,174741,272039
"2004","OKLAHOMA","OKMULGEE",7367,0,8363,15730
"2004","OKLAHOMA","OSAGE",8068,0,11467,19535
"2004","OKLAHOMA","OTTAWA",5086,0,7443,12529
"2004","OKLAHOMA","PAWNEE",2564,0,4412,6976
"2004","OKLAHOMA","PAYNE",10101,0,19560,29661
"2004","OKLAHOMA","PITTSBURG",7452,0,11134,18586
"2004","OKLAHOMA","PONTOTOC",5165,0,9647,14812
"2004","OKLAHOMA","POTTAWATOMIE",8638,0,17215,25853
"2004","OKLAHOMA","PUSHMATAHA",1934,0,2863,4797
"2004","OKLAHOMA","ROGER MILLS",382,0,1388,1770
"2004","OKLAHOMA","ROGERS",11918,0,24976,36894
"2004","OKLAHOMA","SEMINOLE",3648,0,5624,9272
"2004","OKLAHOMA","SEQUOYAH",5910,0,8865,14775
"2004","OKLAHOMA","STEPHENS",5515,0,13646,19161
"2004","OKLAHOMA","TEXAS",1016,0,5450,6466
"2004","OKLAHOMA","TILLMAN",1175,0,2273,3448
"2004","OKLAHOMA","TULSA",90220,0,163452,253672
"2004","OKLAHOMA","WAGONER",9157,0,19081,28238
"2004","OKLAHOMA","WASHINGTON",6862,0,16551,23413
"2004","OKLAHOMA","WASHITA",1340,0,3705,5045
"2004","OKLAHOMA","WOODS",932,0,3166,4098
"2004","OKLAHOMA","WOODWARD",1458,0,6193,7651
"2004","OREGON","BAKER",2616,165,6253,9034
"2004","OREGON","BENTON",26515,760,18460,45735
"2004","OREGON","CLACKAMAS",95129,2180,97691,195000
"2004","OREGON","CLATSOP",10461,345,8503,19309
"2004","OREGON","COLUMBIA",12563,486,11868,24917
"2004","OREGON","COOS",14393,678,18291,33362
"2004","OREGON","CROOK",3024,197,6830,10051
"2004","OREGON","CURRY",5220,247,7332,12799
"2004","OREGON","DESCHUTES",31179,1112,41757,74048
"2004","OREGON","DOUGLAS",18089,939,35956,54984
"2004","OREGON","GILLIAM",370,13,755,1138
"2004","OREGON","GRANT",780,77,3204,4061
"2004","OREGON","HARNEY",839,48,2815,3702
"2004","OREGON","HOOD RIVER",5587,148,4124,9859
"2004","OREGON","JACKSON",44366,1304,56519,102189
"2004","OREGON","JEFFERSON",3243,110,4762,8115
"2004","OREGON","JOSEPHINE",15214,820,26241,42275
"2004","OREGON","KLAMATH",8264,518,22733,31515
"2004","OREGON","LAKE",802,64,3039,3905
"2004","OREGON","LANE",107769,3096,75007,185872
"2004","OREGON","LINCOLN",13753,412,10160,24325
"2004","OREGON","LINN",19940,841,31260,52041
"2004","OREGON","MALHEUR",2577,146,8123,10846
"2004","OREGON","MARION",57671,2048,69900,129619
"2004","OREGON","MORROW",1361,56,2732,4149
"2004","OREGON","MULTNOMAH",259585,4670,98439,362694
"2004","OREGON","POLK",15484,497,19508,35489
"2004","OREGON","SHERMAN",390,20,694,1104
"2004","OREGON","TILLAMOOK",6750,198,7003,13951
"2004","OREGON","UMATILLA",8884,370,17068,26322
"2004","OREGON","UNION",4428,212,8879,13519
"2004","OREGON","WALLOWA",1269,120,3132,4521
"2004","OREGON","WASCO",5691,192,6119,12002
"2004","OREGON","WASHINGTON",121140,2945,107223,231308
"2004","OREGON","WHEELER",245,23,612,880
"2004","OREGON","YAMHILL",17572,731,23839,42142
"2004","PENNSYLVANIA","ADAMS",13764,217,28247,42228
"2004","PENNSYLVANIA","ALLEGHENY",368912,4632,271925,645469
"2004","PENNSYLVANIA","ARMSTRONG",12025,147,18925,31097
"2004","PENNSYLVANIA","BEAVER",42146,481,39916,82543
"2004","PENNSYLVANIA","BEDFORD",6016,57,16606,22679
"2004","PENNSYLVANIA","BERKS",76309,1056,87122,164487
"2004","PENNSYLVANIA","BLAIR",18105,322,35751,54178
"2004","PENNSYLVANIA","BRADFORD",8590,120,16942,25652
"2004","PENNSYLVANIA","BUCKS",163438,1909,154469,319816
"2004","PENNSYLVANIA","BUTLER",30090,376,54959,85425
"2004","PENNSYLVANIA","CAMBRIA",32591,344,34048,66983
"2004","PENNSYLVANIA","CAMERON",794,13,1599,2406
"2004","PENNSYLVANIA","CARBON",12223,301,12519,25043
"2004","PENNSYLVANIA","CENTRE",30733,387,33133,64253
"2004","PENNSYLVANIA","CHESTER",109708,1079,120036,230823
"2004","PENNSYLVANIA","CLARION",6049,72,11063,17184
"2004","PENNSYLVANIA","CLEARFIELD",13518,182,20533,34233
"2004","PENNSYLVANIA","CLINTON",5823,109,8035,13967
"2004","PENNSYLVANIA","COLUMBIA",10679,138,16052,26869
"2004","PENNSYLVANIA","CRAWFORD",16013,344,21965,38322
"2004","PENNSYLVANIA","CUMBERLAND",37928,506,67648,106082
"2004","PENNSYLVANIA","DAUPHIN",55299,613,65296,121208
"2004","PENNSYLVANIA","DELAWARE",162601,1512,120425,284538
"2004","PENNSYLVANIA","ELK",6602,76,7872,14550
"2004","PENNSYLVANIA","ERIE",67921,605,57372,125898
"2004","PENNSYLVANIA","FAYETTE",29120,542,25045,54707
"2004","PENNSYLVANIA","FOREST",989,13,1571,2573
"2004","PENNSYLVANIA","FRANKLIN",16562,190,41817,58569
"2004","PENNSYLVANIA","FULTON",1475,24,4772,6271
"2004","PENNSYLVANIA","GREENE",7674,105,7786,15565
"2004","PENNSYLVANIA","HUNTINGDON",5879,53,12126,18058
"2004","PENNSYLVANIA","INDIANA",15831,163,20254,36248
"2004","PENNSYLVANIA","JEFFERSON",6073,116,13371,19560
"2004","PENNSYLVANIA","JUNIATA",2797,65,7144,10006
"2004","PENNSYLVANIA","LACKAWANNA",59573,1480,44766,105819
"2004","PENNSYLVANIA","LANCASTER",74328,1359,145591,221278
"2004","PENNSYLVANIA","LAWRENCE",21387,117,21938,43442
"2004","PENNSYLVANIA","LEBANON",18109,467,37089,55665
"2004","PENNSYLVANIA","LEHIGH",73940,991,70160,145091
"2004","PENNSYLVANIA","LUZERNE",69573,1502,64953,136028
"2004","PENNSYLVANIA","LYCOMING",15681,407,33961,50049
"2004","PENNSYLVANIA","MCKEAN",6294,191,10941,17426
"2004","PENNSYLVANIA","MERCER",24831,422,26311,51564
"2004","PENNSYLVANIA","MIFFLIN",4889,187,11726,16802
"2004","PENNSYLVANIA","MONROE",27967,404,27971,56342
"2004","PENNSYLVANIA","MONTGOMERY",222048,1802,175741,399591
"2004","PENNSYLVANIA","MONTOUR",2666,55,4903,7624
"2004","PENNSYLVANIA","NORTHAMPTON",63446,1192,62102,126740
"2004","PENNSYLVANIA","NORTHUMBERLAND",14602,270,22262,37134
"2004","PENNSYLVANIA","PERRY",5423,85,13919,19427
"2004","PENNSYLVANIA","PHILADELPHIA",542205,1765,130099,674069
"2004","PENNSYLVANIA","PIKE",8656,199,12444,21299
"2004","PENNSYLVANIA","POTTER",2268,54,5640,7962
"2004","PENNSYLVANIA","SCHUYLKILL",29231,398,35640,65269
"2004","PENNSYLVANIA","SNYDER",4348,69,10566,14983
"2004","PENNSYLVANIA","SOMERSET",12842,134,23802,36778
"2004","PENNSYLVANIA","SULLIVAN",1213,16,2056,3285
"2004","PENNSYLVANIA","SUSQUEHANNA",7351,116,11573,19040
"2004","PENNSYLVANIA","TIOGA",5437,115,12019,17571
"2004","PENNSYLVANIA","UNION",5700,89,10334,16123
"2004","PENNSYLVANIA","VENANGO",9024,163,14472,23659
"2004","PENNSYLVANIA","WARREN",8044,230,10999,19273
"2004","PENNSYLVANIA","WASHINGTON",48225,279,47673,96177
"2004","PENNSYLVANIA","WAYNE",8060,194,13713,21967
"2004","PENNSYLVANIA","WESTMORELAND",77774,835,100087,178696
"2004","PENNSYLVANIA","WYOMING",4982,68,7782,12832
"2004","PENNSYLVANIA","YORK",63701,1298,114270,179269
"2004","RHODE ISLAND","BRISTOL",14448,374,9855,24677
"2004","RHODE ISLAND","FEDERAL PRECINCT",0,0,0,0
"2004","RHODE ISLAND","KENT",42830,1313,33699,77842
"2004","RHODE ISLAND","NEWPORT",22992,723,16622,40337
"2004","RHODE ISLAND","PROVIDENCE",144811,3799,82337,230947
"2004","RHODE ISLAND","WASHINGTON",34679,1274,26533,62486
"2004","SOUTH CAROLINA","ABBEVILLE",4389,100,5436,9925
"2004","SOUTH CAROLINA","AIKEN",19799,616,39077,59492
"2004","SOUTH CAROLINA","ALLENDALE",2565,41,985,3591
"2004","SOUTH CAROLINA","ANDERSON",20697,670,43355,64722
"2004","SOUTH CAROLINA","BAMBERG",3841,57,2138,6036
"2004","SOUTH CAROLINA","BARNWELL",3982,97,4606,8685
"2004","SOUTH CAROLINA","BEAUFORT",21505,399,33331,55235
"2004","SOUTH CAROLINA","BERKELEY",20142,691,32104,52937
"2004","SOUTH CAROLINA","CALHOUN",3393,78,3448,6919
"2004","SOUTH CAROLINA","CHARLESTON",63758,2261,70297,136316
"2004","SOUTH CAROLINA","CHEROKEE",6466,158,12090,18714
"2004","SOUTH CAROLINA","CHESTER",5790,141,5798,11729
"2004","SOUTH CAROLINA","CHESTERFIELD",6729,68,7252,14049
"2004","SOUTH CAROLINA","CLARENDON",7087,52,6061,13200
"2004","SOUTH CAROLINA","COLLETON",6699,143,7264,14106
"2004","SOUTH CAROLINA","DARLINGTON",11829,209,13416,25454
"2004","SOUTH CAROLINA","DILLON",4832,102,4301,9235
"2004","SOUTH CAROLINA","DORCHESTER",14733,578,26006,41317
"2004","SOUTH CAROLINA","EDGEFIELD",4051,84,5611,9746
"2004","SOUTH CAROLINA","FAIRFIELD",5764,140,3531,9435
"2004","SOUTH CAROLINA","FLORENCE",21442,414,27689,49545
"2004","SOUTH CAROLINA","GEORGETOWN",10602,385,12606,23593
"2004","SOUTH CAROLINA","GREENVILLE",55347,2005,111481,168833
"2004","SOUTH CAROLINA","GREENWOOD",8954,224,14264,23442
"2004","SOUTH CAROLINA","HAMPTON",4832,87,3097,8016
"2004","SOUTH CAROLINA","HORRY",29547,1353,50447,81347
"2004","SOUTH CAROLINA","JASPER",3840,73,2933,6846
"2004","SOUTH CAROLINA","KERSHAW",8515,240,14160,22915
"2004","SOUTH CAROLINA","LANCASTER",7631,267,12916,20814
"2004","SOUTH CAROLINA","LAURENS",9205,158,14466,23829
"2004","SOUTH CAROLINA","LEE",4960,37,2901,7898
"2004","SOUTH CAROLINA","LEXINGTON",25393,907,67132,93432
"2004","SOUTH CAROLINA","MARION",7767,151,5589,13507
"2004","SOUTH CAROLINA","MARLBORO",4984,153,3423,8560
"2004","SOUTH CAROLINA","MCCORMICK",2648,78,2396,5122
"2004","SOUTH CAROLINA","NEWBERRY",4483,272,7654,12409
"2004","SOUTH CAROLINA","OCONEE",8395,326,18811,27532
"2004","SOUTH CAROLINA","ORANGEBURG",24698,171,12695,37564
"2004","SOUTH CAROLINA","PICKENS",10287,464,29759,40510
"2004","SOUTH CAROLINA","RICHLAND",76283,1306,56212,133801
"2004","SOUTH CAROLINA","SALUDA",3001,40,4537,7578
"2004","SOUTH CAROLINA","SPARTANBURG",33633,1121,62004,96758
"2004","SOUTH CAROLINA","SUMTER",18695,234,18074,37003
"2004","SOUTH CAROLINA","UNION",5236,106,6592,11934
"2004","SOUTH CAROLINA","WILLIAMSBURG",9044,79,4795,13918
"2004","SOUTH CAROLINA","YORK",24226,721,45234,70181
"2004","SOUTH DAKOTA","AURORA",620,20,1009,1649
"2004","SOUTH DAKOTA","BEADLE",3443,120,4917,8480
"2004","SOUTH DAKOTA","BENNETT",759,38,833,1630
"2004","SOUTH DAKOTA","BON HOMME",1293,52,2063,3408
"2004","SOUTH DAKOTA","BROOKINGS",5443,270,7662,13375
"2004","SOUTH DAKOTA","BROWN",7943,270,10386,18599
"2004","SOUTH DAKOTA","BRULE",1040,45,1544,2629
"2004","SOUTH DAKOTA","BUFFALO",603,15,223,841
"2004","SOUTH DAKOTA","BUTTE",1009,96,3166,4271
"2004","SOUTH DAKOTA","CAMPBELL",239,12,708,959
"2004","SOUTH DAKOTA","CHARLES MIX",2155,87,2556,4798
"2004","SOUTH DAKOTA","CLARK",875,17,1435,2327
"2004","SOUTH DAKOTA","CLAY",3315,129,2692,6136
"2004","SOUTH DAKOTA","CODINGTON",4803,170,7778,12751
"2004","SOUTH DAKOTA","CORSON",972,32,720,1724
"2004","SOUTH DAKOTA","CUSTER",1272,110,2922,4304
"2004","SOUTH DAKOTA","DAVISON",3263,128,5561,8952
"2004","SOUTH DAKOTA","DAY",1817,52,1671,3540
"2004","SOUTH DAKOTA","DEUEL",961,45,1406,2412
"2004","SOUTH DAKOTA","DEWEY",1606,37,921,2564
"2004","SOUTH DAKOTA","DOUGLAS",393,23,1596,2012
"2004","SOUTH DAKOTA","EDMUNDS",765,35,1434,2234
"2004","SOUTH DAKOTA","FALL RIVER",1326,106,2413,3845
"2004","SOUTH DAKOTA","FAULK",418,6,945,1369
"2004","SOUTH DAKOTA","GRANT",1633,65,2392,4090
"2004","SOUTH DAKOTA","GREGORY",813,48,1685,2546
"2004","SOUTH DAKOTA","HAAKON",219,14,1007,1240
"2004","SOUTH DAKOTA","HAMLIN",1015,50,1946,3011
"2004","SOUTH DAKOTA","HAND",668,37,1482,2187
"2004","SOUTH DAKOTA","HANSON",745,26,1379,2150
"2004","SOUTH DAKOTA","HARDING",94,17,704,815
"2004","SOUTH DAKOTA","HUGHES",2697,121,6017,8835
"2004","SOUTH DAKOTA","HUTCHINSON",1177,71,2899,4147
"2004","SOUTH DAKOTA","HYDE",259,10,631,900
"2004","SOUTH DAKOTA","JACKSON",508,37,726,1271
"2004","SOUTH DAKOTA","JERAULD",482,18,736,1236
"2004","SOUTH DAKOTA","JONES",134,18,565,717
"2004","SOUTH DAKOTA","KINGSBURY",1163,47,1804,3014
"2004","SOUTH DAKOTA","LAKE",2509,139,3359,6007
"2004","SOUTH DAKOTA","LAWRENCE",3857,273,7489,11619
"2004","SOUTH DAKOTA","LINCOLN",5703,202,11161,17066
"2004","SOUTH DAKOTA","LYMAN",872,39,1029,1940
"2004","SOUTH DAKOTA","MARSHALL",1099,23,1242,2364
"2004","SOUTH DAKOTA","MCCOOK",1201,53,2017,3271
"2004","SOUTH DAKOTA","MCPHERSON",369,30,1180,1579
"2004","SOUTH DAKOTA","MEADE",2941,216,8347,11504
"2004","SOUTH DAKOTA","MELLETTE",361,17,553,931
"2004","SOUTH DAKOTA","MINER",641,19,810,1470
"2004","SOUTH DAKOTA","MINNEHAHA",32314,1129,44189,77632
"2004","SOUTH DAKOTA","MOODY",1609,52,1790,3451
"2004","SOUTH DAKOTA","PENNINGTON",14213,779,29976,44968
"2004","SOUTH DAKOTA","PERKINS",418,66,1329,1813
"2004","SOUTH DAKOTA","POTTER",463,12,1143,1618
"2004","SOUTH DAKOTA","ROBERTS",2527,59,2396,4982
"2004","SOUTH DAKOTA","SANBORN",581,28,817,1426
"2004","SOUTH DAKOTA","SHANNON",3566,122,526,4214
"2004","SOUTH DAKOTA","SPINK",1478,37,2259,3774
"2004","SOUTH DAKOTA","STANLEY",464,30,1129,1623
"2004","SOUTH DAKOTA","SULLY",201,14,702,917
"2004","SOUTH DAKOTA","TODD",2543,92,889,3524
"2004","SOUTH DAKOTA","TRIPP",972,43,2230,3245
"2004","SOUTH DAKOTA","TURNER",1646,104,3084,4834
"2004","SOUTH DAKOTA","UNION",3000,61,3987,7048
"2004","SOUTH DAKOTA","WALWORTH",878,35,1967,2880
"2004","SOUTH DAKOTA","YANKTON",4237,191,6003,10431
"2004","SOUTH DAKOTA","ZIEBACH",641,28,447,1116
"2004","TENNESSEE","ANDERSON",12896,276,18510,31682
"2004","TENNESSEE","BEDFORD",5261,87,8348,13696
"2004","TENNESSEE","BENTON",3869,60,3161,7090
"2004","TENNESSEE","BLEDSOE",1927,24,2849,4800
"2004","TENNESSEE","BLOUNT",15042,428,33240,48710
"2004","TENNESSEE","BRADLEY",9426,255,25942,35623
"2004","TENNESSEE","CAMPBELL",6163,96,7859,14118
"2004","TENNESSEE","CANNON",2510,34,2923,5467
"2004","TENNESSEE","CARROLL",5070,82,6603,11755
"2004","TENNESSEE","CARTER",6390,149,15763,22302
"2004","TENNESSEE","CHEATHAM",5918,103,9676,15697
"2004","TENNESSEE","CHESTER",2182,29,4086,6297
"2004","TENNESSEE","CLAIBORNE",4033,58,6447,10538
"2004","TENNESSEE","CLAY",1673,32,1647,3352
"2004","TENNESSEE","COCKE",3932,79,8290,12301
"2004","TENNESSEE","COFFEE",8238,131,11785,20154
"2004","TENNESSEE","CROCKETT",2455,21,3239,5715
"2004","TENNESSEE","CUMBERLAND",8326,166,15142,23634
"2004","TENNESSEE","DAVIDSON",132362,1695,107618,241675
"2004","TENNESSEE","DECATUR",2268,45,2566,4879
"2004","TENNESSEE","DEKALB",3445,43,3685,7173
"2004","TENNESSEE","DICKSON",8592,134,10557,19283
"2004","TENNESSEE","DYER",5287,75,8447,13809
"2004","TENNESSEE","FAYETTE",5692,79,8960,14731
"2004","TENNESSEE","FENTRESS",2371,36,4293,6700
"2004","TENNESSEE","FRANKLIN",7797,147,9126,17070
"2004","TENNESSEE","GIBSON",8509,114,10596,19219
"2004","TENNESSEE","GILES",5273,101,6162,11536
"2004","TENNESSEE","GRAINGER",2569,51,4905,7525
"2004","TENNESSEE","GREENE",7625,173,16374,24172
"2004","TENNESSEE","GRUNDY",2787,34,2102,4923
"2004","TENNESSEE","HAMBLEN",7426,143,14733,22302
"2004","TENNESSEE","HAMILTON",57268,1082,78513,136863
"2004","TENNESSEE","HANCOCK",776,18,1756,2550
"2004","TENNESSEE","HARDEMAN",5683,77,4702,10462
"2004","TENNESSEE","HARDIN",3834,33,6087,9954
"2004","TENNESSEE","HAWKINS",6683,102,13445,20230
"2004","TENNESSEE","HAYWOOD",4359,49,3140,7548
"2004","TENNESSEE","HENDERSON",3448,63,6585,10096
"2004","TENNESSEE","HENRY",5728,105,6337,12170
"2004","TENNESSEE","HICKMAN",4261,51,4359,8671
"2004","TENNESSEE","HOUSTON",2126,29,1438,3593
"2004","TENNESSEE","HUMPHREYS",4485,47,3261,7793
"2004","TENNESSEE","JACKSON",2996,32,2024,5052
"2004","TENNESSEE","JEFFERSON",5469,121,11617,17207
"2004","TENNESSEE","JOHNSON",1810,34,4632,6476
"2004","TENNESSEE","KNOX",65921,1601,110653,178175
"2004","TENNESSEE","LAKE",1039,14,1317,2370
"2004","TENNESSEE","LAUDERDALE",4473,44,4164,8681
"2004","TENNESSEE","LAWRENCE",6592,107,9952,16651
"2004","TENNESSEE","LEWIS",2191,43,2819,5053
"2004","TENNESSEE","LINCOLN",4546,82,7827,12455
"2004","TENNESSEE","LOUDON",5706,115,14041,19862
"2004","TENNESSEE","MACON",2739,25,4670,7434
"2004","TENNESSEE","MADISON",16837,156,21672,38665
"2004","TENNESSEE","MARION",5548,82,5862,11492
"2004","TENNESSEE","MARSHALL",4722,68,5825,10615
"2004","TENNESSEE","MAURY",12372,159,17495,30026
"2004","TENNESSEE","MCMINN",5889,132,11978,17999
"2004","TENNESSEE","MCNAIRY",4101,36,5787,9924
"2004","TENNESSEE","MEIGS",1595,37,2499,4131
"2004","TENNESSEE","MONROE",5349,91,10113,15553
"2004","TENNESSEE","MONTGOMERY",20061,299,28615,48975
"2004","TENNESSEE","MOORE",1084,22,1667,2773
"2004","TENNESSEE","MORGAN",2924,35,4401,7360
"2004","TENNESSEE","OBION",5549,127,7859,13535
"2004","TENNESSEE","OVERTON",4518,51,3941,8510
"2004","TENNESSEE","PERRY",1579,49,1520,3148
"2004","TENNESSEE","PICKETT",1033,12,1600,2645
"2004","TENNESSEE","POLK",2724,52,3923,6699
"2004","TENNESSEE","PUTNAM",10549,239,15619,26407
"2004","TENNESSEE","RHEA",3663,86,7288,11037
"2004","TENNESSEE","ROANE",8676,165,14423,23264
"2004","TENNESSEE","ROBERTSON",9863,127,15329,25319
"2004","TENNESSEE","RUTHERFORD",31639,562,52189,84390
"2004","TENNESSEE","SCOTT",3085,33,4508,7626
"2004","TENNESSEE","SEQUATCHIE",1986,46,2950,4982
"2004","TENNESSEE","SEVIER",8613,204,22127,30944
"2004","TENNESSEE","SHELBY",215810,2183,157591,375584
"2004","TENNESSEE","SMITH",4038,45,3738,7821
"2004","TENNESSEE","STEWART",2860,48,2675,5583
"2004","TENNESSEE","SULLIVAN",19626,446,42526,62598
"2004","TENNESSEE","SUMNER",21439,329,40141,61909
"2004","TENNESSEE","TIPTON",7379,120,14178,21677
"2004","TENNESSEE","TROUSDALE",1850,26,1314,3190
"2004","TENNESSEE","UNICOI",2372,59,5026,7457
"2004","TENNESSEE","UNION",2524,41,4145,6710
"2004","TENNESSEE","VAN BUREN",1209,18,1119,2346
"2004","TENNESSEE","WARREN",6803,89,7502,14394
"2004","TENNESSEE","WASHINGTON",14937,327,29720,44984
"2004","TENNESSEE","WAYNE",1951,34,3998,5983
"2004","TENNESSEE","WEAKLEY",5584,91,7816,13491
"2004","TENNESSEE","WHITE",4147,79,5268,9494
"2004","TENNESSEE","WILLIAMSON",21719,449,57409,79577
"2004","TENNESSEE","WILSON",15256,251,28896,44403
"2004","TEXAS","ANDERSON",4678,98,11525,16301
"2004","TEXAS","ANDREWS",677,22,3837,4536
"2004","TEXAS","ANGELINA",9302,130,18932,28364
"2004","TEXAS","ARANSAS",2640,59,6569,9268
"2004","TEXAS","ARCHER",878,17,3556,4451
"2004","TEXAS","ARMSTRONG",170,4,830,1004
"2004","TEXAS","ATASCOSA",4421,60,7635,12116
"2004","TEXAS","AUSTIN",2582,48,8072,10702
"2004","TEXAS","BAILEY",525,5,1882,2412
"2004","TEXAS","BANDERA",1738,70,6933,8741
"2004","TEXAS","BASTROP",9794,357,13290,23441
"2004","TEXAS","BAYLOR",467,4,1169,1640
"2004","TEXAS","BEE",4045,45,5428,9518
"2004","TEXAS","BELL",27165,424,52135,79724
"2004","TEXAS","BEXAR",210976,3640,260698,475314
"2004","TEXAS","BLANCO",1267,40,3277,4584
"2004","TEXAS","BORDEN",55,1,303,359
"2004","TEXAS","BOSQUE",1815,34,5737,7586
"2004","TEXAS","BOWIE",11880,89,21791,33760
"2004","TEXAS","BRAZORIA",28904,682,63662,93248
"2004","TEXAS","BRAZOS",16128,587,37594,54309
"2004","TEXAS","BREWSTER",1729,51,1980,3760
"2004","TEXAS","BRISCOE",191,0,620,811
"2004","TEXAS","BROOKS",1823,6,845,2674
"2004","TEXAS","BROWN",2523,90,11640,14253
"2004","TEXAS","BURLESON",2276,40,4405,6721
"2004","TEXAS","BURNET",4147,139,11456,15742
"2004","TEXAS","CALDWELL",5052,99,6436,11587
"2004","TEXAS","CALHOUN",2561,20,4348,6929
"2004","TEXAS","CALLAHAN",1073,39,4542,5654
"2004","TEXAS","CAMERON",33998,357,34801,69156
"2004","TEXAS","CAMP",1778,23,2638,4439
"2004","TEXAS","CARSON",485,9,2450,2944
"2004","TEXAS","CASS",4630,36,7383,12049
"2004","TEXAS","CASTRO",631,5,1794,2430
"2004","TEXAS","CHAMBERS",2953,78,8618,11649
"2004","TEXAS","CHEROKEE",4439,71,11329,15839
"2004","TEXAS","CHILDRESS",511,4,1629,2144
"2004","TEXAS","CLAY",1299,18,3971,5288
"2004","TEXAS","COCHRAN",249,5,856,1110
"2004","TEXAS","COKE",266,6,1338,1610
"2004","TEXAS","COLEMAN",778,13,3035,3826
"2004","TEXAS","COLLIN",68935,1784,174435,245154
"2004","TEXAS","COLLINGSWORTH",346,1,1051,1398
"2004","TEXAS","COLORADO",2161,41,5488,7690
"2004","TEXAS","COMAL",9153,316,31574,41043
"2004","TEXAS","COMANCHE",1431,24,3813,5268
"2004","TEXAS","CONCHO",270,12,911,1193
"2004","TEXAS","COOKE",3142,57,11908,15107
"2004","TEXAS","CORYELL",5122,82,12421,17625
"2004","TEXAS","COTTLE",214,5,549,768
"2004","TEXAS","CRANE",254,6,1314,1574
"2004","TEXAS","CROCKETT",473,7,1248,1728
"2004","TEXAS","CROSBY",622,6,1647,2275
"2004","TEXAS","CULBERSON",375,6,407,788
"2004","TEXAS","DALLAM",305,4,1473,1782
"2004","TEXAS","DALLAS",336641,4822,346246,687709
"2004","TEXAS","DAWSON",1114,12,3419,4545
"2004","TEXAS","DEAF SMITH",1133,19,4139,5291
"2004","TEXAS","DELTA",627,8,1447,2082
"2004","TEXAS","DENTON",59346,1173,140891,201410
"2004","TEXAS","DEWITT",1610,22,5100,6732
"2004","TEXAS","DICKENS",245,3,815,1063
"2004","TEXAS","DIMMIT",2365,13,1188,3566
"2004","TEXAS","DONLEY",349,6,1429,1784
"2004","TEXAS","DUVAL",2916,15,1160,4091
"2004","TEXAS","EASTLAND",1582,26,5249,6857
"2004","TEXAS","ECTOR",8579,229,27502,36310
"2004","TEXAS","EDWARDS",217,1,745,963
"2004","TEXAS","EL PASO",95142,1170,73261,169573
"2004","TEXAS","ELLIS",11640,202,34602,46444
"2004","TEXAS","ERATH",2710,65,9506,12281
"2004","TEXAS","FALLS",2427,21,3454,5902
"2004","TEXAS","FANNIN",4001,66,7893,11960
"2004","TEXAS","FAYETTE",2803,67,7527,10397
"2004","TEXAS","FISHER",758,4,1161,1923
"2004","TEXAS","FLOYD",545,7,2032,2584
"2004","TEXAS","FOARD",235,5,347,587
"2004","TEXAS","FORT BEND",68722,822,93625,163169
"2004","TEXAS","FRANKLIN",1011,21,3185,4217
"2004","TEXAS","FREESTONE",2070,34,5057,7161
"2004","TEXAS","FRIO",1931,8,1991,3930
"2004","TEXAS","GAINES",608,16,3540,4164
"2004","TEXAS","GALVESTON",43919,772,61290,105981
"2004","TEXAS","GARZA",326,6,1480,1812
"2004","TEXAS","GILLESPIE",2104,152,9297,11553
"2004","TEXAS","GLASSCOCK",44,1,488,533
"2004","TEXAS","GOLIAD",1219,15,2267,3501
"2004","TEXAS","GONZALES",1709,22,4291,6022
"2004","TEXAS","GRAY",1289,23,7260,8572
"2004","TEXAS","GRAYSON",13452,194,30777,44423
"2004","TEXAS","GREGG",12306,153,29939,42398
"2004","TEXAS","GRIMES",2713,54,5263,8030
"2004","TEXAS","GUADALUPE",10290,254,28208,38752
"2004","TEXAS","HALE",2078,51,8025,10154
"2004","TEXAS","HALL",413,4,860,1277
"2004","TEXAS","HAMILTON",845,29,2856,3730
"2004","TEXAS","HANSFORD",240,4,1903,2147
"2004","TEXAS","HARDEMAN",480,8,1214,1702
"2004","TEXAS","HARDIN",5608,72,15030,20710
"2004","TEXAS","HARRIS",475865,7380,584723,1067968
"2004","TEXAS","HARRISON",9642,108,16473,26223
"2004","TEXAS","HARTLEY",315,8,1736,2059
"2004","TEXAS","HASKELL",867,10,1539,2416
"2004","TEXAS","HAYS",20110,692,27021,47823
"2004","TEXAS","HEMPHILL",257,6,1380,1643
"2004","TEXAS","HENDERSON",8505,134,20210,28849
"2004","TEXAS","HIDALGO",62369,383,50931,113683
"2004","TEXAS","HILL",3751,77,9225,13053
"2004","TEXAS","HOCKLEY",1385,32,6160,7577
"2004","TEXAS","HOOD",4865,148,16280,21293
"2004","TEXAS","HOPKINS",3443,37,8582,12062
"2004","TEXAS","HOUSTON",2921,37,5848,8806
"2004","TEXAS","HOWARD",2663,58,7480,10201
"2004","TEXAS","HUDSPETH",302,7,577,886
"2004","TEXAS","HUNT",7971,158,20065,28194
"2004","TEXAS","HUTCHINSON",1503,27,7839,9369
"2004","TEXAS","IRION",141,3,684,828
"2004","TEXAS","JACK",643,13,2470,3126
"2004","TEXAS","JACKSON",1296,15,3766,5077
"2004","TEXAS","JASPER",4471,55,8347,12873
"2004","TEXAS","JEFF DAVIS",378,25,764,1167
"2004","TEXAS","JEFFERSON",47066,377,44423,91866
"2004","TEXAS","JIM HOGG",1344,9,712,2065
"2004","TEXAS","JIM WELLS",6824,50,5817,12691
"2004","TEXAS","JOHNSON",12325,279,34818,47422
"2004","TEXAS","JONES",1658,19,4254,5931
"2004","TEXAS","KARNES",1543,16,3114,4673
"2004","TEXAS","KAUFMAN",8947,115,21304,30366
"2004","TEXAS","KENDALL",2532,106,11434,14072
"2004","TEXAS","KENEDY",85,2,82,169
"2004","TEXAS","KENT",138,2,382,522
"2004","TEXAS","KERR",4557,151,16538,21246
"2004","TEXAS","KIMBLE",324,10,1482,1816
"2004","TEXAS","KING",18,1,137,156
"2004","TEXAS","KINNEY",542,7,1051,1600
"2004","TEXAS","KLEBERG",4550,57,5366,9973
"2004","TEXAS","KNOX",464,7,1081,1552
"2004","TEXAS","LA SALLE",1229,12,989,2230
"2004","TEXAS","LAMAR",5338,78,12054,17470
"2004","TEXAS","LAMB",857,4,3410,4271
"2004","TEXAS","LAMPASAS",1593,10,5422,7025
"2004","TEXAS","LAVACA",2152,51,5974,8177
"2004","TEXAS","LEE",1899,29,4160,6088
"2004","TEXAS","LEON",1754,22,5023,6799
"2004","TEXAS","LIBERTY",6780,90,14821,21691
"2004","TEXAS","LIMESTONE",2752,38,5028,7818
"2004","TEXAS","LIPSCOMB",184,6,1147,1337
"2004","TEXAS","LIVE OAK",1036,18,3147,4201
"2004","TEXAS","LLANO",2257,65,7241,9563
"2004","TEXAS","LOVING",12,3,65,80
"2004","TEXAS","LUBBOCK",22472,544,70135,93151
"2004","TEXAS","LYNN",490,5,1776,2271
"2004","TEXAS","MADISON",1235,29,2837,4101
"2004","TEXAS","MARION",1884,23,2441,4348
"2004","TEXAS","MARTIN",288,5,1514,1807
"2004","TEXAS","MASON",459,18,1600,2077
"2004","TEXAS","MATAGORDA",4355,47,8119,12521
"2004","TEXAS","MAVERICK",5948,61,4025,10034
"2004","TEXAS","MCCULLOCH",745,10,2465,3220
"2004","TEXAS","MCLENNAN",26760,404,52090,79254
"2004","TEXAS","MCMULLEN",95,2,467,564
"2004","TEXAS","MEDINA",4322,115,10389,14826
"2004","TEXAS","MENARD",331,11,761,1103
"2004","TEXAS","MIDLAND",8005,244,36585,44834
"2004","TEXAS","MILAM",3445,47,5291,8783
"2004","TEXAS","MILLS",416,21,1794,2231
"2004","TEXAS","MITCHELL",639,7,1912,2558
"2004","TEXAS","MONTAGUE",1946,41,5910,7897
"2004","TEXAS","MONTGOMERY",28628,706,104654,133988
"2004","TEXAS","MOORE",1009,18,4601,5628
"2004","TEXAS","MORRIS",2437,23,2818,5278
"2004","TEXAS","MOTLEY",113,7,564,684
"2004","TEXAS","NACOGDOCHES",7152,154,14160,21466
"2004","TEXAS","NAVARRO",5259,60,10715,16034
"2004","TEXAS","NEWTON",2513,28,3159,5700
"2004","TEXAS","NOLAN",1541,26,3722,5289
"2004","TEXAS","NUECES",44439,762,59359,104560
"2004","TEXAS","OCHILTREE",251,4,2922,3177
"2004","TEXAS","OLDHAM",108,2,733,843
"2004","TEXAS","ORANGE",11476,140,20292,31908
"2004","TEXAS","PALO PINTO",2816,61,7137,10014
"2004","TEXAS","PANOLA",2958,28,7021,10007
"2004","TEXAS","PARKER",8966,196,31795,40957
"2004","TEXAS","PARMER",389,9,2375,2773
"2004","TEXAS","PECOS",1242,19,3167,4428
"2004","TEXAS","POLK",6964,104,13778,20846
"2004","TEXAS","POTTER",7489,166,21401,29056
"2004","TEXAS","PRESIDIO",1159,16,715,1890
"2004","TEXAS","RAINS",1213,18,2998,4229
"2004","TEXAS","RANDALL",7849,218,40520,48587
"2004","TEXAS","REAGAN",184,3,956,1143
"2004","TEXAS","REAL",325,6,1314,1645
"2004","TEXAS","RED RIVER",2097,14,3379,5490
"2004","TEXAS","REEVES",1600,18,1777,3395
"2004","TEXAS","REFUGIO",1232,11,2212,3455
"2004","TEXAS","ROBERTS",46,0,461,507
"2004","TEXAS","ROBERTSON",2979,24,3792,6795
"2004","TEXAS","ROCKWALL",5320,141,20120,25581
"2004","TEXAS","RUNNELS",792,18,3239,4049
"2004","TEXAS","RUSK",4899,55,13390,18344
"2004","TEXAS","SABINE",1476,25,3138,4639
"2004","TEXAS","SAN AUGUSTINE",1506,16,2235,3757
"2004","TEXAS","SAN JACINTO",2688,43,5394,8125
"2004","TEXAS","SAN PATRICIO",7764,82,13474,21320
"2004","TEXAS","SAN SABA",529,8,1894,2431
"2004","TEXAS","SCHLEICHER",312,5,1012,1329
"2004","TEXAS","SCURRY",981,15,4576,5572
"2004","TEXAS","SHACKELFORD",229,6,1292,1527
"2004","TEXAS","SHELBY",2951,33,6295,9279
"2004","TEXAS","SHERMAN",124,0,942,1066
"2004","TEXAS","SMITH",19970,302,53392,73664
"2004","TEXAS","SOMERVELL",831,19,2701,3551
"2004","TEXAS","STARR",7199,30,2552,9781
"2004","TEXAS","STEPHENS",703,13,2803,3519
"2004","TEXAS","STERLING",71,0,544,615
"2004","TEXAS","STONEWALL",250,3,499,752
"2004","TEXAS","SUTTON",280,0,1173,1453
"2004","TEXAS","SWISHER",626,7,1487,2120
"2004","TEXAS","TARRANT",207286,3393,349462,560141
"2004","TEXAS","TAYLOR",10648,254,37197,48099
"2004","TEXAS","TERRELL",159,4,306,469
"2004","TEXAS","TERRY",794,10,3166,3970
"2004","TEXAS","THROCKMORTON",202,5,656,863
"2004","TEXAS","TITUS",3173,25,5709,8907
"2004","TEXAS","TOM GREEN",9007,225,28185,37417
"2004","TEXAS","TRAVIS",197235,6993,147885,352113
"2004","TEXAS","TRINITY",2204,24,3985,6213
"2004","TEXAS","TYLER",2659,43,5043,7745
"2004","TEXAS","UPSHUR",4225,69,10232,14526
"2004","TEXAS","UPTON",185,3,1009,1197
"2004","TEXAS","UVALDE",3298,37,5148,8483
"2004","TEXAS","VAL VERDE",4757,70,6968,11795
"2004","TEXAS","VAN ZANDT",4822,58,14976,19856
"2004","TEXAS","VICTORIA",8553,174,20875,29602
"2004","TEXAS","WALKER",5977,135,11710,17822
"2004","TEXAS","WALLER",6145,57,7679,13881
"2004","TEXAS","WARD",901,11,2856,3768
"2004","TEXAS","WASHINGTON",3389,77,9597,13063
"2004","TEXAS","WEBB",23654,149,17753,41556
"2004","TEXAS","WHARTON",4702,49,9288,14039
"2004","TEXAS","WHEELER",420,14,1960,2394
"2004","TEXAS","WICHITA",12819,254,32472,45545
"2004","TEXAS","WILBARGER",1284,21,3685,4990
"2004","TEXAS","WILLACY",2734,19,2209,4962
"2004","TEXAS","WILLIAMSON",43117,1797,83284,128198
"2004","TEXAS","WILSON",4409,76,10400,14885
"2004","TEXAS","WINKLER",391,7,1604,2002
"2004","TEXAS","WISE",4783,71,15177,20031
"2004","TEXAS","WOOD",4034,64,12831,16929
"2004","TEXAS","YOAKUM",376,9,2228,2613
"2004","TEXAS","YOUNG",1511,24,5874,7409
"2004","TEXAS","ZAPATA",1662,8,1228,2898
"2004","TEXAS","ZAVALA",2332,9,777,3118
"2004","UTAH","BEAVER",493,28,2023,2544
"2004","UTAH","BOX ELDER",2244,373,15751,18368
"2004","UTAH","CACHE",6375,870,32486,39731
"2004","UTAH","CARBON",3415,143,4950,8508
"2004","UTAH","DAGGETT",108,11,380,499
"2004","UTAH","DAVIS",20893,2188,86187,109268
"2004","UTAH","DUCHESNE",738,76,4742,5556
"2004","UTAH","EMERY",831,66,3781,4678
"2004","UTAH","GARFIELD",264,50,1848,2162
"2004","UTAH","GRAND",1858,177,2130,4165
"2004","UTAH","IRON",2267,364,12815,15446
"2004","UTAH","JUAB",605,131,2681,3417
"2004","UTAH","KANE",576,61,2414,3051
"2004","UTAH","MILLARD",626,167,4084,4877
"2004","UTAH","MORGAN",472,68,3301,3841
"2004","UTAH","PIUTE",123,4,646,773
"2004","UTAH","RICH",109,6,922,1037
"2004","UTAH","SALT LAKE",135949,10461,215728,362138
"2004","UTAH","SAN JUAN",1906,73,2971,4950
"2004","UTAH","SANPETE",1189,314,7004,8507
"2004","UTAH","SEVIER",920,124,6597,7641
"2004","UTAH","SUMMIT",6977,399,7936,15312
"2004","UTAH","TOOELE",4130,353,12181,16664
"2004","UTAH","UINTAH",1266,173,8518,9957
"2004","UTAH","UTAH",17357,3547,128269,149173
"2004","UTAH","WASATCH",1854,155,5503,7512
"2004","UTAH","WASHINGTON",7513,872,35633,44018
"2004","UTAH","WAYNE",279,19,1062,1360
"2004","UTAH","WEBER",19862,1630,51199,72691
"2004","VERMONT","ADDISON",11147,355,7077,18579
"2004","VERMONT","BENNINGTON",11069,380,7616,19065
"2004","VERMONT","CALEDONIA",7106,340,6765,14211
"2004","VERMONT","CHITTENDEN",49369,1905,26422,77696
"2004","VERMONT","ESSEX",1276,70,1591,2937
"2004","VERMONT","FRANKLIN",10598,386,8936,19920
"2004","VERMONT","GRAND ISLE",2246,77,1754,4077
"2004","VERMONT","LAMOILLE",7636,285,4260,12181
"2004","VERMONT","ORANGE",8159,315,6421,14895
"2004","VERMONT","ORLEANS",6330,246,5666,12242
"2004","VERMONT","RUTLAND",15904,631,14440,30975
"2004","VERMONT","WASHINGTON",19177,810,11461,31448
"2004","VERMONT","WINDHAM",15489,547,7280,23316
"2004","VERMONT","WINDSOR",18561,715,11491,30767
"2004","VIRGINIA","ACCOMACK",5518,112,7726,13356
"2004","VIRGINIA","ALBEMARLE",22088,449,21189,43726
"2004","VIRGINIA","ALEXANDRIA",41116,555,19844,61515
"2004","VIRGINIA","ALLEGHANY",3203,30,3962,7195
"2004","VIRGINIA","AMELIA",1862,36,3499,5397
"2004","VIRGINIA","AMHERST",4866,71,7758,12695
"2004","VIRGINIA","APPOMATTOX",2191,98,4366,6655
"2004","VIRGINIA","ARLINGTON",63987,1028,29635,94650
"2004","VIRGINIA","AUGUSTA",7019,585,22100,29704
"2004","VIRGINIA","BATH",828,22,1432,2282
"2004","VIRGINIA","BEDFORD",10144,405,23397,33946
"2004","VIRGINIA","BLAND",846,57,1962,2865
"2004","VIRGINIA","BOTETOURT",4801,131,10865,15797
"2004","VIRGINIA","BRISTOL",2400,49,4275,6724
"2004","VIRGINIA","BRUNSWICK",4062,12,2852,6926
"2004","VIRGINIA","BUCHANAN",5275,47,4507,9829
"2004","VIRGINIA","BUCKINGHAM",2789,53,3185,6027
"2004","VIRGINIA","BUENA VISTA",936,36,1417,2389
"2004","VIRGINIA","CAMPBELL",6862,244,15891,22997
"2004","VIRGINIA","CAROLINE",4878,77,4999,9954
"2004","VIRGINIA","CARROLL",3888,67,8173,12128
"2004","VIRGINIA","CHARLES CITY",2155,30,1254,3439
"2004","VIRGINIA","CHARLOTTE",2223,49,3166,5438
"2004","VIRGINIA","CHARLOTTESVILLE",11088,190,4172,15450
"2004","VIRGINIA","CHESAPEAKE",38744,514,52283,91541
"2004","VIRGINIA","CHESTERFIELD",49346,723,83745,133814
"2004","VIRGINIA","CLARKE",2699,65,3741,6505
"2004","VIRGINIA","COLONIAL HEIGHTS",2061,41,6129,8231
"2004","VIRGINIA","COVINGTON",1179,18,1104,2301
"2004","VIRGINIA","CRAIG",901,14,1706,2621
"2004","VIRGINIA","CULPEPER",5476,103,10026,15605
"2004","VIRGINIA","CUMBERLAND",1721,28,2377,4126
"2004","VIRGINIA","DANVILLE",9436,277,9399,19112
"2004","VIRGINIA","DICKENSON",3761,54,3591,7406
"2004","VIRGINIA","DINWIDDIE",4569,77,6193,10839
"2004","VIRGINIA","EMPORIA",1247,4,970,2221
"2004","VIRGINIA","ESSEX",2007,33,2304,4344
"2004","VIRGINIA","FAIRFAX",251066,3834,217025,471925
"2004","VIRGINIA","FALLS CHURCH",3944,80,2074,6098
"2004","VIRGINIA","FAUQUIER",10712,192,19011,29915
"2004","VIRGINIA","FLOYD",2488,84,4162,6734
"2004","VIRGINIA","FLUVANNA",4415,84,6458,10957
"2004","VIRGINIA","FRANKLIN",9912,186,15661,25759
"2004","VIRGINIA","FREDERICK",8853,301,19386,28540
"2004","VIRGINIA","FREDERICKSBURG",4085,67,3390,7542
"2004","VIRGINIA","GALAX",987,12,1336,2335
"2004","VIRGINIA","GILES",3047,131,4320,7498
"2004","VIRGINIA","GLOUCESTER",5105,144,11084,16333
"2004","VIRGINIA","GOOCHLAND",3583,87,6668,10338
"2004","VIRGINIA","GRAYSON",2430,52,4655,7137
"2004","VIRGINIA","GREENE",2240,129,4570,6939
"2004","VIRGINIA","GREENSVILLE",2514,12,1732,4258
"2004","VIRGINIA","HALIFAX",6220,73,8363,14656
"2004","VIRGINIA","HAMPTON",32016,326,23399,55741
"2004","VIRGINIA","HANOVER",13941,266,35404,49611
"2004","VIRGINIA","HARRISONBURG",4726,139,6165,11030
"2004","VIRGINIA","HENRICO",60864,745,71809,133418
"2004","VIRGINIA","HENRY",9851,249,13358,23458
"2004","VIRGINIA","HIGHLAND",522,16,982,1520
"2004","VIRGINIA","HOPEWELL",3573,112,4251,7936
"2004","VIRGINIA","ISLE OF WIGHT",5871,71,9929,15871
"2004","VIRGINIA","JAMES CITY",11934,207,18949,31090
"2004","VIRGINIA","KING AND QUEEN",1506,43,1737,3286
"2004","VIRGINIA","KING GEORGE",2739,58,5124,7921
"2004","VIRGINIA","KING WILLIAM",2436,39,4397,6872
"2004","VIRGINIA","LANCASTER",2477,29,3724,6230
"2004","VIRGINIA","LEE",4005,101,5664,9770
"2004","VIRGINIA","LEXINGTON",1340,27,982,2349
"2004","VIRGINIA","LOUDOUN",47271,777,60382,108430
"2004","VIRGINIA","LOUISA",4844,108,7083,12035
"2004","VIRGINIA","LUNENBURG",2362,25,2858,5245
"2004","VIRGINIA","LYNCHBURG",11727,213,14400,26340
"2004","VIRGINIA","MADISON",2176,40,3556,5772
"2004","VIRGINIA","MANASSAS",5562,84,7257,12903
"2004","VIRGINIA","MANASSAS PARK",1498,27,1807,3332
"2004","VIRGINIA","MARTINSVILLE",3036,29,2538,5603
"2004","VIRGINIA","MATHEWS",1589,43,3497,5129
"2004","VIRGINIA","MECKLENBURG",5293,168,7319,12780
"2004","VIRGINIA","MIDDLESEX",1914,127,3336,5377
"2004","VIRGINIA","MONTGOMERY",14128,317,17070,31515
"2004","VIRGINIA","NELSON",3543,57,3539,7139
"2004","VIRGINIA","NEW KENT",2443,89,5414,7946
"2004","VIRGINIA","NEWPORT NEWS",35319,425,32208,67952
"2004","VIRGINIA","NORFOLK",43518,651,26401,70570
"2004","VIRGINIA","NORTHAMPTON",2775,55,2669,5499
"2004","VIRGINIA","NORTHUMBERLAND",2548,29,3832,6409
"2004","VIRGINIA","NORTON",725,11,768,1504
"2004","VIRGINIA","NOTTOWAY",2635,92,3303,6030
"2004","VIRGINIA","ORANGE",5015,164,7749,12928
"2004","VIRGINIA","PAGE",3324,58,6221,9603
"2004","VIRGINIA","PATRICK",2572,136,5507,8215
"2004","VIRGINIA","PETERSBURG",9682,29,2238,11949
"2004","VIRGINIA","PITTSYLVANIA",9274,470,17673,27417
"2004","VIRGINIA","POQUOSON",1424,52,5004,6480
"2004","VIRGINIA","PORTSMOUTH",24112,210,15212,39534
"2004","VIRGINIA","POWHATAN",3112,96,8955,12163
"2004","VIRGINIA","PRINCE EDWARD",3632,113,3571,7316
"2004","VIRGINIA","PRINCE GEORGE",5066,57,8131,13254
"2004","VIRGINIA","PRINCE WILLIAM",61271,1016,69776,132063
"2004","VIRGINIA","PULASKI",5310,172,8769,14251
"2004","VIRGINIA","RADFORD",2244,37,2564,4845
"2004","VIRGINIA","RAPPAHANNOCK",1837,41,2172,4050
"2004","VIRGINIA","RICHMOND",53410,557,23719,77686
"2004","VIRGINIA","ROANOKE",34944,772,47257,82973
"2004","VIRGINIA","ROCKBRIDGE",3627,142,5412,9181
"2004","VIRGINIA","ROCKINGHAM",7273,206,21737,29216
"2004","VIRGINIA","RUSSELL",5167,179,6077,11423
"2004","VIRGINIA","SALEM",4254,115,7115,11484
"2004","VIRGINIA","SCOTT",3324,164,6479,9967
"2004","VIRGINIA","SHENANDOAH",5186,140,11820,17146
"2004","VIRGINIA","SMYTH",4143,270,7906,12319
"2004","VIRGINIA","SOUTHAMPTON",3431,43,4018,7492
"2004","VIRGINIA","SPOTSYLVANIA",16623,295,28527,45445
"2004","VIRGINIA","STAFFORD",17208,278,28500,45986
"2004","VIRGINIA","STAUNTON",3756,68,5805,9629
"2004","VIRGINIA","SUFFOLK",15233,193,16763,32189
"2004","VIRGINIA","SURRY",1954,25,1543,3522
"2004","VIRGINIA","SUSSEX",2420,35,1890,4345
"2004","VIRGINIA","TAZEWELL",7184,257,10039,17480
"2004","VIRGINIA","VIRGINIA BEACH",70666,1269,103752,175687
"2004","VIRGINIA","WARREN",5241,227,8600,14068
"2004","VIRGINIA","WASHINGTON",7339,426,14749,22514
"2004","VIRGINIA","WAYNESBORO",2792,79,5092,7963
"2004","VIRGINIA","WESTMORELAND",3370,45,3433,6848
"2004","VIRGINIA","WILLIAMSBURG",2216,40,2064,4320
"2004","VIRGINIA","WINCHESTER",3967,93,5283,9343
"2004","VIRGINIA","WISE",5802,180,8330,14312
"2004","VIRGINIA","WYTHE",3581,62,7911,11554
"2004","VIRGINIA","YORK",10276,208,19396,29880
"2004","WASHINGTON","ADAMS",1315,61,3751,5127
"2004","WASHINGTON","ASOTIN",3319,147,5320,8786
"2004","WASHINGTON","BENTON",21549,987,44350,66886
"2004","WASHINGTON","CHELAN",10471,443,18482,29396
"2004","WASHINGTON","CLALLAM",17049,846,18871,36766
"2004","WASHINGTON","CLARK",79538,2255,88646,170439
"2004","WASHINGTON","COLUMBIA",605,32,1470,2107
"2004","WASHINGTON","COWLITZ",21589,667,20217,42473
"2004","WASHINGTON","DOUGLAS",4306,166,8900,13372
"2004","WASHINGTON","FERRY",1201,121,2019,3341
"2004","WASHINGTON","FRANKLIN",5188,214,10757,16159
"2004","WASHINGTON","GARFIELD",365,20,935,1320
"2004","WASHINGTON","GRANT",7779,417,17799,25995
"2004","WASHINGTON","GRAYS HARBOR",14583,499,12871,27953
"2004","WASHINGTON","ISLAND",18216,589,19754,38559
"2004","WASHINGTON","JEFFERSON",11610,356,6650,18616
"2004","WASHINGTON","KING",580378,12113,301043,893534
"2004","WASHINGTON","KITSAP",60796,2049,55608,118453
"2004","WASHINGTON","KITTITAS",6731,301,9052,16084
"2004","WASHINGTON","KLICKITAT",4036,185,5016,9237
"2004","WASHINGTON","LEWIS",10726,660,21042,32428
"2004","WASHINGTON","LINCOLN",1706,90,4015,5811
"2004","WASHINGTON","MASON",12894,513,11987,25394
"2004","WASHINGTON","OKANOGAN",6309,397,9636,16342
"2004","WASHINGTON","PACIFIC",5570,227,4634,10431
"2004","WASHINGTON","PEND OREILLE",2310,195,3693,6198
"2004","WASHINGTON","PIERCE",158231,4317,150783,313331
"2004","WASHINGTON","SAN JUAN",6589,209,3290,10088
"2004","WASHINGTON","SKAGIT",25131,960,26139,52230
"2004","WASHINGTON","SKAMANIA",2374,90,2695,5159
"2004","WASHINGTON","SNOHOMISH",156468,4212,134317,294997
"2004","WASHINGTON","SPOKANE",87490,3491,111606,202587
"2004","WASHINGTON","STEVENS",6822,503,13015,20340
"2004","WASHINGTON","THURSTON",62650,2147,47992,112789
"2004","WASHINGTON","WAHKIAKUM",1021,43,1171,2235
"2004","WASHINGTON","WALLA WALLA",8257,345,14323,22925
"2004","WASHINGTON","WHATCOM",48268,1830,40296,90394
"2004","WASHINGTON","WHITMAN",8287,328,9397,18012
"2004","WASHINGTON","YAKIMA",28474,964,43352,72790
"2004","WEST VIRGINIA","BARBOUR",2610,41,4004,6655
"2004","WEST VIRGINIA","BERKELEY",12244,248,21293,33785
"2004","WEST VIRGINIA","BOONE",5933,58,4207,10198
"2004","WEST VIRGINIA","BRAXTON",3035,30,2986,6051
"2004","WEST VIRGINIA","BROOKE",5493,91,5189,10773
"2004","WEST VIRGINIA","CABELL",16583,332,21035,37950
"2004","WEST VIRGINIA","CALHOUN",1266,35,1360,2661
"2004","WEST VIRGINIA","CLAY",1835,39,2198,4072
"2004","WEST VIRGINIA","DODDRIDGE",800,17,2362,3179
"2004","WEST VIRGINIA","FAYETTE",8971,115,7881,16967
"2004","WEST VIRGINIA","GILMER",1159,28,1665,2852
"2004","WEST VIRGINIA","GRANT",963,21,4063,5047
"2004","WEST VIRGINIA","GREENBRIER",6084,111,8358,14553
"2004","WEST VIRGINIA","HAMPSHIRE",2455,52,5489,7996
"2004","WEST VIRGINIA","HANCOCK",6906,117,7298,14321
"2004","WEST VIRGINIA","HARDY",1617,24,3635,5276
"2004","WEST VIRGINIA","HARRISON",13238,239,17111,30588
"2004","WEST VIRGINIA","JACKSON",5384,88,7686,13158
"2004","WEST VIRGINIA","JEFFERSON",9301,153,10539,19993
"2004","WEST VIRGINIA","KANAWHA",43010,488,44430,87928
"2004","WEST VIRGINIA","LEWIS",2475,79,4445,6999
"2004","WEST VIRGINIA","LINCOLN",4048,162,4102,8312
"2004","WEST VIRGINIA","LOGAN",7877,63,7047,14987
"2004","WEST VIRGINIA","MARION",12771,273,12150,25194
"2004","WEST VIRGINIA","MARSHALL",6435,121,8516,15072
"2004","WEST VIRGINIA","MASON",5408,95,6487,11990
"2004","WEST VIRGINIA","MCDOWELL",4501,36,2762,7299
"2004","WEST VIRGINIA","MERCER",9178,144,13057,22379
"2004","WEST VIRGINIA","MINERAL",3518,89,7854,11461
"2004","WEST VIRGINIA","MINGO",5983,60,4612,10655
"2004","WEST VIRGINIA","MONONGALIA",16313,323,17670,34306
"2004","WEST VIRGINIA","MONROE",2311,50,3590,5951
"2004","WEST VIRGINIA","MORGAN",2272,64,4511,6847
"2004","WEST VIRGINIA","NICHOLAS",4788,78,5485,10351
"2004","WEST VIRGINIA","OHIO",8543,155,11694,20392
"2004","WEST VIRGINIA","PENDLETON",1381,17,2146,3544
"2004","WEST VIRGINIA","PLEASANTS",1349,25,2061,3435
"2004","WEST VIRGINIA","POCAHONTAS",1573,50,2295,3918
"2004","WEST VIRGINIA","PRESTON",3963,111,7855,11929
"2004","WEST VIRGINIA","PUTNAM",9301,134,15716,25151
"2004","WEST VIRGINIA","RALEIGH",11815,191,18519,30525
"2004","WEST VIRGINIA","RANDOLPH",4892,86,6512,11490
"2004","WEST VIRGINIA","RITCHIE",1070,40,3086,4196
"2004","WEST VIRGINIA","ROANE",2612,48,3440,6100
"2004","WEST VIRGINIA","SUMMERS",2504,42,2978,5524
"2004","WEST VIRGINIA","TAYLOR",2617,41,3893,6551
"2004","WEST VIRGINIA","TUCKER",1400,21,2179,3600
"2004","WEST VIRGINIA","TYLER",1401,46,2798,4245
"2004","WEST VIRGINIA","UPSHUR",3034,68,6191,9293
"2004","WEST VIRGINIA","WAYNE",8411,128,10070,18609
"2004","WEST VIRGINIA","WEBSTER",1965,25,1724,3714
"2004","WEST VIRGINIA","WETZEL",3330,52,3656,7038
"2004","WEST VIRGINIA","WIRT",896,31,1727,2654
"2004","WEST VIRGINIA","WOOD",14025,254,24948,39227
"2004","WEST VIRGINIA","WYOMING",3694,39,4985,8718
"2004","WISCONSIN","ADAMS",5447,119,4890,10456
"2004","WISCONSIN","ASHLAND",5805,81,3313,9199
"2004","WISCONSIN","BARRON",11696,211,12030,23937
"2004","WISCONSIN","BAYFIELD",5845,100,3754,9699
"2004","WISCONSIN","BROWN",54935,1186,67173,123294
"2004","WISCONSIN","BUFFALO",3998,91,3502,7591
"2004","WISCONSIN","BURNETT",4499,79,4743,9321
"2004","WISCONSIN","CALUMET",10290,265,14721,25276
"2004","WISCONSIN","CHIPPEWA",14751,323,15450,30524
"2004","WISCONSIN","CLARK",6966,193,7966,15125
"2004","WISCONSIN","COLUMBIA",14300,299,14956,29555
"2004","WISCONSIN","CRAWFORD",4656,123,3680,8459
"2004","WISCONSIN","DANE",181052,2828,90369,274249
"2004","WISCONSIN","DODGE",16690,445,27201,44336
"2004","WISCONSIN","DOOR",8367,214,8910,17491
"2004","WISCONSIN","DOUGLAS",16537,202,8448,25187
"2004","WISCONSIN","DUNN",12039,254,10879,23172
"2004","WISCONSIN","EAU CLAIRE",30068,716,24653,55437
"2004","WISCONSIN","FLORENCE",993,28,1703,2724
"2004","WISCONSIN","FOND DU LAC",19216,529,33291,53036
"2004","WISCONSIN","FOREST",2509,36,2608,5153
"2004","WISCONSIN","GRANT",12864,192,12208,25264
"2004","WISCONSIN","GREEN",9575,176,8497,18248
"2004","WISCONSIN","GREEN LAKE",3605,101,6472,10178
"2004","WISCONSIN","IOWA",7122,72,5348,12542
"2004","WISCONSIN","IRON",1956,39,1884,3879
"2004","WISCONSIN","JACKSON",5249,90,4387,9726
"2004","WISCONSIN","JEFFERSON",17925,414,23776,42115
"2004","WISCONSIN","JUNEAU",5734,172,6473,12379
"2004","WISCONSIN","KENOSHA",40107,734,35587,76428
"2004","WISCONSIN","KEWAUNEE",5175,128,5970,11273
"2004","WISCONSIN","LA CROSSE",33170,677,28289,62136
"2004","WISCONSIN","LAFAYETTE",4402,57,3929,8388
"2004","WISCONSIN","LANGLADE",4751,88,6235,11074
"2004","WISCONSIN","LINCOLN",7484,192,8024,15700
"2004","WISCONSIN","MANITOWOC",20652,481,23027,44160
"2004","WISCONSIN","MARATHON",30899,766,36394,68059
"2004","WISCONSIN","MARINETTE",10190,214,11866,22270
"2004","WISCONSIN","MARQUETTE",3785,88,4604,8477
"2004","WISCONSIN","MENOMINEE",1412,10,288,1710
"2004","WISCONSIN","MILWAUKEE",297653,4296,180287,482236
"2004","WISCONSIN","MONROE",8973,206,10375,19554
"2004","WISCONSIN","OCONTO",8534,217,11043,19794
"2004","WISCONSIN","ONEIDA",10464,224,11351,22039
"2004","WISCONSIN","OUTAGAMIE",40169,978,48903,90050
"2004","WISCONSIN","OZAUKEE",17714,414,34904,53032
"2004","WISCONSIN","PEPIN",2181,32,1853,4066
"2004","WISCONSIN","PIERCE",11176,263,10437,21876
"2004","WISCONSIN","POLK",11173,235,12095,23503
"2004","WISCONSIN","PORTAGE",21861,554,16546,38961
"2004","WISCONSIN","PRICE",4349,102,4312,8763
"2004","WISCONSIN","RACINE",48229,884,52456,101569
"2004","WISCONSIN","RICHLAND",4501,83,4836,9420
"2004","WISCONSIN","ROCK",46598,730,33151,80479
"2004","WISCONSIN","RUSK",3820,122,3985,7927
"2004","WISCONSIN","SAUK",15708,294,14415,30417
"2004","WISCONSIN","SAWYER",4411,91,4951,9453
"2004","WISCONSIN","SHAWANO",8657,192,12150,20999
"2004","WISCONSIN","SHEBOYGAN",27608,559,34458,62625
"2004","WISCONSIN","ST. CROIX",18784,372,22679,41835
"2004","WISCONSIN","TAYLOR",3829,132,5582,9543
"2004","WISCONSIN","TREMPEALEAU",8075,109,5878,14062
"2004","WISCONSIN","VERNON",7924,147,6774,14845
"2004","WISCONSIN","VILAS",5713,134,8155,14002
"2004","WISCONSIN","WALWORTH",19177,515,28754,48446
"2004","WISCONSIN","WASHBURN",4705,100,4762,9567
"2004","WISCONSIN","WASHINGTON",21234,592,50641,72467
"2004","WISCONSIN","WAUKESHA",73626,1811,154926,230363
"2004","WISCONSIN","WAUPACA",10792,241,15941,26974
"2004","WISCONSIN","WAUSHARA",5257,101,6888,12246
"2004","WISCONSIN","WINNEBAGO",40943,1111,46542,88596
"2004","WISCONSIN","WOOD",18950,529,20592,40071
"2004","WYOMING","ALBANY",7117,501,9006,16624
"2004","WYOMING","BIG HORN",960,91,4232,5283
"2004","WYOMING","CAMPBELL",2464,220,12415,15099
"2004","WYOMING","CARBON",2158,161,4758,7077
"2004","WYOMING","CONVERSE",1184,94,4447,5725
"2004","WYOMING","CROOK",501,59,2836,3396
"2004","WYOMING","FREMONT",5338,329,11429,17096
"2004","WYOMING","GOSHEN",1566,99,4114,5779
"2004","WYOMING","HOT SPRINGS",623,45,1812,2480
"2004","WYOMING","JOHNSON",676,84,3231,3991
"2004","WYOMING","LARAMIE",13171,757,25951,39879
"2004","WYOMING","LINCOLN",1364,127,6423,7914
"2004","WYOMING","NATRONA",9863,693,21512,32068
"2004","WYOMING","NIOBRARA",230,20,1064,1314
"2004","WYOMING","PARK",3007,307,10917,14231
"2004","WYOMING","PLATTE",1328,97,3149,4574
"2004","WYOMING","SHERIDAN",4066,274,9689,14029
"2004","WYOMING","SUBLETTE",730,74,2847,3651
"2004","WYOMING","SWEETWATER",5208,411,10653,16272
"2004","WYOMING","TETON",5972,263,5124,11359
"2004","WYOMING","UINTA",1815,185,6081,8081
"2004","WYOMING","WASHAKIE",855,59,3200,4114
"2004","WYOMING","WESTON",580,73,2739,3392
"2008","ALABAMA","AUTAUGA",6093,145,17403,23641
"2008","ALABAMA","BALDWIN",19386,756,61271,81413
"2008","ALABAMA","BARBOUR",5697,67,5866,11630
"2008","ALABAMA","BIBB",2299,83,6262,8644
"2008","ALABAMA","BLOUNT",3522,356,20389,24267
"2008","ALABAMA","BULLOCK",4011,13,1391,5415
"2008","ALABAMA","BUTLER",4188,36,5485,9709
"2008","ALABAMA","CALHOUN",16334,560,32348,49242
"2008","ALABAMA","CHAMBERS",6799,90,8067,14956
"2008","ALABAMA","CHEROKEE",2306,141,7298,9745
"2008","ALABAMA","CHILTON",3674,151,13960,17785
"2008","ALABAMA","CHOCTAW",3636,35,4223,7894
"2008","ALABAMA","CLARKE",5914,55,7466,13435
"2008","ALABAMA","CLAY",1760,75,4984,6819
"2008","ALABAMA","CLEBURNE",1168,108,5216,6492
"2008","ALABAMA","COFFEE",5079,130,14919,20128
"2008","ALABAMA","COLBERT",9703,401,14739,24843
"2008","ALABAMA","CONECUH",3429,44,3470,6943
"2008","ALABAMA","COOSA",2273,42,3248,5563
"2008","ALABAMA","COVINGTON",3240,103,12444,15787
"2008","ALABAMA","CRENSHAW",1938,34,4319,6291
"2008","ALABAMA","CULLMAN",5864,545,28896,35305
"2008","ALABAMA","DALE",5270,164,13886,19320
"2008","ALABAMA","DALLAS",13986,68,6798,20852
"2008","ALABAMA","DEKALB",5658,400,17957,24015
"2008","ALABAMA","ELMORE",8301,237,25777,34315
"2008","ALABAMA","ESCAMBIA",5188,111,9375,14674
"2008","ALABAMA","ETOWAH",13497,645,30595,44737
"2008","ALABAMA","FAYETTE",1994,80,5883,7957
"2008","ALABAMA","FRANKLIN",3469,176,8048,11693
"2008","ALABAMA","GENEVA",2134,106,9417,11657
"2008","ALABAMA","GREENE",4408,21,876,5305
"2008","ALABAMA","HALE",4982,32,3200,8214
"2008","ALABAMA","HENRY",3018,45,5585,8648
"2008","ALABAMA","HOUSTON",12225,256,29254,41735
"2008","ALABAMA","JACKSON",6374,417,14083,20874
"2008","ALABAMA","JEFFERSON",166121,2482,149921,318524
"2008","ALABAMA","LAMAR",1614,42,5419,7075
"2008","ALABAMA","LAUDERDALE",13329,707,24068,38104
"2008","ALABAMA","LAWRENCE",5164,239,9277,14680
"2008","ALABAMA","LEE",21498,597,32230,54325
"2008","ALABAMA","LIMESTONE",9536,417,23598,33551
"2008","ALABAMA","LOWNDES",5449,20,1809,7278
"2008","ALABAMA","MACON",9450,31,1396,10877
"2008","ALABAMA","MADISON",64117,1817,86965,152899
"2008","ALABAMA","MARENGO",5926,29,5516,11471
"2008","ALABAMA","MARION",2600,219,9536,12355
"2008","ALABAMA","MARSHALL",7038,401,25727,33166
"2008","ALABAMA","MOBILE",82181,1194,98049,181424
"2008","ALABAMA","MONROE",5025,52,6175,11252
"2008","ALABAMA","MONTGOMERY",62166,546,42031,104743
"2008","ALABAMA","MORGAN",13895,633,36014,50542
"2008","ALABAMA","PERRY",4457,23,1679,6159
"2008","ALABAMA","PICKENS",4594,39,5434,10067
"2008","ALABAMA","PIKE",5879,72,8004,13955
"2008","ALABAMA","RANDOLPH",3064,145,7175,10384
"2008","ALABAMA","RUSSELL",10085,125,8705,18915
"2008","ALABAMA","SHELBY",20625,958,69060,90643
"2008","ALABAMA","ST. CLAIR",6091,348,27649,34088
"2008","ALABAMA","SUMTER",5264,25,1731,7020
"2008","ALABAMA","TALLADEGA",13779,313,20112,34204
"2008","ALABAMA","TALLAPOOSA",6063,132,13116,19311
"2008","ALABAMA","TUSCALOOSA",32796,711,45405,78912
"2008","ALABAMA","WALKER",7420,510,20722,28652
"2008","ALABAMA","WASHINGTON",3067,54,5654,8775
"2008","ALABAMA","WILCOX",4612,14,1868,6494
"2008","ALABAMA","WINSTON",1757,171,8103,10031
"2008","ALASKA","DISTRICT 1",2597,224,4149,6970
"2008","ALASKA","DISTRICT 10",2074,149,3392,5615
"2008","ALASKA","DISTRICT 11",1924,206,7736,9866
"2008","ALASKA","DISTRICT 12",1914,208,5467,7589
"2008","ALASKA","DISTRICT 13",2800,294,8432,11526
"2008","ALASKA","DISTRICT 14",2132,216,8108,10456
"2008","ALASKA","DISTRICT 15",2510,349,8227,11086
"2008","ALASKA","DISTRICT 16",2636,287,7774,10697
"2008","ALASKA","DISTRICT 17",2645,182,6621,9448
"2008","ALASKA","DISTRICT 18",2046,113,4252,6411
"2008","ALASKA","DISTRICT 19",3095,171,4106,7372
"2008","ALASKA","DISTRICT 2",3468,238,4029,7735
"2008","ALASKA","DISTRICT 20",2474,128,2536,5138
"2008","ALASKA","DISTRICT 21",3647,191,4837,8675
"2008","ALASKA","DISTRICT 22",3337,188,3109,6634
"2008","ALASKA","DISTRICT 23",4075,199,2808,7082
"2008","ALASKA","DISTRICT 24",3380,181,4127,7688
"2008","ALASKA","DISTRICT 25",3233,168,3042,6443
"2008","ALASKA","DISTRICT 26",4472,186,4037,8695
"2008","ALASKA","DISTRICT 27",3130,209,5159,8498
"2008","ALASKA","DISTRICT 28",3642,197,5953,9792
"2008","ALASKA","DISTRICT 29",2684,151,4127,6962
"2008","ALASKA","DISTRICT 3",5657,281,2829,8767
"2008","ALASKA","DISTRICT 30",3486,197,5500,9183
"2008","ALASKA","DISTRICT 31",3596,205,6419,10220
"2008","ALASKA","DISTRICT 32",5176,264,6867,12307
"2008","ALASKA","DISTRICT 33",2089,249,6571,8909
"2008","ALASKA","DISTRICT 34",1920,270,7358,9548
"2008","ALASKA","DISTRICT 35",4254,290,4959,9503
"2008","ALASKA","DISTRICT 36",2264,208,4201,6673
"2008","ALASKA","DISTRICT 37",1868,136,2661,4665
"2008","ALASKA","DISTRICT 38",2549,215,2056,4820
"2008","ALASKA","DISTRICT 39",2695,166,2323,5184
"2008","ALASKA","DISTRICT 4",4161,273,4302,8736
"2008","ALASKA","DISTRICT 40",2137,177,2686,5000
"2008","ALASKA","DISTRICT 5",3393,304,3426,7123
"2008","ALASKA","DISTRICT 6",2351,239,4234,6824
"2008","ALASKA","DISTRICT 7",4283,314,6297,10894
"2008","ALASKA","DISTRICT 8",4995,342,4983,10320
"2008","ALASKA","DISTRICT 9",2805,197,4141,7143
"2008","ALASKA","DISTRICT 99",0,0,0,0
"2008","ARIZONA","APACHE",15390,321,8551,24262
"2008","ARIZONA","COCHISE",18943,851,29026,48820
"2008","ARIZONA","COCONINO",31433,725,22186,54344
"2008","ARIZONA","GILA",7884,354,14095,22333
"2008","ARIZONA","GRAHAM",3487,144,8376,12007
"2008","ARIZONA","GREENLEE",1165,36,1712,2913
"2008","ARIZONA","LA PAZ",1929,114,3509,5552
"2008","ARIZONA","MARICOPA",602166,16348,746448,1364962
"2008","ARIZONA","MOHAVE",22092,1180,44333,67605
"2008","ARIZONA","NAVAJO",15579,460,19761,35800
"2008","ARIZONA","PIMA",206254,4768,182406,393428
"2008","ARIZONA","PINAL",44254,1208,59421,104883
"2008","ARIZONA","SANTA CRUZ",8683,102,4518,13303
"2008","ARIZONA","YAVAPAI",36889,1567,61192,99648
"2008","ARIZONA","YUMA",18559,479,24577,43615
"2008","ARKANSAS","ARKANSAS",2619,174,4185,6978
"2008","ARKANSAS","ASHLEY",2976,260,5406,8642
"2008","ARKANSAS","BAXTER",6539,590,12852,19981
"2008","ARKANSAS","BENTON",23331,1618,51124,76073
"2008","ARKANSAS","BOONE",4435,464,10575,15474
"2008","ARKANSAS","BRADLEY",1680,99,2262,4041
"2008","ARKANSAS","CALHOUN",691,64,1462,2217
"2008","ARKANSAS","CARROLL",4172,324,6083,10579
"2008","ARKANSAS","CHICOT",3043,46,2119,5208
"2008","ARKANSAS","CLARK",4267,219,4608,9094
"2008","ARKANSAS","CLAY",2244,235,3032,5511
"2008","ARKANSAS","CLEBURNE",2951,425,7962,11338
"2008","ARKANSAS","CLEVELAND",911,143,2451,3505
"2008","ARKANSAS","COLUMBIA",3554,143,5861,9558
"2008","ARKANSAS","CONWAY",3149,298,4691,8138
"2008","ARKANSAS","CRAIGHEAD",11294,793,18881,30968
"2008","ARKANSAS","CRAWFORD",5238,606,14688,20532
"2008","ARKANSAS","CRITTENDEN",10330,275,7650,18255
"2008","ARKANSAS","CROSS",2580,157,4393,7130
"2008","ARKANSAS","DALLAS",1471,90,1757,3318
"2008","ARKANSAS","DESHA",2569,110,1999,4678
"2008","ARKANSAS","DREW",2598,152,3860,6610
"2008","ARKANSAS","FAULKNER",14955,862,25362,41179
"2008","ARKANSAS","FRANKLIN",1869,195,4411,6475
"2008","ARKANSAS","FULTON",1819,155,2702,4676
"2008","ARKANSAS","GARLAND",15899,995,26825,43719
"2008","ARKANSAS","GRANT",1562,208,5023,6793
"2008","ARKANSAS","GREENE",4541,493,8578,13612
"2008","ARKANSAS","HEMPSTEAD",2869,207,4273,7349
"2008","ARKANSAS","HOT SPRING",4288,458,7209,11955
"2008","ARKANSAS","HOWARD",1746,143,2957,4846
"2008","ARKANSAS","INDEPENDENCE",3688,356,8255,12299
"2008","ARKANSAS","IZARD",1792,233,3193,5218
"2008","ARKANSAS","JACKSON",2207,257,3118,5582
"2008","ARKANSAS","JEFFERSON",18465,569,10655,29689
"2008","ARKANSAS","JOHNSON",3034,224,4922,8180
"2008","ARKANSAS","LAFAYETTE",1133,84,1685,2902
"2008","ARKANSAS","LAWRENCE",2138,335,3357,5830
"2008","ARKANSAS","LEE",2263,46,1454,3763
"2008","ARKANSAS","LINCOLN",1710,183,2513,4406
"2008","ARKANSAS","LITTLE RIVER",1753,152,3247,5152
"2008","ARKANSAS","LOGAN",2286,271,5350,7907
"2008","ARKANSAS","LONOKE",5968,531,17242,23741
"2008","ARKANSAS","MADISON",2144,212,3972,6328
"2008","ARKANSAS","MARION",2384,254,4524,7162
"2008","ARKANSAS","MILLER",4869,281,9913,15063
"2008","ARKANSAS","MISSISSIPPI",6667,367,6976,14010
"2008","ARKANSAS","MONROE",1615,80,1754,3449
"2008","ARKANSAS","MONTGOMERY",1092,165,2365,3622
"2008","ARKANSAS","NEVADA",1474,99,2062,3635
"2008","ARKANSAS","NEWTON",1182,190,2588,3960
"2008","ARKANSAS","OUACHITA",4346,187,5427,9960
"2008","ARKANSAS","PERRY",1352,184,2743,4279
"2008","ARKANSAS","PHILLIPS",5695,177,3097,8969
"2008","ARKANSAS","PIKE",1089,150,2727,3966
"2008","ARKANSAS","POINSETT",2742,283,4903,7928
"2008","ARKANSAS","POLK",1957,251,5473,7681
"2008","ARKANSAS","POPE",6002,509,15568,22079
"2008","ARKANSAS","PRAIRIE",1048,110,2223,3381
"2008","ARKANSAS","PULASKI",88854,2277,70212,161343
"2008","ARKANSAS","RANDOLPH",2469,235,3615,6319
"2008","ARKANSAS","SALINE",12695,977,30981,44653
"2008","ARKANSAS","SCOTT",1053,151,2791,3995
"2008","ARKANSAS","SEARCY",961,160,2726,3847
"2008","ARKANSAS","SEBASTIAN",13673,902,28637,43212
"2008","ARKANSAS","SEVIER",1291,164,3125,4580
"2008","ARKANSAS","SHARP",2436,281,4535,7252
"2008","ARKANSAS","ST. FRANCIS",5486,102,3917,9505
"2008","ARKANSAS","STONE",1598,192,3534,5324
"2008","ARKANSAS","UNION",6190,312,10677,17179
"2008","ARKANSAS","VAN BUREN",2151,276,4276,6703
"2008","ARKANSAS","WASHINGTON",29021,1396,37963,68380
"2008","ARKANSAS","WHITE",6732,756,19467,26955
"2008","ARKANSAS","WOODRUFF",1412,143,1206,2761
"2008","ARKANSAS","YELL",2003,225,3808,6036
"2008","CALIFORNIA","ALAMEDA",489106,12368,119555,621029
"2008","CALIFORNIA","ALPINE",422,18,252,692
"2008","CALIFORNIA","AMADOR",7813,436,10561,18810
"2008","CALIFORNIA","BUTTE",49013,2606,46706,98325
"2008","CALIFORNIA","CALAVERAS",9813,658,12835,23306
"2008","CALIFORNIA","COLUSA",2569,127,3733,6429
"2008","CALIFORNIA","CONTRA COSTA",306983,8231,136436,451650
"2008","CALIFORNIA","DEL NORTE",4323,241,4967,9531
"2008","CALIFORNIA","EL DORADO",40529,2083,50314,92926
"2008","CALIFORNIA","FRESNO",136706,4568,131015,272289
"2008","CALIFORNIA","GLENN",3734,235,5910,9879
"2008","CALIFORNIA","HUMBOLDT",39692,2322,21713,63727
"2008","CALIFORNIA","IMPERIAL",24162,650,14008,38820
"2008","CALIFORNIA","INYO",3743,267,4523,8533
"2008","CALIFORNIA","KERN",93457,4600,134793,232850
"2008","CALIFORNIA","KINGS",14747,651,19710,35108
"2008","CALIFORNIA","LAKE",14854,753,9935,25542
"2008","CALIFORNIA","LASSEN",3586,318,7483,11387
"2008","CALIFORNIA","LOS ANGELES",2295853,65970,956425,3318248
"2008","CALIFORNIA","MADERA",17952,820,23583,42355
"2008","CALIFORNIA","MARIN",109320,2493,28384,140197
"2008","CALIFORNIA","MARIPOSA",4100,253,5298,9651
"2008","CALIFORNIA","MENDOCINO",27843,1452,10721,40016
"2008","CALIFORNIA","MERCED",34031,1073,28704,63808
"2008","CALIFORNIA","MODOC",1313,126,2981,4420
"2008","CALIFORNIA","MONO",3093,124,2354,5571
"2008","CALIFORNIA","MONTEREY",88453,2533,38797,129783
"2008","CALIFORNIA","NAPA",38849,1309,19484,59642
"2008","CALIFORNIA","NEVADA",28617,1367,25663,55647
"2008","CALIFORNIA","ORANGE",549558,25065,579064,1153687
"2008","CALIFORNIA","PLACER",75112,3348,94647,173107
"2008","CALIFORNIA","PLUMAS",4715,278,6035,11028
"2008","CALIFORNIA","RIVERSIDE",325017,12241,310041,647299
"2008","CALIFORNIA","SACRAMENTO",316506,11012,213583,541101
"2008","CALIFORNIA","SAN BENITO",11917,363,7425,19705
"2008","CALIFORNIA","SAN BERNARDINO",315720,13206,277408,606334
"2008","CALIFORNIA","SAN DIEGO",666581,23434,541032,1231047
"2008","CALIFORNIA","SAN FRANCISCO",322220,8353,52292,382865
"2008","CALIFORNIA","SAN JOAQUIN",113974,3768,91607,209349
"2008","CALIFORNIA","SAN LUIS OBISPO",68176,3422,61055,132653
"2008","CALIFORNIA","SAN MATEO",222826,5409,75057,303292
"2008","CALIFORNIA","SANTA BARBARA",105614,3713,65585,174912
"2008","CALIFORNIA","SANTA CLARA",462241,13309,190039,665589
"2008","CALIFORNIA","SANTA CRUZ",98745,3494,25244,127483
"2008","CALIFORNIA","SHASTA",28867,1935,49588,80390
"2008","CALIFORNIA","SIERRA",743,90,1158,1991
"2008","CALIFORNIA","SISKIYOU",9292,658,11520,21470
"2008","CALIFORNIA","SOLANO",102095,2843,56035,160973
"2008","CALIFORNIA","SONOMA",168888,5336,55127,229351
"2008","CALIFORNIA","STANISLAUS",80279,3239,77497,161015
"2008","CALIFORNIA","SUTTER",13412,618,18911,32941
"2008","CALIFORNIA","TEHAMA",8945,648,14843,24436
"2008","CALIFORNIA","TRINITY",3233,201,2940,6374
"2008","CALIFORNIA","TULARE",43634,1807,59765,105206
"2008","CALIFORNIA","TUOLUMNE",11532,661,14988,27181
"2008","CALIFORNIA","VENTURA",187601,6346,145853,339800
"2008","CALIFORNIA","YOLO",53488,1669,24592,79749
"2008","CALIFORNIA","YUBA",8866,528,12007,21401
"2008","COLORADO","ADAMS",93443,3080,63976,160499
"2008","COLORADO","ALAMOSA",3521,130,2635,6286
"2008","COLORADO","ARAPAHOE",148218,4064,113866,266148
"2008","COLORADO","ARCHULETA",2836,151,3638,6625
"2008","COLORADO","BACA",536,67,1572,2175
"2008","COLORADO","BENT",799,44,1077,1920
"2008","COLORADO","BOULDER",124159,2700,44904,171763
"2008","COLORADO","BROOMFIELD",16168,528,12757,29453
"2008","COLORADO","CHAFFEE",4861,186,4873,9920
"2008","COLORADO","CHEYENNE",198,23,890,1111
"2008","COLORADO","CLEAR CREEK",3332,135,2300,5767
"2008","COLORADO","CONEJOS",2154,67,1653,3874
"2008","COLORADO","COSTILLA",1245,37,415,1697
"2008","COLORADO","CROWLEY",552,30,976,1558
"2008","COLORADO","CUSTER",912,45,1672,2629
"2008","COLORADO","DELTA",5084,283,10067,15434
"2008","COLORADO","DENVER",204882,4084,62567,271533
"2008","COLORADO","DOLORES",369,30,818,1217
"2008","COLORADO","DOUGLAS",61960,1751,88108,151819
"2008","COLORADO","EAGLE",13187,286,8179,21652
"2008","COLORADO","EL PASO",108899,3958,160318,273175
"2008","COLORADO","ELBERT",3819,279,9108,13206
"2008","COLORADO","FREMONT",6844,407,12668,19919
"2008","COLORADO","GARFIELD",11357,366,11359,23082
"2008","COLORADO","GILPIN",1954,94,1253,3301
"2008","COLORADO","GRAND",4037,143,4128,8308
"2008","COLORADO","GUNNISON",5556,183,3131,8870
"2008","COLORADO","HINSDALE",240,15,344,599
"2008","COLORADO","HUERFANO",1989,74,1580,3643
"2008","COLORADO","JACKSON",277,12,624,913
"2008","COLORADO","JEFFERSON",158153,5282,131627,295062
"2008","COLORADO","KIOWA",178,24,650,852
"2008","COLORADO","KIT CARSON",912,75,2455,3442
"2008","COLORADO","LA PLATA",16057,419,11503,27979
"2008","COLORADO","LAKE",1859,65,1078,3002
"2008","COLORADO","LARIMER",89822,2910,73641,166373
"2008","COLORADO","LAS ANIMAS",3562,113,3086,6761
"2008","COLORADO","LINCOLN",546,41,1717,2304
"2008","COLORADO","LOGAN",2846,129,6002,8977
"2008","COLORADO","MESA",24008,1045,44578,69631
"2008","COLORADO","MINERAL",270,19,334,623
"2008","COLORADO","MOFFAT",1582,154,4135,5871
"2008","COLORADO","MONTEZUMA",4661,203,6961,11825
"2008","COLORADO","MONTROSE",6495,459,12199,19153
"2008","COLORADO","MORGAN",3813,149,6272,10234
"2008","COLORADO","OTERO",3546,125,4393,8064
"2008","COLORADO","OURAY",1636,57,1367,3060
"2008","COLORADO","PARK",4250,237,4896,9383
"2008","COLORADO","PHILLIPS",622,26,1612,2260
"2008","COLORADO","PITKIN",7349,133,2484,9966
"2008","COLORADO","PROWERS",1487,85,3043,4615
"2008","COLORADO","PUEBLO",41097,1073,30257,72427
"2008","COLORADO","RIO BLANCO",655,55,2437,3147
"2008","COLORADO","RIO GRANDE",2448,66,2930,5444
"2008","COLORADO","ROUTT",8270,204,4725,13199
"2008","COLORADO","SAGUACHE",1730,64,953,2747
"2008","COLORADO","SAN JUAN",264,14,218,496
"2008","COLORADO","SAN MIGUEL",3349,68,933,4350
"2008","COLORADO","SEDGWICK",468,26,857,1351
"2008","COLORADO","SUMMIT",9802,214,4883,14899
"2008","COLORADO","TELLER",4513,247,8146,12906
"2008","COLORADO","WASHINGTON",529,35,1949,2513
"2008","COLORADO","WELD",47292,2048,56526,105866
"2008","COLORADO","YUMA",1117,80,3286,4483
"2008","CONNECTICUT","FAIRFIELD",241320,2931,166845,411096
"2008","CONNECTICUT","HARTFORD",268301,4768,138716,411785
"2008","CONNECTICUT","LITCHFIELD",51037,1657,46176,98870
"2008","CONNECTICUT","MIDDLESEX",52966,1282,32907,87155
"2008","CONNECTICUT","NEW HAVEN",232820,4454,144465,381739
"2008","CONNECTICUT","NEW LONDON",74745,1560,48460,124765
"2008","CONNECTICUT","STATEWIDE WRITEIN",0,0,0,0
"2008","CONNECTICUT","TOLLAND",44969,1175,29262,75406
"2008","CONNECTICUT","WINDHAM",34133,926,21210,56269
"2008","DELAWARE","KENT",36392,706,29827,66925
"2008","DELAWARE","NEW CASTLE",178768,3041,74608,256417
"2008","DELAWARE","SUSSEX",40299,832,47939,89070
"2008","DISTRICT OF COLUMBIA","DISTRICT OF COLUMBIA",245800,2686,17367,265853
"2008","FLORIDA","ALACHUA",75565,1441,48513,125519
"2008","FLORIDA","BAKER",2327,60,8672,11059
"2008","FLORIDA","BAY",23653,791,56683,81127
"2008","FLORIDA","BRADFORD",3430,110,8136,11676
"2008","FLORIDA","BREVARD",127620,2650,157589,287859
"2008","FLORIDA","BROWARD",492640,3530,237729,733899
"2008","FLORIDA","CALHOUN",1821,78,4345,6244
"2008","FLORIDA","CHARLOTTE",39031,922,45205,85158
"2008","FLORIDA","CITRUS",31460,992,43706,76158
"2008","FLORIDA","CLAY",26697,677,67203,94577
"2008","FLORIDA","COLLIER",54450,1159,86379,141988
"2008","FLORIDA","COLUMBIA",9171,287,18670,28128
"2008","FLORIDA","DESOTO",4383,116,5632,10131
"2008","FLORIDA","DIXIE",1925,145,5194,7264
"2008","FLORIDA","DUVAL",202618,2606,210537,415761
"2008","FLORIDA","ESCAMBIA",61572,1464,91411,154447
"2008","FLORIDA","FLAGLER",24726,354,23951,49031
"2008","FLORIDA","FRANKLIN",2134,77,3818,6029
"2008","FLORIDA","GADSDEN",15582,117,6811,22510
"2008","FLORIDA","GILCHRIST",1996,167,5656,7819
"2008","FLORIDA","GLADES",1674,54,2533,4261
"2008","FLORIDA","GULF",2149,76,4980,7205
"2008","FLORIDA","HAMILTON",2364,44,3179,5587
"2008","FLORIDA","HARDEE",2568,81,4763,7412
"2008","FLORIDA","HENDRY",4998,101,5780,10879
"2008","FLORIDA","HERNANDO",41886,994,45021,87901
"2008","FLORIDA","HIGHLANDS",18135,427,26221,44783
"2008","FLORIDA","HILLSBOROUGH",272963,3994,236355,513312
"2008","FLORIDA","HOLMES",1446,110,7033,8589
"2008","FLORIDA","INDIAN RIVER",29710,705,40176,70591
"2008","FLORIDA","JACKSON",7671,177,13717,21565
"2008","FLORIDA","JEFFERSON",4088,72,3797,7957
"2008","FLORIDA","LAFAYETTE",642,38,2679,3359
"2008","FLORIDA","LAKE",62948,1176,82802,146926
"2008","FLORIDA","LEE",119701,1967,147608,269276
"2008","FLORIDA","LEON",91747,1156,55705,148608
"2008","FLORIDA","LEVY",6711,260,11754,18725
"2008","FLORIDA","LIBERTY",895,44,2339,3278
"2008","FLORIDA","MADISON",4270,93,4544,8907
"2008","FLORIDA","MANATEE",70034,1239,80721,151994
"2008","FLORIDA","MARION",70839,1555,89628,162022
"2008","FLORIDA","MARTIN",33508,643,44143,78294
"2008","FLORIDA","MIAMI-DADE",499831,3104,360551,863486
"2008","FLORIDA","MONROE",20907,432,18933,40272
"2008","FLORIDA","NASSAU",10618,283,27403,38304
"2008","FLORIDA","OKALOOSA",25872,868,68789,95529
"2008","FLORIDA","OKEECHOBEE",5108,117,7561,12786
"2008","FLORIDA","ORANGE",273009,2870,186832,462711
"2008","FLORIDA","OSCEOLA",59962,622,40086,100670
"2008","FLORIDA","PALM BEACH",361271,3192,226037,590500
"2008","FLORIDA","PASCO",102417,2345,110104,214866
"2008","FLORIDA","PINELLAS",248299,4917,210066,463282
"2008","FLORIDA","POLK",113865,2090,128878,244833
"2008","FLORIDA","PUTNAM",13236,298,19637,33171
"2008","FLORIDA","SANTA ROSA",19470,743,55972,76185
"2008","FLORIDA","SARASOTA",102686,1770,102897,207353
"2008","FLORIDA","SEMINOLE",99335,1490,105070,205895
"2008","FLORIDA","ST. JOHNS",35791,831,69222,105844
"2008","FLORIDA","ST. LUCIE",67125,942,52512,120579
"2008","FLORIDA","SUMTER",17655,347,30866,48868
"2008","FLORIDA","SUWANNEE",4916,212,12534,17662
"2008","FLORIDA","TAYLOR",2803,106,6457,9366
"2008","FLORIDA","UNION",1299,53,3933,5285
"2008","FLORIDA","VOLUSIA",127795,2091,113938,243824
"2008","FLORIDA","WAKULLA",5311,188,8877,14376
"2008","FLORIDA","WALTON",7174,311,19561,27046
"2008","FLORIDA","WASHINGTON",2863,90,8178,11131
"2008","GEORGIA","APPLING",1846,65,5085,6996
"2008","GEORGIA","ATKINSON",938,25,1941,2904
"2008","GEORGIA","BACON",817,32,3089,3938
"2008","GEORGIA","BAKER",846,13,828,1687
"2008","GEORGIA","BALDWIN",8587,127,7823,16537
"2008","GEORGIA","BANKS",1027,94,5120,6241
"2008","GEORGIA","BARROW",6657,300,17625,24582
"2008","GEORGIA","BARTOW",9662,455,25976,36093
"2008","GEORGIA","BEN HILL",2590,29,3417,6036
"2008","GEORGIA","BERRIEN",1471,77,4901,6449
"2008","GEORGIA","BIBB",38987,344,27037,66368
"2008","GEORGIA","BLECKLEY",1380,34,3657,5071
"2008","GEORGIA","BRANTLEY",1119,78,5080,6277
"2008","GEORGIA","BROOKS",2669,25,3507,6201
"2008","GEORGIA","BRYAN",3636,97,9112,12845
"2008","GEORGIA","BULLOCH",9586,160,14174,23920
"2008","GEORGIA","BURKE",5233,49,4344,9626
"2008","GEORGIA","BUTTS",3065,79,5947,9091
"2008","GEORGIA","CALHOUN",1342,7,862,2211
"2008","GEORGIA","CAMDEN",6482,100,10502,17084
"2008","GEORGIA","CANDLER",1209,23,2286,3518
"2008","GEORGIA","CARROLL",14334,503,28661,43498
"2008","GEORGIA","CATOOSA",6025,253,18218,24496
"2008","GEORGIA","CHARLTON",1197,22,2466,3685
"2008","GEORGIA","CHATHAM",62755,654,46829,110238
"2008","GEORGIA","CHATTAHOOCHEE",830,12,811,1653
"2008","GEORGIA","CHATTOOGA",2596,139,5572,8307
"2008","GEORGIA","CHEROKEE",22350,1143,70279,93772
"2008","GEORGIA","CLARKE",29591,586,15333,45510
"2008","GEORGIA","CLAY",879,3,558,1440
"2008","GEORGIA","CLAYTON",82527,405,16506,99438
"2008","GEORGIA","CLINCH",989,29,1678,2696
"2008","GEORGIA","COBB",141216,3271,170957,315444
"2008","GEORGIA","COFFEE",4811,64,8872,13747
"2008","GEORGIA","COLQUITT",4139,111,9185,13435
"2008","GEORGIA","COLUMBIA",15703,326,39322,55351
"2008","GEORGIA","COOK",2075,46,3782,5903
"2008","GEORGIA","COWETA",15521,457,37571,53549
"2008","GEORGIA","CRAWFORD",1832,50,3358,5240
"2008","GEORGIA","CRISP",3085,41,4424,7550
"2008","GEORGIA","DADE",1612,93,4703,6408
"2008","GEORGIA","DAWSON",1632,100,8242,9974
"2008","GEORGIA","DECATUR",4424,60,5890,10374
"2008","GEORGIA","DEKALB",254594,2126,65581,322301
"2008","GEORGIA","DODGE",2595,74,5543,8212
"2008","GEORGIA","DOOLY",2138,31,1991,4160
"2008","GEORGIA","DOUGHERTY",26135,164,12547,38846
"2008","GEORGIA","DOUGLAS",27825,446,26812,55083
"2008","GEORGIA","EARLY",2603,21,2711,5335
"2008","GEORGIA","ECHOLS",201,5,981,1187
"2008","GEORGIA","EFFINGHAM",4936,150,15230,20316
"2008","GEORGIA","ELBERT",3366,83,4868,8317
"2008","GEORGIA","EMANUEL",3068,64,5110,8242
"2008","GEORGIA","EVANS",1374,19,2462,3855
"2008","GEORGIA","FANNIN",2611,166,7807,10584
"2008","GEORGIA","FAYETTE",20313,507,38501,59321
"2008","GEORGIA","FLOYD",10691,390,23132,34213
"2008","GEORGIA","FORSYTH",15406,804,59166,75376
"2008","GEORGIA","FRANKLIN",1914,90,6069,8073
"2008","GEORGIA","FULTON",272000,3492,130136,405628
"2008","GEORGIA","GILMER",2614,127,8408,11149
"2008","GEORGIA","GLASCOCK",210,16,1202,1428
"2008","GEORGIA","GLYNN",12676,186,20479,33341
"2008","GEORGIA","GORDON",4268,226,13113,17607
"2008","GEORGIA","GRADY",3539,51,5775,9365
"2008","GEORGIA","GREENE",3339,48,4532,7919
"2008","GEORGIA","GWINNETT",129025,2376,158746,290147
"2008","GEORGIA","HABERSHAM",2900,142,11766,14808
"2008","GEORGIA","HALL",14457,509,44962,59928
"2008","GEORGIA","HANCOCK",3535,14,795,4344
"2008","GEORGIA","HARALSON",2248,191,8658,11097
"2008","GEORGIA","HARRIS",4184,76,10648,14908
"2008","GEORGIA","HART",3365,100,6537,10002
"2008","GEORGIA","HEARD",1042,50,3133,4225
"2008","GEORGIA","HENRY",40527,587,47115,88229
"2008","GEORGIA","HOUSTON",22094,445,33392,55931
"2008","GEORGIA","IRWIN",1197,26,2605,3828
"2008","GEORGIA","JACKSON",4950,234,17776,22960
"2008","GEORGIA","JASPER",1935,53,3916,5904
"2008","GEORGIA","JEFF DAVIS",1356,55,3867,5278
"2008","GEORGIA","JEFFERSON",4149,24,3061,7234
"2008","GEORGIA","JENKINS",1482,22,1936,3440
"2008","GEORGIA","JOHNSON",1198,23,2426,3647
"2008","GEORGIA","JONES",4572,84,7782,12438
"2008","GEORGIA","LAMAR",2752,63,4873,7688
"2008","GEORGIA","LANIER",1062,24,1787,2873
"2008","GEORGIA","LAURENS",7769,116,12052,19937
"2008","GEORGIA","LEE",3100,62,9925,13087
"2008","GEORGIA","LIBERTY",10474,74,5828,16376
"2008","GEORGIA","LINCOLN",1650,35,2731,4416
"2008","GEORGIA","LONG",1288,43,2119,3450
"2008","GEORGIA","LOWNDES",17651,293,21296,39240
"2008","GEORGIA","LUMPKIN",2586,163,8326,11075
"2008","GEORGIA","MACON",3251,21,1712,4984
"2008","GEORGIA","MADISON",2965,174,8226,11365
"2008","GEORGIA","MARION",1381,35,1772,3188
"2008","GEORGIA","MCDUFFIE",3989,155,5400,9544
"2008","GEORGIA","MCINTOSH",2905,49,3282,6236
"2008","GEORGIA","MERIWETHER",4465,57,4982,9504
"2008","GEORGIA","MILLER",818,21,1899,2738
"2008","GEORGIA","MITCHELL",3872,47,4201,8120
"2008","GEORGIA","MONROE",4106,92,7933,12131
"2008","GEORGIA","MONTGOMERY",1045,24,2521,3590
"2008","GEORGIA","MORGAN",3091,73,5987,9151
"2008","GEORGIA","MURRAY",3026,176,8180,11382
"2008","GEORGIA","MUSCOGEE",44158,339,29568,74065
"2008","GEORGIA","NEWTON",20827,271,20337,41435
"2008","GEORGIA","OCONEE",4825,187,12120,17132
"2008","GEORGIA","OGLETHORPE",2232,71,4144,6447
"2008","GEORGIA","PAULDING",17229,564,39192,56985
"2008","GEORGIA","PEACH",5927,65,5173,11165
"2008","GEORGIA","PICKENS",2595,187,10004,12786
"2008","GEORGIA","PIERCE",1253,38,5500,6791
"2008","GEORGIA","PIKE",1575,81,6547,8203
"2008","GEORGIA","POLK",4052,211,9850,14113
"2008","GEORGIA","PULASKI",1377,23,2553,3953
"2008","GEORGIA","PUTNAM",3102,64,5966,9132
"2008","GEORGIA","QUITMAN",597,8,509,1114
"2008","GEORGIA","RABUN",2001,111,5487,7599
"2008","GEORGIA","RANDOLPH",1833,12,1370,3215
"2008","GEORGIA","RICHMOND",52100,391,26842,79333
"2008","GEORGIA","ROCKDALE",20526,259,16921,37706
"2008","GEORGIA","SCHLEY",479,7,1252,1738
"2008","GEORGIA","SCREVEN",3024,34,3423,6481
"2008","GEORGIA","SEMINOLE",1660,21,2315,3996
"2008","GEORGIA","SPALDING",10141,229,14885,25255
"2008","GEORGIA","STEPHENS",2705,123,7689,10517
"2008","GEORGIA","STEWART",1305,17,783,2105
"2008","GEORGIA","SUMTER",6454,64,5717,12235
"2008","GEORGIA","TALBOT",2369,30,1301,3700
"2008","GEORGIA","TALIAFERRO",643,8,339,990
"2008","GEORGIA","TATTNALL",1932,52,4730,6714
"2008","GEORGIA","TAYLOR",1536,26,2021,3583
"2008","GEORGIA","TELFAIR",1862,26,2486,4374
"2008","GEORGIA","TERRELL",2501,25,1890,4416
"2008","GEORGIA","THOMAS",7720,97,10642,18459
"2008","GEORGIA","TIFT",4749,77,9431,14257
"2008","GEORGIA","TOOMBS",2964,66,6658,9688
"2008","GEORGIA","TOWNS",1391,56,4292,5739
"2008","GEORGIA","TREUTLEN",1112,16,1826,2954
"2008","GEORGIA","TROUP",10455,182,15391,26028
"2008","GEORGIA","TURNER",1427,30,2096,3553
"2008","GEORGIA","TWIGGS",2402,30,2087,4519
"2008","GEORGIA","UNION",2486,135,8013,10634
"2008","GEORGIA","UPSON",4061,69,7291,11421
"2008","GEORGIA","WALKER",6095,337,17110,23542
"2008","GEORGIA","WALTON",8469,304,27253,36026
"2008","GEORGIA","WARE",4034,71,8311,12416
"2008","GEORGIA","WARREN",1554,19,1087,2660
"2008","GEORGIA","WASHINGTON",4607,40,4216,8863
"2008","GEORGIA","WAYNE",2858,101,7601,10560
"2008","GEORGIA","WEBSTER",515,8,588,1111
"2008","GEORGIA","WHEELER",794,8,1408,2210
"2008","GEORGIA","WHITE",2174,120,8467,10761
"2008","GEORGIA","WHITFIELD",8167,280,19230,27677
"2008","GEORGIA","WILCOX",978,26,2159,3163
"2008","GEORGIA","WILKES",2315,32,2705,5052
"2008","GEORGIA","WILKINSON",2298,26,2349,4673
"2008","GEORGIA","WORTH",2542,48,5780,8370
"2008","HAWAII","HAWAII",50819,1231,14866,66916
"2008","HAWAII","HONOLULU",214239,4410,88164,306813
"2008","HAWAII","KAUAI",20416,563,6245,27224
"2008","HAWAII","MAUI",39727,908,11154,51789
"2008","IDAHO","ADA",82236,3838,93328,179402
"2008","IDAHO","ADAMS",728,75,1517,2320
"2008","IDAHO","BANNOCK",14792,957,19356,35105
"2008","IDAHO","BEAR LAKE",502,64,2377,2943
"2008","IDAHO","BENEWAH",1407,111,2646,4164
"2008","IDAHO","BINGHAM",4424,501,12230,17155
"2008","IDAHO","BLAINE",6947,185,3439,10571
"2008","IDAHO","BOISE",1240,100,2433,3773
"2008","IDAHO","BONNER",7840,562,11145,19547
"2008","IDAHO","BONNEVILLE",11417,952,29334,41703
"2008","IDAHO","BOUNDARY",1484,171,3078,4733
"2008","IDAHO","BUTTE",318,36,1056,1410
"2008","IDAHO","CAMAS",187,9,422,618
"2008","IDAHO","CANYON",20147,1347,42752,64246
"2008","IDAHO","CARIBOU",553,93,2656,3302
"2008","IDAHO","CASSIA",1332,201,6309,7842
"2008","IDAHO","CLARK",64,6,305,375
"2008","IDAHO","CLEARWATER",1211,126,2569,3906
"2008","IDAHO","CUSTER",611,47,1694,2352
"2008","IDAHO","ELMORE",2591,180,5665,8436
"2008","IDAHO","FRANKLIN",600,227,4246,5073
"2008","IDAHO","FREMONT",1065,115,4700,5880
"2008","IDAHO","GEM",2166,196,5585,7947
"2008","IDAHO","GOODING",1489,137,3765,5391
"2008","IDAHO","IDAHO",2017,298,5895,8210
"2008","IDAHO","JEFFERSON",1641,260,8540,10441
"2008","IDAHO","JEROME",1794,156,4897,6847
"2008","IDAHO","KOOTENAI",22120,1425,38387,61932
"2008","IDAHO","LATAH",9195,531,7988,17714
"2008","IDAHO","LEMHI",1061,106,2938,4105
"2008","IDAHO","LEWIS",479,50,1275,1804
"2008","IDAHO","LINCOLN",545,93,1232,1870
"2008","IDAHO","MADISON",1627,299,11131,13057
"2008","IDAHO","MINIDOKA",1630,173,5087,6890
"2008","IDAHO","NEZ PERCE",7123,343,10357,17823
"2008","IDAHO","ONEIDA",381,57,1724,2162
"2008","IDAHO","OWYHEE",944,90,3024,4058
"2008","IDAHO","PAYETTE",2415,210,5988,8613
"2008","IDAHO","POWER",1027,61,1754,2842
"2008","IDAHO","SHOSHONE",2521,192,2953,5666
"2008","IDAHO","TETON",2302,93,2263,4658
"2008","IDAHO","TWIN FALLS",8621,691,19032,28344
"2008","IDAHO","VALLEY",2405,119,2772,5296
"2008","IDAHO","WASHINGTON",1241,97,3168,4506
"2008","ILLINOIS","ADAMS",11794,318,18711,30823
"2008","ILLINOIS","ALEXANDER",2189,56,1692,3937
"2008","ILLINOIS","BOND",3843,134,3947,7924
"2008","ILLINOIS","BOONE",11333,421,10403,22157
"2008","ILLINOIS","BROWN",986,39,1544,2569
"2008","ILLINOIS","BUREAU",8889,313,7911,17113
"2008","ILLINOIS","CALHOUN",1423,55,1221,2699
"2008","ILLINOIS","CARROLL",3965,113,3596,7674
"2008","ILLINOIS","CASS",2690,101,2617,5408
"2008","ILLINOIS","CHAMPAIGN",48597,1675,33871,84143
"2008","ILLINOIS","CHRISTIAN",6918,310,7872,15100
"2008","ILLINOIS","CLARK",3742,137,4409,8288
"2008","ILLINOIS","CLAY",2425,103,3926,6454
"2008","ILLINOIS","CLINTON",7657,300,9357,17314
"2008","ILLINOIS","COLES",11716,382,10978,23076
"2008","ILLINOIS","COOK",1629024,20706,487736,2137466
"2008","ILLINOIS","CRAWFORD",3883,176,5070,9129
"2008","ILLINOIS","CUMBERLAND",2055,110,3156,5321
"2008","ILLINOIS","DE WITT",3308,145,4348,7801
"2008","ILLINOIS","DEKALB",25784,768,18266,44818
"2008","ILLINOIS","DOUGLAS",3228,123,5005,8356
"2008","ILLINOIS","DUPAGE",228698,5649,183626,417973
"2008","ILLINOIS","EDGAR",3743,114,4398,8255
"2008","ILLINOIS","EDWARDS",1140,73,2137,3350
"2008","ILLINOIS","EFFINGHAM",5262,250,11323,16835
"2008","ILLINOIS","FAYETTE",3967,214,5499,9680
"2008","ILLINOIS","FORD",2227,80,4079,6386
"2008","ILLINOIS","FRANKLIN",8880,357,9404,18641
"2008","ILLINOIS","FULTON",9732,340,6251,16323
"2008","ILLINOIS","GALLATIN",1587,60,1212,2859
"2008","ILLINOIS","GREENE",2619,135,3053,5807
"2008","ILLINOIS","GRUNDY",11063,421,10687,22171
"2008","ILLINOIS","HAMILTON",1796,115,2353,4264
"2008","ILLINOIS","HANCOCK",4141,167,5161,9469
"2008","ILLINOIS","HARDIN",892,33,1330,2255
"2008","ILLINOIS","HENDERSON",2215,58,1541,3814
"2008","ILLINOIS","HENRY",13181,341,11263,24785
"2008","ILLINOIS","IROQUOIS",4643,258,8695,13596
"2008","ILLINOIS","JACKSON",15248,597,9687,25532
"2008","ILLINOIS","JASPER",2063,104,2964,5131
"2008","ILLINOIS","JEFFERSON",7462,377,9302,17141
"2008","ILLINOIS","JERSEY",5042,212,5329,10583
"2008","ILLINOIS","JO DAVIESS",6403,177,5170,11750
"2008","ILLINOIS","JOHNSON",1871,118,3912,5901
"2008","ILLINOIS","KANE",106756,2580,83963,193299
"2008","ILLINOIS","KANKAKEE",24750,739,22527,48016
"2008","ILLINOIS","KENDALL",24742,509,21380,46631
"2008","ILLINOIS","KNOX",14191,378,9419,23988
"2008","ILLINOIS","LAKE",177242,3318,118545,299105
"2008","ILLINOIS","LASALLE",27443,870,21872,50185
"2008","ILLINOIS","LAWRENCE",3016,117,3403,6536
"2008","ILLINOIS","LEE",7765,295,8258,16318
"2008","ILLINOIS","LIVINGSTON",6189,245,9191,15625
"2008","ILLINOIS","LOGAN",5250,217,7429,12896
"2008","ILLINOIS","MACON",25487,781,24948,51216
"2008","ILLINOIS","MACOUPIN",12090,392,9891,22373
"2008","ILLINOIS","MADISON",68979,2178,57177,128334
"2008","ILLINOIS","MARION",8345,328,8691,17364
"2008","ILLINOIS","MARSHALL",3081,107,3145,6333
"2008","ILLINOIS","MASON",3542,125,3141,6808
"2008","ILLINOIS","MASSAC",2693,122,4371,7186
"2008","ILLINOIS","MCDONOUGH",6783,204,6055,13042
"2008","ILLINOIS","MCHENRY",72288,2135,64845,139268
"2008","ILLINOIS","MCLEAN",37689,1294,36767,75750
"2008","ILLINOIS","MENARD",2706,86,3672,6464
"2008","ILLINOIS","MERCER",4887,128,3833,8848
"2008","ILLINOIS","MONROE",7953,249,9881,18083
"2008","ILLINOIS","MONTGOMERY",6491,230,6150,12871
"2008","ILLINOIS","MORGAN",7467,295,7591,15353
"2008","ILLINOIS","MOULTRIE",2668,121,3471,6260
"2008","ILLINOIS","OGLE",11253,453,13144,24850
"2008","ILLINOIS","PEORIA",45906,1219,34579,81704
"2008","ILLINOIS","PERRY",4701,208,5086,9995
"2008","ILLINOIS","PIATT",3859,149,4991,8999
"2008","ILLINOIS","PIKE",3024,135,4457,7616
"2008","ILLINOIS","POPE",845,43,1343,2231
"2008","ILLINOIS","PULASKI",1638,39,1593,3270
"2008","ILLINOIS","PUTNAM",1900,59,1378,3337
"2008","ILLINOIS","RANDOLPH",7395,269,7538,15202
"2008","ILLINOIS","RICHLAND",3181,140,4329,7650
"2008","ILLINOIS","ROCK ISLAND",42210,827,25364,68401
"2008","ILLINOIS","SALINE",5083,246,6099,11428
"2008","ILLINOIS","SANGAMON",51300,1583,46945,99828
"2008","ILLINOIS","SCHUYLER",1900,90,1833,3823
"2008","ILLINOIS","SCOTT",1090,55,1455,2600
"2008","ILLINOIS","SHELBY",4245,227,6396,10868
"2008","ILLINOIS","ST. CLAIR",76160,1626,47958,125744
"2008","ILLINOIS","STARK",1357,37,1513,2907
"2008","ILLINOIS","STEPHENSON",11349,347,9909,21605
"2008","ILLINOIS","TAZEWELL",29384,1223,33247,63854
"2008","ILLINOIS","UNION",3918,195,5003,9116
"2008","ILLINOIS","VERMILION",16246,572,16054,32872
"2008","ILLINOIS","WABASH",2462,66,3254,5782
"2008","ILLINOIS","WARREN",4286,106,3637,8029
"2008","ILLINOIS","WASHINGTON",3342,117,4473,7932
"2008","ILLINOIS","WAYNE",2547,134,5390,8071
"2008","ILLINOIS","WHITE",3315,151,3987,7453
"2008","ILLINOIS","WHITESIDE",15607,416,10883,26906
"2008","ILLINOIS","WILL",160406,3417,122597,286420
"2008","ILLINOIS","WILLIAMSON",12914,520,17387,30821
"2008","ILLINOIS","WINNEBAGO",70034,2111,53886,126031
"2008","ILLINOIS","WOODFORD",6999,293,12191,19483
"2008","INDIANA","ADAMS",4928,181,8404,13513
"2008","INDIANA","ALLEN",71263,1268,77793,150324
"2008","INDIANA","BARTHOLOMEW",13567,409,17067,31043
"2008","INDIANA","BENTON",1563,68,2183,3814
"2008","INDIANA","BLACKFORD",2677,74,2690,5441
"2008","INDIANA","BOONE",9752,273,16622,26647
"2008","INDIANA","BROWN",3854,141,4060,8055
"2008","INDIANA","CARROLL",3736,142,4858,8736
"2008","INDIANA","CASS",7011,296,8346,15653
"2008","INDIANA","CLARK",21953,446,25326,47725
"2008","INDIANA","CLAY",4954,174,6267,11395
"2008","INDIANA","CLINTON",5307,166,6919,12392
"2008","INDIANA","CRAWFORD",2286,65,2393,4744
"2008","INDIANA","DAVIESS",3370,118,7098,10586
"2008","INDIANA","DEARBORN",7123,208,14886,22217
"2008","INDIANA","DECATUR",3892,147,6449,10488
"2008","INDIANA","DEKALB",7175,194,9780,17149
"2008","INDIANA","DELAWARE",28384,563,20916,49863
"2008","INDIANA","DUBOIS",8748,291,9526,18565
"2008","INDIANA","ELKHART",31398,664,39396,71458
"2008","INDIANA","FAYETTE",4389,156,4917,9462
"2008","INDIANA","FLOYD",16263,317,19957,36537
"2008","INDIANA","FOUNTAIN",3094,158,4158,7410
"2008","INDIANA","FRANKLIN",3404,188,7018,10610
"2008","INDIANA","FULTON",3702,157,5147,9006
"2008","INDIANA","GIBSON",6455,191,8449,15095
"2008","INDIANA","GRANT",11293,272,14734,26299
"2008","INDIANA","GREENE",5709,229,7691,13629
"2008","INDIANA","HAMILTON",49704,959,78401,129064
"2008","INDIANA","HANCOCK",11874,371,22008,34253
"2008","INDIANA","HARRISON",7288,252,10551,18091
"2008","INDIANA","HENDRICKS",24548,679,39728,64955
"2008","INDIANA","HENRY",10059,364,10896,21319
"2008","INDIANA","HOWARD",17871,505,20248,38624
"2008","INDIANA","HUNTINGTON",5843,194,10291,16328
"2008","INDIANA","JACKSON",7354,294,9726,17374
"2008","INDIANA","JASPER",5044,162,7669,12875
"2008","INDIANA","JAY",3748,166,4401,8315
"2008","INDIANA","JEFFERSON",6255,182,7053,13490
"2008","INDIANA","JENNINGS",5312,266,6261,11839
"2008","INDIANA","JOHNSON",21553,604,36487,58644
"2008","INDIANA","KNOX",7569,216,8639,16424
"2008","INDIANA","KOSCIUSKO",9236,410,20488,30134
"2008","INDIANA","LAGRANGE",3663,126,5702,9491
"2008","INDIANA","LAKE",139301,1714,67742,208757
"2008","INDIANA","LAPORTE",28258,743,17918,46919
"2008","INDIANA","LAWRENCE",7208,308,11018,18534
"2008","INDIANA","MADISON",30152,785,26403,57340
"2008","INDIANA","MARION",241987,3062,134313,379362
"2008","INDIANA","MARSHALL",7889,255,10406,18550
"2008","INDIANA","MARTIN",1706,75,3122,4903
"2008","INDIANA","MIAMI",5564,237,8312,14113
"2008","INDIANA","MONROE",41450,647,21118,63215
"2008","INDIANA","MONTGOMERY",6013,212,9060,15285
"2008","INDIANA","MORGAN",10330,352,18129,28811
"2008","INDIANA","NEWTON",2625,119,3301,6045
"2008","INDIANA","NOBLE",7064,237,9673,16974
"2008","INDIANA","OHIO",1158,47,1713,2918
"2008","INDIANA","ORANGE",3390,160,4536,8086
"2008","INDIANA","OWEN",3570,185,4415,8170
"2008","INDIANA","PARKE",2924,131,3909,6964
"2008","INDIANA","PERRY",5141,147,3202,8490
"2008","INDIANA","PIKE",2700,107,3221,6028
"2008","INDIANA","PORTER",39178,881,33857,73916
"2008","INDIANA","POSEY",5828,139,6804,12771
"2008","INDIANA","PULASKI",2466,110,3388,5964
"2008","INDIANA","PUTNAM",6334,226,8086,14646
"2008","INDIANA","RANDOLPH",4839,181,5788,10808
"2008","INDIANA","RIPLEY",4187,207,7794,12188
"2008","INDIANA","RUSH",3229,129,4271,7629
"2008","INDIANA","SCOTT",4271,161,4445,8877
"2008","INDIANA","SHELBY",6987,254,10333,17574
"2008","INDIANA","SPENCER",5039,141,5001,10181
"2008","INDIANA","ST. JOSEPH",68710,1169,48510,118389
"2008","INDIANA","STARKE",4778,215,4473,9466
"2008","INDIANA","STEUBEN",6284,188,7674,14146
"2008","INDIANA","SULLIVAN",4284,155,4343,8782
"2008","INDIANA","SWITZERLAND",1638,62,1940,3640
"2008","INDIANA","TIPPECANOE",37781,833,29822,68436
"2008","INDIANA","TIPTON",3250,125,4452,7827
"2008","INDIANA","UNION",1224,63,2061,3348
"2008","INDIANA","VANDERBURGH",39423,721,37512,77656
"2008","INDIANA","VERMILLION",4003,122,3010,7135
"2008","INDIANA","VIGO",25040,545,18121,43706
"2008","INDIANA","WABASH",5456,177,8238,13871
"2008","INDIANA","WARREN",1755,77,2166,3998
"2008","INDIANA","WARRICK",12329,323,16013,28665
"2008","INDIANA","WASHINGTON",4562,224,6519,11305
"2008","INDIANA","WAYNE",13459,545,14558,28562
"2008","INDIANA","WELLS",4403,166,8504,13073
"2008","INDIANA","WHITE",4839,197,5731,10767
"2008","INDIANA","WHITLEY",5862,202,9124,15188
"2008","IOWA","ADAIR",1924,69,2060,4053
"2008","IOWA","ADAMS",1118,42,1046,2206
"2008","IOWA","ALLAMAKEE",3971,123,2965,7059
"2008","IOWA","APPANOOSE",2970,120,3086,6176
"2008","IOWA","AUDUBON",1739,62,1634,3435
"2008","IOWA","BENTON",7058,207,6447,13712
"2008","IOWA","BLACK HAWK",39184,929,24662,64775
"2008","IOWA","BOONE",7356,280,6293,13929
"2008","IOWA","BREMER",6940,190,5741,12871
"2008","IOWA","BUCHANAN",6050,149,4139,10338
"2008","IOWA","BUENA VISTA",4075,120,4223,8418
"2008","IOWA","BUTLER",3364,102,3700,7166
"2008","IOWA","CALHOUN",2341,113,2741,5195
"2008","IOWA","CARROLL",5302,163,4922,10387
"2008","IOWA","CASS",3211,133,4006,7350
"2008","IOWA","CEDAR",5221,155,4289,9665
"2008","IOWA","CERRO GORDO",14405,360,9375,24140
"2008","IOWA","CHEROKEE",2890,103,3372,6365
"2008","IOWA","CHICKASAW",3923,103,2557,6583
"2008","IOWA","CLARKE",2218,107,2118,4443
"2008","IOWA","CLAY",3925,118,4355,8398
"2008","IOWA","CLAYTON",5195,143,3651,8989
"2008","IOWA","CLINTON",15018,377,9324,24719
"2008","IOWA","CRAWFORD",3715,131,3345,7191
"2008","IOWA","DALLAS",15149,537,16954,32640
"2008","IOWA","DAVIS",1680,106,2029,3815
"2008","IOWA","DECATUR",1986,96,2020,4102
"2008","IOWA","DELAWARE",4649,139,4113,8901
"2008","IOWA","DES MOINES",12462,387,7721,20570
"2008","IOWA","DICKINSON",4625,119,5162,9906
"2008","IOWA","DUBUQUE",28611,691,18651,47953
"2008","IOWA","EMMET",2570,72,2373,5015
"2008","IOWA","FAYETTE",5908,146,4205,10259
"2008","IOWA","FLOYD",4822,218,3051,8091
"2008","IOWA","FRANKLIN",2575,72,2501,5148
"2008","IOWA","FREMONT",1848,57,1989,3894
"2008","IOWA","GREENE",2371,84,2349,4804
"2008","IOWA","GRUNDY",2790,93,3945,6828
"2008","IOWA","GUTHRIE",2625,148,3074,5847
"2008","IOWA","HAMILTON",4018,147,3913,8078
"2008","IOWA","HANCOCK",2805,109,3016,5930
"2008","IOWA","HARDIN",4393,151,4315,8859
"2008","IOWA","HARRISON",3555,114,3909,7578
"2008","IOWA","HENRY",4349,206,4822,9377
"2008","IOWA","HOWARD",2941,65,1722,4728
"2008","IOWA","HUMBOLDT",2160,67,2895,5122
"2008","IOWA","IDA",1454,57,2036,3547
"2008","IOWA","IOWA",4202,156,4188,8546
"2008","IOWA","JACKSON",6102,180,3673,9955
"2008","IOWA","JASPER",10250,377,8794,19421
"2008","IOWA","JEFFERSON",5070,237,3324,8631
"2008","IOWA","JOHNSON",51027,1216,20732,72975
"2008","IOWA","JONES",5446,153,4405,10004
"2008","IOWA","KEOKUK",2518,131,2712,5361
"2008","IOWA","KOSSUTH",4625,143,4329,9097
"2008","IOWA","LEE",9821,341,7062,17224
"2008","IOWA","LINN",68037,1692,43626,113355
"2008","IOWA","LOUISA",2523,83,2314,4920
"2008","IOWA","LUCAS",2029,112,2330,4471
"2008","IOWA","LYON",1675,71,4471,6217
"2008","IOWA","MADISON",3733,168,4579,8480
"2008","IOWA","MAHASKA",4464,197,6271,10932
"2008","IOWA","MARION",7421,353,9256,17030
"2008","IOWA","MARSHALL",10023,356,8278,18657
"2008","IOWA","MILLS",2976,123,4183,7282
"2008","IOWA","MITCHELL",3179,118,2469,5766
"2008","IOWA","MONONA",2295,90,2411,4796
"2008","IOWA","MONROE",1798,75,2000,3873
"2008","IOWA","MONTGOMERY",2326,74,2887,5287
"2008","IOWA","MUSCATINE",10920,270,7929,19119
"2008","IOWA","O'BRIEN",2338,101,4894,7333
"2008","IOWA","OSCEOLA",1037,63,2027,3127
"2008","IOWA","PAGE",2900,105,4351,7356
"2008","IOWA","PALO ALTO",2428,84,2294,4806
"2008","IOWA","PLYMOUTH",4629,118,7765,12512
"2008","IOWA","POCAHONTAS",1800,73,2138,4011
"2008","IOWA","POLK",120984,3734,89668,214386
"2008","IOWA","POTTAWATTAMIE",20436,647,21237,42320
"2008","IOWA","POWESHIEK",5519,172,4340,10031
"2008","IOWA","RINGGOLD",1236,52,1401,2689
"2008","IOWA","SAC",2256,92,2705,5053
"2008","IOWA","SCOTT",48927,1079,36365,86371
"2008","IOWA","SHELBY",2863,102,3488,6453
"2008","IOWA","SIOUX",3030,144,13490,16664
"2008","IOWA","STORY",26548,1032,18995,46575
"2008","IOWA","TAMA",4899,131,3820,8850
"2008","IOWA","TAYLOR",1347,72,1607,3026
"2008","IOWA","UNION",3000,128,2781,5909
"2008","IOWA","VAN BUREN",1546,76,1986,3608
"2008","IOWA","WAPELLO",8820,448,6663,15931
"2008","IOWA","WARREN",12299,437,12144,24880
"2008","IOWA","WASHINGTON",5170,209,5247,10626
"2008","IOWA","WAYNE",1357,58,1565,2980
"2008","IOWA","WEBSTER",9917,300,8337,18554
"2008","IOWA","WINNEBAGO",3254,98,2730,6082
"2008","IOWA","WINNESHIEK",6829,178,4273,11280
"2008","IOWA","WOODBURY",21983,599,22219,44801
"2008","IOWA","WORTH",2567,78,1612,4257
"2008","IOWA","WRIGHT",3102,95,3198,6395
"2008","KANSAS","ALLEN",2189,114,3552,5855
"2008","KANSAS","ANDERSON",1175,89,2362,3626
"2008","KANSAS","ATCHISON",3241,159,3791,7191
"2008","KANSAS","BARBER",598,31,1833,2462
"2008","KANSAS","BARTON",3027,228,7802,11057
"2008","KANSAS","BOURBON",2394,147,4240,6781
"2008","KANSAS","BROWN",1317,74,2985,4376
"2008","KANSAS","BUTLER",9159,559,18155,27873
"2008","KANSAS","CHASE",383,25,976,1384
"2008","KANSAS","CHAUTAUQUA",401,33,1418,1852
"2008","KANSAS","CHEROKEE",3594,185,5886,9665
"2008","KANSAS","CHEYENNE",323,27,1148,1498
"2008","KANSAS","CLARK",245,17,897,1159
"2008","KANSAS","CLAY",1009,47,2998,4054
"2008","KANSAS","CLOUD",1233,97,3121,4451
"2008","KANSAS","COFFEY",1121,57,3054,4232
"2008","KANSAS","COMANCHE",194,15,765,974
"2008","KANSAS","COWLEY",5012,283,8492,13787
"2008","KANSAS","CRAWFORD",7957,383,7735,16075
"2008","KANSAS","DECATUR",343,16,1189,1548
"2008","KANSAS","DICKINSON",2422,164,6081,8667
"2008","KANSAS","DONIPHAN",1115,77,2372,3564
"2008","KANSAS","DOUGLAS",34398,1071,17929,53398
"2008","KANSAS","EDWARDS",333,29,995,1357
"2008","KANSAS","ELK",363,29,1042,1434
"2008","KANSAS","ELLIS",4010,230,8207,12447
"2008","KANSAS","ELLSWORTH",851,66,2021,2938
"2008","KANSAS","FINNEY",3275,153,6926,10354
"2008","KANSAS","FORD",2991,143,5730,8864
"2008","KANSAS","FRANKLIN",4433,227,7079,11739
"2008","KANSAS","GEARY",3491,111,4492,8094
"2008","KANSAS","GOVE",261,21,1136,1418
"2008","KANSAS","GRAHAM",325,38,1060,1423
"2008","KANSAS","GRANT",635,31,1995,2661
"2008","KANSAS","GRAY",436,40,1643,2119
"2008","KANSAS","GREELEY",151,3,591,745
"2008","KANSAS","GREENWOOD",622,38,1619,2279
"2008","KANSAS","HAMILTON",233,19,844,1096
"2008","KANSAS","HARPER",736,61,1999,2796
"2008","KANSAS","HARVEY",6318,289,9006,15613
"2008","KANSAS","HASKELL",278,15,1277,1570
"2008","KANSAS","HODGEMAN",211,20,865,1096
"2008","KANSAS","JACKSON",2308,134,3811,6253
"2008","KANSAS","JEFFERSON",3542,188,5220,8950
"2008","KANSAS","JEWELL",313,40,1231,1584
"2008","KANSAS","JOHNSON",127091,3714,152627,283432
"2008","KANSAS","KEARNY",309,14,1159,1482
"2008","KANSAS","KINGMAN",963,98,2603,3664
"2008","KANSAS","KIOWA",200,23,912,1135
"2008","KANSAS","LABETTE",3839,191,5001,9031
"2008","KANSAS","LANE",193,20,814,1027
"2008","KANSAS","LEAVENWORTH",13255,545,16791,30591
"2008","KANSAS","LINCOLN",347,35,1204,1586
"2008","KANSAS","LINN",1425,106,3086,4617
"2008","KANSAS","LOGAN",225,28,1187,1440
"2008","KANSAS","LYON",5924,289,6698,12911
"2008","KANSAS","MARION",1801,99,4159,6059
"2008","KANSAS","MARSHALL",1784,95,3157,5036
"2008","KANSAS","MCPHERSON",4218,231,8937,13386
"2008","KANSAS","MEADE",357,34,1540,1931
"2008","KANSAS","MIAMI",5742,253,9382,15377
"2008","KANSAS","MITCHELL",701,62,2440,3203
"2008","KANSAS","MONTGOMERY",4338,260,9309,13907
"2008","KANSAS","MORRIS",907,59,1875,2841
"2008","KANSAS","MORTON",229,20,1153,1402
"2008","KANSAS","NEMAHA",1432,110,3817,5359
"2008","KANSAS","NEOSHO",2563,156,4473,7192
"2008","KANSAS","NESS",289,29,1207,1525
"2008","KANSAS","NORTON",497,40,1878,2415
"2008","KANSAS","OSAGE",2534,190,4820,7544
"2008","KANSAS","OSBORNE",403,37,1490,1930
"2008","KANSAS","OTTAWA",704,59,2323,3086
"2008","KANSAS","PAWNEE",882,51,1946,2879
"2008","KANSAS","PHILLIPS",525,37,2105,2667
"2008","KANSAS","POTTAWATOMIE",2599,309,6929,9837
"2008","KANSAS","PRATT",1294,74,2822,4190
"2008","KANSAS","RAWLINS",273,29,1247,1549
"2008","KANSAS","RENO",9916,484,16112,26512
"2008","KANSAS","REPUBLIC",640,53,1978,2671
"2008","KANSAS","RICE",1163,78,2780,4021
"2008","KANSAS","RILEY",10495,391,12111,22997
"2008","KANSAS","ROOKS",468,52,2068,2588
"2008","KANSAS","RUSH",504,52,1225,1781
"2008","KANSAS","RUSSELL",736,48,2509,3293
"2008","KANSAS","SALINE",8186,437,14165,22788
"2008","KANSAS","SCOTT",321,35,1823,2179
"2008","KANSAS","SEDGWICK",82337,3547,106849,192733
"2008","KANSAS","SEWARD",1493,52,3791,5336
"2008","KANSAS","SHAWNEE",41235,1466,41476,84177
"2008","KANSAS","SHERIDAN",254,14,1108,1376
"2008","KANSAS","SHERMAN",688,57,1959,2704
"2008","KANSAS","SMITH",446,39,1719,2204
"2008","KANSAS","STAFFORD",542,37,1495,2074
"2008","KANSAS","STANTON",188,11,628,827
"2008","KANSAS","STEVENS",283,29,1815,2127
"2008","KANSAS","SUMNER",3353,247,6737,10337
"2008","KANSAS","THOMAS",787,49,2837,3673
"2008","KANSAS","TREGO",420,26,1225,1671
"2008","KANSAS","WABAUNSEE",1036,90,2395,3521
"2008","KANSAS","WALLACE",96,18,690,804
"2008","KANSAS","WASHINGTON",659,73,2248,2980
"2008","KANSAS","WICHITA",163,16,840,1019
"2008","KANSAS","WILSON",1170,101,2850,4121
"2008","KANSAS","WOODSON",512,32,1055,1599
"2008","KANSAS","WYANDOTTE",39865,798,16506,57169
"2008","KENTUCKY","ADAIR",1668,118,5512,7298
"2008","KENTUCKY","ALLEN",2024,108,5258,7390
"2008","KENTUCKY","ANDERSON",3462,205,6885,10552
"2008","KENTUCKY","BALLARD",1427,96,2537,4060
"2008","KENTUCKY","BARREN",5434,240,11133,16807
"2008","KENTUCKY","BATH",2210,99,2234,4543
"2008","KENTUCKY","BELL",2782,135,6681,9598
"2008","KENTUCKY","BOONE",16292,670,33812,50774
"2008","KENTUCKY","BOURBON",3385,125,4820,8330
"2008","KENTUCKY","BOYD",8886,354,11430,20670
"2008","KENTUCKY","BOYLE",4769,165,7701,12635
"2008","KENTUCKY","BRACKEN",1241,92,2066,3399
"2008","KENTUCKY","BREATHITT",2205,154,2671,5030
"2008","KENTUCKY","BRECKINRIDGE",3110,131,5281,8522
"2008","KENTUCKY","BULLITT",10177,447,20102,30726
"2008","KENTUCKY","BUTLER",1555,56,3696,5307
"2008","KENTUCKY","CALDWELL",2212,121,3866,6199
"2008","KENTUCKY","CALLOWAY",6165,248,8991,15404
"2008","KENTUCKY","CAMPBELL",15622,629,24046,40297
"2008","KENTUCKY","CARLISLE",879,39,1699,2617
"2008","KENTUCKY","CARROLL",1716,87,2032,3835
"2008","KENTUCKY","CARTER",4316,245,5252,9813
"2008","KENTUCKY","CASEY",1219,59,4679,5957
"2008","KENTUCKY","CHRISTIAN",8880,199,13699,22778
"2008","KENTUCKY","CLARK",5749,215,9664,15628
"2008","KENTUCKY","CLAY",1552,102,5710,7364
"2008","KENTUCKY","CLINTON",761,45,3366,4172
"2008","KENTUCKY","CRITTENDEN",1254,72,2604,3930
"2008","KENTUCKY","CUMBERLAND",697,44,2056,2797
"2008","KENTUCKY","DAVIESS",19282,648,23692,43622
"2008","KENTUCKY","EDMONSON",1652,56,3562,5270
"2008","KENTUCKY","ELLIOTT",1535,78,902,2515
"2008","KENTUCKY","ESTILL",1555,74,3685,5314
"2008","KENTUCKY","FAYETTE",66042,1713,59884,127639
"2008","KENTUCKY","FLEMING",2279,121,3432,5832
"2008","KENTUCKY","FLOYD",7530,388,7741,15659
"2008","KENTUCKY","FRANKLIN",11767,401,11911,24079
"2008","KENTUCKY","FULTON",1238,57,1530,2825
"2008","KENTUCKY","GALLATIN",1278,75,1840,3193
"2008","KENTUCKY","GARRARD",2012,80,5118,7210
"2008","KENTUCKY","GRANT",3112,132,5510,8754
"2008","KENTUCKY","GRAVES",5843,256,10056,16155
"2008","KENTUCKY","GRAYSON",3154,144,6605,9903
"2008","KENTUCKY","GREEN",1204,90,3785,5079
"2008","KENTUCKY","GREENUP",6621,328,8849,15798
"2008","KENTUCKY","HANCOCK",2135,81,1928,4144
"2008","KENTUCKY","HARDIN",15650,444,23896,39990
"2008","KENTUCKY","HARLAN",2586,163,7165,9914
"2008","KENTUCKY","HARRISON",2916,154,4520,7590
"2008","KENTUCKY","HART",2290,131,4397,6818
"2008","KENTUCKY","HENDERSON",10049,289,9523,19861
"2008","KENTUCKY","HENRY",2725,113,4081,6919
"2008","KENTUCKY","HICKMAN",812,32,1406,2250
"2008","KENTUCKY","HOPKINS",7104,328,11916,19348
"2008","KENTUCKY","JACKSON",743,74,4407,5224
"2008","KENTUCKY","JEFFERSON",196435,3500,153957,353892
"2008","KENTUCKY","JESSAMINE",6236,267,13711,20214
"2008","KENTUCKY","JOHNSON",2407,162,5948,8517
"2008","KENTUCKY","KENTON",26480,1019,40714,68213
"2008","KENTUCKY","KNOTT",2612,138,3070,5820
"2008","KENTUCKY","KNOX",3074,165,8150,11389
"2008","KENTUCKY","LARUE",1913,112,4153,6178
"2008","KENTUCKY","LAUREL",4618,222,17660,22500
"2008","KENTUCKY","LAWRENCE",2036,110,3503,5649
"2008","KENTUCKY","LEE",752,43,1978,2773
"2008","KENTUCKY","LESLIE",766,57,3574,4397
"2008","KENTUCKY","LETCHER",2623,245,5367,8235
"2008","KENTUCKY","LEWIS",1510,68,3213,4791
"2008","KENTUCKY","LINCOLN",2752,126,6273,9151
"2008","KENTUCKY","LIVINGSTON",1622,81,2890,4593
"2008","KENTUCKY","LOGAN",3811,154,6925,10890
"2008","KENTUCKY","LYON",1577,58,2220,3855
"2008","KENTUCKY","MADISON",12392,451,19694,32537
"2008","KENTUCKY","MAGOFFIN",2105,112,2434,4651
"2008","KENTUCKY","MARION",3596,177,3842,7615
"2008","KENTUCKY","MARSHALL",5683,292,9512,15487
"2008","KENTUCKY","MARTIN",808,60,2824,3692
"2008","KENTUCKY","MASON",2891,128,4102,7121
"2008","KENTUCKY","MCCRACKEN",11285,426,19043,30754
"2008","KENTUCKY","MCCREARY",1258,71,4078,5407
"2008","KENTUCKY","MCLEAN",1963,73,2386,4422
"2008","KENTUCKY","MEADE",4343,172,6691,11206
"2008","KENTUCKY","MENIFEE",1276,58,1155,2489
"2008","KENTUCKY","MERCER",3159,120,6781,10060
"2008","KENTUCKY","METCALFE",1350,115,2734,4199
"2008","KENTUCKY","MONROE",1067,61,3537,4665
"2008","KENTUCKY","MONTGOMERY",4234,150,5947,10331
"2008","KENTUCKY","MORGAN",1879,104,2396,4379
"2008","KENTUCKY","MUHLENBERG",6221,221,6447,12889
"2008","KENTUCKY","NELSON",7654,353,10139,18146
"2008","KENTUCKY","NICHOLAS",1272,64,1634,2970
"2008","KENTUCKY","OHIO",4059,192,5687,9938
"2008","KENTUCKY","OLDHAM",10000,319,18997,29316
"2008","KENTUCKY","OWEN",1694,88,2969,4751
"2008","KENTUCKY","OWSLEY",381,26,1279,1686
"2008","KENTUCKY","PENDLETON",2027,99,3676,5802
"2008","KENTUCKY","PERRY",3444,169,6762,10375
"2008","KENTUCKY","PIKE",9525,463,12655,22643
"2008","KENTUCKY","POWELL",2065,70,2837,4972
"2008","KENTUCKY","PULASKI",5590,314,19862,25766
"2008","KENTUCKY","ROBERTSON",451,31,533,1015
"2008","KENTUCKY","ROCKCASTLE",1410,107,4757,6274
"2008","KENTUCKY","ROWAN",4074,173,3907,8154
"2008","KENTUCKY","RUSSELL",1569,127,5779,7475
"2008","KENTUCKY","SCOTT",7712,236,11782,19730
"2008","KENTUCKY","SHELBY",6871,218,11451,18540
"2008","KENTUCKY","SIMPSON",2775,97,4437,7309
"2008","KENTUCKY","SPENCER",2519,152,5378,8049
"2008","KENTUCKY","TAYLOR",3165,127,7568,10860
"2008","KENTUCKY","TODD",1543,62,3336,4941
"2008","KENTUCKY","TRIGG",2246,92,4189,6527
"2008","KENTUCKY","TRIMBLE",1484,89,2239,3812
"2008","KENTUCKY","UNION",2804,110,3120,6034
"2008","KENTUCKY","WARREN",17669,483,25993,44145
"2008","KENTUCKY","WASHINGTON",1890,80,3305,5275
"2008","KENTUCKY","WAYNE",2201,127,4868,7196
"2008","KENTUCKY","WEBSTER",2390,113,3037,5540
"2008","KENTUCKY","WHITLEY",3484,205,10015,13704
"2008","KENTUCKY","WOLFE",1493,67,1408,2968
"2008","KENTUCKY","WOODFORD",5027,140,7130,12297
"2008","LOUISIANA","ACADIA",7028,454,19228,26710
"2008","LOUISIANA","ALLEN",2891,243,6333,9467
"2008","LOUISIANA","ASCENSION",14625,707,31239,46571
"2008","LOUISIANA","ASSUMPTION",4756,223,5981,10960
"2008","LOUISIANA","AVOYELLES",6327,375,10236,16938
"2008","LOUISIANA","BEAUREGARD",3071,285,10718,14074
"2008","LOUISIANA","BIENVILLE",3589,65,3776,7430
"2008","LOUISIANA","BOSSIER",12701,419,32706,45826
"2008","LOUISIANA","CADDO",55220,895,52105,108220
"2008","LOUISIANA","CALCASIEU",30244,1438,50449,82131
"2008","LOUISIANA","CALDWELL",1118,79,3696,4893
"2008","LOUISIANA","CAMERON",613,95,3089,3797
"2008","LOUISIANA","CATAHOULA",1659,80,3486,5225
"2008","LOUISIANA","CLAIBORNE",3025,66,3750,6841
"2008","LOUISIANA","CONCORDIA",3766,93,5668,9527
"2008","LOUISIANA","DE SOTO",5242,132,6883,12257
"2008","LOUISIANA","EAST BATON ROUGE",99652,2307,95390,197349
"2008","LOUISIANA","EAST CARROLL",2267,38,1254,3559
"2008","LOUISIANA","EAST FELICIANA",4383,132,5432,9947
"2008","LOUISIANA","EVANGELINE",5853,330,9793,15976
"2008","LOUISIANA","FRANKLIN",2959,119,6278,9356
"2008","LOUISIANA","GRANT",1474,177,6906,8557
"2008","LOUISIANA","IBERIA",12492,549,20127,33168
"2008","LOUISIANA","IBERVILLE",9023,213,7185,16421
"2008","LOUISIANA","JACKSON",2456,90,5190,7736
"2008","LOUISIANA","JEFFERSON",65096,2833,113191,181120
"2008","LOUISIANA","JEFFERSON DAVIS",3923,300,9278,13501
"2008","LOUISIANA","LA SALLE",860,91,5602,6553
"2008","LOUISIANA","LAFAYETTE",32145,1442,62055,95642
"2008","LOUISIANA","LAFOURCHE",9662,1142,27089,37893
"2008","LOUISIANA","LINCOLN",8267,207,10676,19150
"2008","LOUISIANA","LIVINGSTON",6681,942,43269,50892
"2008","LOUISIANA","MADISON",3100,48,2152,5300
"2008","LOUISIANA","MOREHOUSE",5792,150,7258,13200
"2008","LOUISIANA","NATCHITOCHES",7801,212,9054,17067
"2008","LOUISIANA","ORLEANS",116042,2204,28041,146287
"2008","LOUISIANA","OUACHITA",24813,690,41741,67244
"2008","LOUISIANA","PLAQUEMINES",3380,175,6894,10449
"2008","LOUISIANA","POINTE COUPEE",5516,217,6702,12435
"2008","LOUISIANA","RAPIDES",20127,783,36611,57521
"2008","LOUISIANA","RED RIVER",2080,65,2484,4629
"2008","LOUISIANA","RICHLAND",3311,119,5751,9181
"2008","LOUISIANA","SABINE",2245,181,7226,9652
"2008","LOUISIANA","ST. BERNARD",3491,407,9642,13540
"2008","LOUISIANA","ST. CHARLES",8522,418,16457,25397
"2008","LOUISIANA","ST. HELENA",3567,95,2522,6184
"2008","LOUISIANA","ST. JAMES",6994,138,5432,12564
"2008","LOUISIANA","ST. JOHN THE BAPTIST",12424,320,8912,21656
"2008","LOUISIANA","ST. LANDRY",20268,575,21650,42493
"2008","LOUISIANA","ST. MARTIN",9419,390,14443,24252
"2008","LOUISIANA","ST. MARY",9345,375,13183,22903
"2008","LOUISIANA","ST. TAMMANY",24589,1867,83047,109503
"2008","LOUISIANA","TANGIPAHOA",16438,730,31434,48602
"2008","LOUISIANA","TENSAS",1646,27,1367,3040
"2008","LOUISIANA","TERREBONNE",11579,905,28208,40692
"2008","LOUISIANA","UNION",3103,146,7619,10868
"2008","LOUISIANA","VERMILION",6266,498,18069,24833
"2008","LOUISIANA","VERNON",3534,289,11946,15769
"2008","LOUISIANA","WASHINGTON",6122,287,12215,18624
"2008","LOUISIANA","WEBSTER",6610,243,11417,18270
"2008","LOUISIANA","WEST BATON ROUGE",5043,169,6654,11866
"2008","LOUISIANA","WEST CARROLL",878,64,4045,4987
"2008","LOUISIANA","WEST FELICIANA",2414,55,3149,5618
"2008","LOUISIANA","WINN",2047,93,4632,6772
"2008","MAINE","ANDROSCOGGIN",31017,1162,22671,54850
"2008","MAINE","AROOSTOOK",19345,751,15898,35994
"2008","MAINE","CUMBERLAND",105218,2747,56186,164151
"2008","MAINE","FRANKLIN",10113,438,6627,17178
"2008","MAINE","HANCOCK",18895,584,12686,32165
"2008","MAINE","KENNEBEC",37238,1266,27482,65986
"2008","MAINE","KNOX",13728,436,8816,22980
"2008","MAINE","LINCOLN",11886,411,9287,21584
"2008","MAINE","MAINE UOCAVA",0,0,0,0
"2008","MAINE","OXFORD",17940,847,12863,31650
"2008","MAINE","PENOBSCOT",41614,1358,37495,80467
"2008","MAINE","PISCATAQUIS",4430,219,4785,9434
"2008","MAINE","SAGADAHOC",12152,428,8721,21301
"2008","MAINE","SOMERSET",13335,556,11867,25758
"2008","MAINE","WALDO",11967,460,9423,21850
"2008","MAINE","WASHINGTON",8246,331,8077,16654
"2008","MAINE","YORK",64799,1973,42389,109161
"2008","MARYLAND","ALLEGANY",10693,644,18405,29742
"2008","MARYLAND","ANNE ARUNDEL",125015,4922,129682,259619
"2008","MARYLAND","BALTIMORE",214151,8073,158714,380938
"2008","MARYLAND","BALTIMORE CITY",214385,2902,28681,245968
"2008","MARYLAND","CALVERT",20299,663,23095,44057
"2008","MARYLAND","CAROLINE",4971,232,8015,13218
"2008","MARYLAND","CARROLL",28060,2197,54503,84760
"2008","MARYLAND","CECIL",17665,974,23855,42494
"2008","MARYLAND","CHARLES",43635,760,25732,70127
"2008","MARYLAND","DORCHESTER",6912,194,8168,15274
"2008","MARYLAND","FREDERICK",54013,2003,55170,111186
"2008","MARYLAND","GARRETT",3736,233,8903,12872
"2008","MARYLAND","HARFORD",48552,2992,71751,123295
"2008","MARYLAND","HOWARD",87120,2720,55393,145233
"2008","MARYLAND","KENT",4953,162,4905,10020
"2008","MARYLAND","MONTGOMERY",314444,6209,118608,439261
"2008","MARYLAND","PRINCE GEORGE'S",332396,2797,38833,374026
"2008","MARYLAND","QUEEN ANNE'S",8575,383,15087,24045
"2008","MARYLAND","SOMERSET",4779,108,5037,9924
"2008","MARYLAND","ST. MARY'S",19023,681,24705,44409
"2008","MARYLAND","TALBOT",9035,298,10995,20328
"2008","MARYLAND","WASHINGTON",26245,1186,34169,61600
"2008","MARYLAND","WICOMICO",19436,569,21849,41854
"2008","MARYLAND","WORCESTER",11374,365,15607,27346
"2008","MASSACHUSETTS","BARNSTABLE",74264,2312,55694,132270
"2008","MASSACHUSETTS","BERKSHIRE",49558,1696,14876,66130
"2008","MASSACHUSETTS","BRISTOL",146861,5662,90597,243120
"2008","MASSACHUSETTS","DUKES",7913,198,2442,10553
"2008","MASSACHUSETTS","ESSEX",208976,7500,137189,353665
"2008","MASSACHUSETTS","FRANKLIN",27919,1085,9545,38549
"2008","MASSACHUSETTS","HAMPDEN",121454,5037,71350,197841
"2008","MASSACHUSETTS","HAMPSHIRE",56869,2083,20618,79570
"2008","MASSACHUSETTS","MIDDLESEX",464484,15778,245769,726031
"2008","MASSACHUSETTS","NANTUCKET",4073,116,1863,6052
"2008","MASSACHUSETTS","NORFOLK",200675,7500,136741,344916
"2008","MASSACHUSETTS","PLYMOUTH",131823,5104,112901,249828
"2008","MASSACHUSETTS","SUFFOLK",207127,4900,57194,269221
"2008","MASSACHUSETTS","WORCESTER",202107,9377,152106,363590
"2008","MICHIGAN","ALCONA",2896,120,3404,6420
"2008","MICHIGAN","ALGER",2472,90,2188,4750
"2008","MICHIGAN","ALLEGAN",24165,1053,30061,55279
"2008","MICHIGAN","ALPENA",7705,255,7125,15085
"2008","MICHIGAN","ANTRIM",6079,267,7506,13852
"2008","MICHIGAN","ARENAC",4155,166,3807,8128
"2008","MICHIGAN","BARAGA",1725,73,1846,3644
"2008","MICHIGAN","BARRY",13449,685,16431,30565
"2008","MICHIGAN","BAY",32589,1044,23795,57428
"2008","MICHIGAN","BENZIE",5451,171,4687,10309
"2008","MICHIGAN","BERRIEN",40381,1155,36130,77666
"2008","MICHIGAN","BRANCH",8413,338,9534,18285
"2008","MICHIGAN","CALHOUN",34561,1082,28553,64196
"2008","MICHIGAN","CASS",12083,379,11114,23576
"2008","MICHIGAN","CHARLEVOIX",6817,244,7306,14367
"2008","MICHIGAN","CHEBOYGAN",6720,261,6920,13901
"2008","MICHIGAN","CHIPPEWA",8184,257,8267,16708
"2008","MICHIGAN","CLARE",7496,278,6793,14567
"2008","MICHIGAN","CLINTON",20005,650,19726,40381
"2008","MICHIGAN","CRAWFORD",3441,176,3561,7178
"2008","MICHIGAN","DELTA",9974,327,8763,19064
"2008","MICHIGAN","DICKINSON",5995,267,7049,13311
"2008","MICHIGAN","EATON",30742,974,25900,57616
"2008","MICHIGAN","EMMET",8515,320,9314,18149
"2008","MICHIGAN","GENESEE",143927,3518,72451,219896
"2008","MICHIGAN","GLADWIN",6590,260,6391,13241
"2008","MICHIGAN","GOGEBIC",4757,177,3330,8264
"2008","MICHIGAN","GRAND TRAVERSE",23258,759,24716,48733
"2008","MICHIGAN","GRATIOT",9105,311,8322,17738
"2008","MICHIGAN","HILLSDALE",8765,463,11221,20449
"2008","MICHIGAN","HOUGHTON",7476,395,8101,15972
"2008","MICHIGAN","HURON",8367,334,8434,17135
"2008","MICHIGAN","INGHAM",93994,2252,46483,142729
"2008","MICHIGAN","IONIA",12565,598,14156,27319
"2008","MICHIGAN","IOSCO",7309,295,6583,14187
"2008","MICHIGAN","IRON",3080,135,2947,6162
"2008","MICHIGAN","ISABELLA",16679,451,11220,28350
"2008","MICHIGAN","JACKSON",37480,1331,35692,74503
"2008","MICHIGAN","KALAMAZOO",77051,2176,51554,130781
"2008","MICHIGAN","KALKASKA",3780,192,4527,8499
"2008","MICHIGAN","KENT",149909,4990,148336,303235
"2008","MICHIGAN","KEWEENAW",610,44,756,1410
"2008","MICHIGAN","LAKE",2919,104,2269,5292
"2008","MICHIGAN","LAPEER",21457,1074,22831,45362
"2008","MICHIGAN","LEELANAU",7355,171,6938,14464
"2008","MICHIGAN","LENAWEE",24640,869,22225,47734
"2008","MICHIGAN","LIVINGSTON",42349,1697,55592,99638
"2008","MICHIGAN","LUCE",1191,59,1490,2740
"2008","MICHIGAN","MACKINAC",3027,101,3268,6396
"2008","MICHIGAN","MACOMB",223784,7769,187663,419216
"2008","MICHIGAN","MANISTEE",7235,264,5510,13009
"2008","MICHIGAN","MARQUETTE",19635,644,12906,33185
"2008","MICHIGAN","MASON",7817,259,7147,15223
"2008","MICHIGAN","MECOSTA",9101,325,9238,18664
"2008","MICHIGAN","MENOMINEE",5981,236,4855,11072
"2008","MICHIGAN","MIDLAND",20701,743,22263,43707
"2008","MICHIGAN","MISSAUKEE",2898,125,4469,7492
"2008","MICHIGAN","MONROE",39180,1384,35858,76422
"2008","MICHIGAN","MONTCALM",13208,552,13291,27051
"2008","MICHIGAN","MONTMORENCY",2403,116,2841,5360
"2008","MICHIGAN","MUSKEGON",53821,1305,29145,84271
"2008","MICHIGAN","NEWAYGO",10790,453,11862,23105
"2008","MICHIGAN","OAKLAND",372566,9546,276956,659068
"2008","MICHIGAN","OCEANA",6405,244,5860,12509
"2008","MICHIGAN","OGEMAW",5391,244,5133,10768
"2008","MICHIGAN","ONTONAGON",1966,96,1823,3885
"2008","MICHIGAN","OSCEOLA",4855,198,5973,11026
"2008","MICHIGAN","OSCODA",1887,121,2320,4328
"2008","MICHIGAN","OTSEGO",5634,230,6752,12616
"2008","MICHIGAN","OTTAWA",50828,2110,83330,136268
"2008","MICHIGAN","PRESQUE ISLE",3722,177,3606,7505
"2008","MICHIGAN","ROSCOMMON",7082,242,6727,14051
"2008","MICHIGAN","SAGINAW",60276,1589,42225,104090
"2008","MICHIGAN","SANILAC",9047,443,10679,20169
"2008","MICHIGAN","SCHOOLCRAFT",2184,84,2058,4326
"2008","MICHIGAN","SHIAWASSEE",19397,750,16268,36415
"2008","MICHIGAN","ST. CLAIR",40677,1687,38536,80900
"2008","MICHIGAN","ST. JOSEPH",12322,494,12886,25702
"2008","MICHIGAN","TUSCOLA",13503,555,13740,27798
"2008","MICHIGAN","VAN BUREN",18588,644,15534,34766
"2008","MICHIGAN","WASHTENAW",130578,2591,53946,187115
"2008","MICHIGAN","WAYNE",660085,10659,219582,890326
"2008","MICHIGAN","WEXFORD",7379,281,8044,15704
"2008","MINNESOTA","AITKIN",4595,226,4589,9410
"2008","MINNESOTA","ANOKA",86976,3891,91357,182224
"2008","MINNESOTA","BECKER",7687,427,8851,16965
"2008","MINNESOTA","BELTRAMI",12019,455,9762,22236
"2008","MINNESOTA","BENTON",8454,547,10338,19339
"2008","MINNESOTA","BIG STONE",1552,76,1362,2990
"2008","MINNESOTA","BLUE EARTH",19325,963,14782,35070
"2008","MINNESOTA","BROWN",5809,355,7456,13620
"2008","MINNESOTA","CARLTON",11501,399,6549,18449
"2008","MINNESOTA","CARVER",20654,873,28156,49683
"2008","MINNESOTA","CASS",7276,371,8660,16307
"2008","MINNESOTA","CHIPPEWA",3280,169,2907,6356
"2008","MINNESOTA","CHISAGO",12783,733,15789,29305
"2008","MINNESOTA","CLAY",16666,615,11978,29259
"2008","MINNESOTA","CLEARWATER",1877,93,2291,4261
"2008","MINNESOTA","COOK",2019,89,1240,3348
"2008","MINNESOTA","COTTONWOOD",2759,120,3157,6036
"2008","MINNESOTA","CROW WING",15859,739,18567,35165
"2008","MINNESOTA","DAKOTA",116778,4330,104364,225472
"2008","MINNESOTA","DODGE",4463,282,5468,10213
"2008","MINNESOTA","DOUGLAS",9256,421,11241,20918
"2008","MINNESOTA","FARIBAULT",3736,220,4196,8152
"2008","MINNESOTA","FILLMORE",5921,320,4993,11234
"2008","MINNESOTA","FREEBORN",9915,410,6955,17280
"2008","MINNESOTA","GOODHUE",12420,600,12775,25795
"2008","MINNESOTA","GRANT",1850,109,1646,3605
"2008","MINNESOTA","HENNEPIN",420958,11768,231054,663780
"2008","MINNESOTA","HOUSTON",5906,234,4743,10883
"2008","MINNESOTA","HUBBARD",4872,208,6558,11638
"2008","MINNESOTA","ISANTI",8248,481,11324,20053
"2008","MINNESOTA","ITASCA",13460,626,10309,24395
"2008","MINNESOTA","JACKSON",2618,147,2858,5623
"2008","MINNESOTA","KANABEC",3743,277,4479,8499
"2008","MINNESOTA","KANDIYOHI",10125,451,11319,21895
"2008","MINNESOTA","KITTSON",1492,60,1016,2568
"2008","MINNESOTA","KOOCHICHING",3649,191,2962,6802
"2008","MINNESOTA","LAC QUI PARLE",2160,120,1912,4192
"2008","MINNESOTA","LAKE",4174,159,2636,6969
"2008","MINNESOTA","LAKE OF THE WOODS",971,64,1278,2313
"2008","MINNESOTA","LE SUEUR",6994,379,7636,15009
"2008","MINNESOTA","LINCOLN",1517,118,1491,3126
"2008","MINNESOTA","LYON",6110,283,6315,12708
"2008","MINNESOTA","MAHNOMEN",1436,64,843,2343
"2008","MINNESOTA","MARSHALL",2311,143,2285,4739
"2008","MINNESOTA","MARTIN",4413,288,6053,10754
"2008","MINNESOTA","MCLEOD",7505,531,10993,19029
"2008","MINNESOTA","MEEKER",5380,428,6737,12545
"2008","MINNESOTA","MILLE LACS",6072,423,7049,13544
"2008","MINNESOTA","MORRISON",6547,461,9735,16743
"2008","MINNESOTA","MOWER",11605,507,7075,19187
"2008","MINNESOTA","MURRAY",2345,148,2320,4813
"2008","MINNESOTA","NICOLLET",9887,390,7968,18245
"2008","MINNESOTA","NOBLES",4244,201,4368,8813
"2008","MINNESOTA","NORMAN",2129,101,1204,3434
"2008","MINNESOTA","OLMSTED",38711,1557,36202,76470
"2008","MINNESOTA","OTTER TAIL",13856,754,18077,32687
"2008","MINNESOTA","PENNINGTON",3394,180,3248,6822
"2008","MINNESOTA","PINE",7084,437,6862,14383
"2008","MINNESOTA","PIPESTONE",2023,126,2652,4801
"2008","MINNESOTA","POLK",7850,336,7148,15334
"2008","MINNESOTA","POPE",3317,150,3069,6536
"2008","MINNESOTA","RAMSEY",182974,5470,88942,277386
"2008","MINNESOTA","RED LAKE",1120,88,983,2191
"2008","MINNESOTA","REDWOOD",3250,248,4308,7806
"2008","MINNESOTA","RENVILLE",3904,275,3956,8135
"2008","MINNESOTA","RICE",17381,695,13723,31799
"2008","MINNESOTA","ROCK",2079,121,2775,4975
"2008","MINNESOTA","ROSEAU",3097,165,4438,7700
"2008","MINNESOTA","SAINT LOUIS",77351,2721,38742,118814
"2008","MINNESOTA","SCOTT",29208,1200,36724,67132
"2008","MINNESOTA","SHERBURNE",17957,893,26140,44990
"2008","MINNESOTA","SIBLEY",2998,239,4492,7729
"2008","MINNESOTA","STEARNS",35690,1872,41194,78756
"2008","MINNESOTA","STEELE",9016,572,10068,19656
"2008","MINNESOTA","STEVENS",2781,143,2710,5634
"2008","MINNESOTA","SWIFT",2907,153,2184,5244
"2008","MINNESOTA","TODD",5277,343,6637,12257
"2008","MINNESOTA","TRAVERSE",1043,59,933,2035
"2008","MINNESOTA","WABASHA",5646,312,5935,11893
"2008","MINNESOTA","WADENA",2882,159,4128,7169
"2008","MINNESOTA","WASECA",4401,276,5211,9888
"2008","MINNESOTA","WASHINGTON",70277,2448,64334,137059
"2008","MINNESOTA","WATONWAN",2562,170,2526,5258
"2008","MINNESOTA","WILKIN",1550,78,1786,3414
"2008","MINNESOTA","WINONA",16308,652,10975,27935
"2008","MINNESOTA","WRIGHT",26343,1456,37779,65578
"2008","MINNESOTA","YELLOW MEDICINE",2816,174,2579,5569
"2008","MISSISSIPPI","ADAMS",9021,109,6566,15696
"2008","MISSISSIPPI","ALCORN",4130,84,10805,15019
"2008","MISSISSIPPI","AMITE",3348,33,4245,7626
"2008","MISSISSIPPI","ATTALA",3849,40,5273,9162
"2008","MISSISSIPPI","BENTON",2227,50,2329,4606
"2008","MISSISSIPPI","BOLIVAR",10334,107,4891,15332
"2008","MISSISSIPPI","CALHOUN",2522,22,4467,7011
"2008","MISSISSIPPI","CARROLL",2037,16,3902,5955
"2008","MISSISSIPPI","CHICKASAW",4588,37,4395,9020
"2008","MISSISSIPPI","CHOCTAW",1459,22,2624,4105
"2008","MISSISSIPPI","CLAIBORNE",4682,19,748,5449
"2008","MISSISSIPPI","CLARKE",3121,22,5229,8372
"2008","MISSISSIPPI","CLAY",6558,32,4466,11056
"2008","MISSISSIPPI","COAHOMA",7597,37,2917,10551
"2008","MISSISSIPPI","COPIAH",7710,53,6701,14464
"2008","MISSISSIPPI","COVINGTON",3852,48,5523,9423
"2008","MISSISSIPPI","DESOTO",19627,260,44222,64109
"2008","MISSISSIPPI","FORREST",11622,165,15296,27083
"2008","MISSISSIPPI","FRANKLIN",1733,25,2909,4667
"2008","MISSISSIPPI","GEORGE",1532,52,7700,9284
"2008","MISSISSIPPI","GREENE",1366,39,4361,5766
"2008","MISSISSIPPI","GRENADA",5029,41,6234,11304
"2008","MISSISSIPPI","HANCOCK",3768,219,13020,17007
"2008","MISSISSIPPI","HARRISON",22673,254,38757,61684
"2008","MISSISSIPPI","HINDS",75401,312,32949,108662
"2008","MISSISSIPPI","HOLMES",7765,44,1714,9523
"2008","MISSISSIPPI","HUMPHREYS",3634,18,1462,5114
"2008","MISSISSIPPI","ISSAQUENA",579,3,364,946
"2008","MISSISSIPPI","ITAWAMBA",2084,87,7663,9834
"2008","MISSISSIPPI","JACKSON",17781,289,35993,54063
"2008","MISSISSIPPI","JASPER",5025,27,4135,9187
"2008","MISSISSIPPI","JEFFERSON",3883,36,551,4470
"2008","MISSISSIPPI","JEFFERSON DAVIS",4454,25,2871,7350
"2008","MISSISSIPPI","JONES",8846,158,20157,29161
"2008","MISSISSIPPI","KEMPER",3256,18,1935,5209
"2008","MISSISSIPPI","LAFAYETTE",7997,121,10278,18396
"2008","MISSISSIPPI","LAMAR",5159,150,18497,23806
"2008","MISSISSIPPI","LAUDERDALE",13332,125,19582,33039
"2008","MISSISSIPPI","LAWRENCE",2587,23,4369,6979
"2008","MISSISSIPPI","LEAKE",4151,31,5148,9330
"2008","MISSISSIPPI","LEE",12021,126,22694,34841
"2008","MISSISSIPPI","LEFLORE",8914,62,4105,13081
"2008","MISSISSIPPI","LINCOLN",5505,67,10781,16353
"2008","MISSISSIPPI","LOWNDES",13209,184,13994,27387
"2008","MISSISSIPPI","MADISON",19831,143,27203,47177
"2008","MISSISSIPPI","MARION",4422,44,8513,12979
"2008","MISSISSIPPI","MARSHALL",9685,77,6683,16445
"2008","MISSISSIPPI","MONROE",7169,69,10184,17422
"2008","MISSISSIPPI","MONTGOMERY",2609,19,3071,5699
"2008","MISSISSIPPI","NESHOBA",3114,29,8209,11352
"2008","MISSISSIPPI","NEWTON",3218,38,6479,9735
"2008","MISSISSIPPI","NOXUBEE",5030,25,1525,6580
"2008","MISSISSIPPI","OKTIBBEHA",9326,146,9320,18792
"2008","MISSISSIPPI","PANOLA",8690,105,7620,16415
"2008","MISSISSIPPI","PEARL RIVER",4320,125,17881,22326
"2008","MISSISSIPPI","PERRY",1533,40,4067,5640
"2008","MISSISSIPPI","PIKE",9276,65,8651,17992
"2008","MISSISSIPPI","PONTOTOC",2982,82,9727,12791
"2008","MISSISSIPPI","PRENTISS",3020,72,7703,10795
"2008","MISSISSIPPI","QUITMAN",2803,18,1334,4155
"2008","MISSISSIPPI","RANKIN",14372,349,48140,62861
"2008","MISSISSIPPI","SCOTT",5025,32,6584,11641
"2008","MISSISSIPPI","SHARKEY",1907,10,873,2790
"2008","MISSISSIPPI","SIMPSON",4817,87,7641,12545
"2008","MISSISSIPPI","SMITH",1968,44,6265,8277
"2008","MISSISSIPPI","STONE",1996,47,5149,7192
"2008","MISSISSIPPI","SUNFLOWER",7838,73,3245,11156
"2008","MISSISSIPPI","TALLAHATCHIE",4105,32,2786,6923
"2008","MISSISSIPPI","TATE",5003,50,7678,12731
"2008","MISSISSIPPI","TIPPAH",2623,69,6937,9629
"2008","MISSISSIPPI","TISHOMINGO",1962,81,6249,8292
"2008","MISSISSIPPI","TUNICA",3279,27,1017,4323
"2008","MISSISSIPPI","UNION",2985,52,9072,12109
"2008","MISSISSIPPI","WALTHALL",3456,40,4253,7749
"2008","MISSISSIPPI","WARREN",10489,68,11152,21709
"2008","MISSISSIPPI","WASHINGTON",13148,60,6347,19555
"2008","MISSISSIPPI","WAYNE",3890,36,6070,9996
"2008","MISSISSIPPI","WEBSTER",1349,18,4072,5439
"2008","MISSISSIPPI","WILKINSON",3534,28,1560,5122
"2008","MISSISSIPPI","WINSTON",4653,40,5497,10190
"2008","MISSISSIPPI","YALOBUSHA",3151,22,3628,6801
"2008","MISSISSIPPI","YAZOO",6116,46,5290,11452
"2008","MISSOURI","ADAIR",5735,245,5891,11871
"2008","MISSOURI","ANDREW",3345,166,5279,8790
"2008","MISSOURI","ATCHISON",1000,40,1936,2976
"2008","MISSOURI","AUDRAIN",4434,180,6167,10781
"2008","MISSOURI","BARRY",4630,256,9758,14644
"2008","MISSOURI","BARTON",1455,79,4414,5948
"2008","MISSOURI","BATES",3271,179,4833,8283
"2008","MISSOURI","BENTON",3629,179,5759,9567
"2008","MISSOURI","BOLLINGER",1690,122,3972,5784
"2008","MISSOURI","BOONE",47062,1340,36849,85251
"2008","MISSOURI","BUCHANAN",19164,766,19110,39040
"2008","MISSOURI","BUTLER",5316,217,11805,17338
"2008","MISSOURI","CALDWELL",1814,96,2654,4564
"2008","MISSOURI","CALLAWAY",7580,352,11389,19321
"2008","MISSOURI","CAMDEN",7773,286,14074,22133
"2008","MISSOURI","CAPE GIRARDEAU",12208,379,24768,37355
"2008","MISSOURI","CARROLL",1535,48,2955,4538
"2008","MISSOURI","CARTER",984,74,1840,2898
"2008","MISSOURI","CASS",19844,640,29695,50179
"2008","MISSOURI","CEDAR",2060,100,4194,6354
"2008","MISSOURI","CHARITON",1799,76,2339,4214
"2008","MISSOURI","CHRISTIAN",11883,432,25382,37697
"2008","MISSOURI","CLARK",1572,102,1782,3456
"2008","MISSOURI","CLAY",53761,1329,54516,109606
"2008","MISSOURI","CLINTON",4545,200,5709,10454
"2008","MISSOURI","COLE",13959,401,24385,38745
"2008","MISSOURI","COOPER",2996,128,4902,8026
"2008","MISSOURI","CRAWFORD",3911,167,6007,10085
"2008","MISSOURI","DADE",1184,64,2864,4112
"2008","MISSOURI","DALLAS",2656,132,4895,7683
"2008","MISSOURI","DAVIESS",1400,123,2263,3786
"2008","MISSOURI","DEKALB",1692,102,2889,4683
"2008","MISSOURI","DENT",2056,157,4655,6868
"2008","MISSOURI","DOUGLAS",2140,167,4405,6712
"2008","MISSOURI","DUNKLIN",4540,180,7044,11764
"2008","MISSOURI","FRANKLIN",21256,682,27355,49293
"2008","MISSOURI","GASCONADE",2899,109,4763,7771
"2008","MISSOURI","GENTRY",1235,93,1964,3292
"2008","MISSOURI","GREENE",56181,1831,77683,135695
"2008","MISSOURI","GRUNDY",1580,154,3006,4740
"2008","MISSOURI","HARRISON",1287,116,2512,3915
"2008","MISSOURI","HENRY",4869,195,6095,11159
"2008","MISSOURI","HICKORY",2171,94,2850,5115
"2008","MISSOURI","HOLT",802,37,1794,2633
"2008","MISSOURI","HOWARD",2036,111,2708,4855
"2008","MISSOURI","HOWELL",5736,311,10982,17029
"2008","MISSOURI","IRON",2213,111,2090,4414
"2008","MISSOURI","JACKSON",90722,2492,92833,186047
"2008","MISSOURI","JASPER",15730,628,31667,48025
"2008","MISSOURI","JEFFERSON",53467,1433,50804,105704
"2008","MISSOURI","JOHNSON",9480,417,12183,22080
"2008","MISSOURI","KANSAS CITY",120102,1263,31854,153219
"2008","MISSOURI","KNOX",759,53,1212,2024
"2008","MISSOURI","LACLEDE",5218,230,10875,16323
"2008","MISSOURI","LAFAYETTE",6902,256,9442,16600
"2008","MISSOURI","LAWRENCE",5097,277,11263,16637
"2008","MISSOURI","LEWIS",1837,71,2594,4502
"2008","MISSOURI","LINCOLN",10234,392,12924,23550
"2008","MISSOURI","LINN",2638,153,3140,5931
"2008","MISSOURI","LIVINGSTON",2435,124,3993,6552
"2008","MISSOURI","MACON",2784,104,4586,7474
"2008","MISSOURI","MADISON",2042,89,2897,5028
"2008","MISSOURI","MARIES",1599,96,2853,4548
"2008","MISSOURI","MARION",4703,145,7705,12553
"2008","MISSOURI","MCDONALD",2454,182,5499,8135
"2008","MISSOURI","MERCER",519,60,1169,1748
"2008","MISSOURI","MILLER",3553,185,7797,11535
"2008","MISSOURI","MISSISSIPPI",2247,75,3034,5356
"2008","MISSOURI","MONITEAU",2084,114,4467,6665
"2008","MISSOURI","MONROE",1703,78,2533,4314
"2008","MISSOURI","MONTGOMERY",2347,81,3428,5856
"2008","MISSOURI","MORGAN",3565,133,5451,9149
"2008","MISSOURI","NEW MADRID",3370,129,4593,8092
"2008","MISSOURI","NEWTON",7450,319,17637,25406
"2008","MISSOURI","NODAWAY",4493,158,5568,10219
"2008","MISSOURI","OREGON",1811,128,2652,4591
"2008","MISSOURI","OSAGE",1907,110,5062,7079
"2008","MISSOURI","OZARK",1661,107,2918,4686
"2008","MISSOURI","PEMISCOT",3029,64,3954,7047
"2008","MISSOURI","PERRY",3005,115,5527,8647
"2008","MISSOURI","PETTIS",6932,258,11018,18208
"2008","MISSOURI","PHELPS",7394,338,11706,19438
"2008","MISSOURI","PIKE",3487,126,4268,7881
"2008","MISSOURI","PLATTE",21459,561,24460,46480
"2008","MISSOURI","POLK",4553,188,8956,13697
"2008","MISSOURI","PULASKI",5249,199,9552,15000
"2008","MISSOURI","PUTNAM",695,53,1591,2339
"2008","MISSOURI","RALLS",2041,56,2987,5084
"2008","MISSOURI","RANDOLPH",3984,183,6457,10624
"2008","MISSOURI","RAY",5241,219,5593,11053
"2008","MISSOURI","REYNOLDS",1418,87,1782,3287
"2008","MISSOURI","RIPLEY",1795,161,3407,5363
"2008","MISSOURI","SALINE",4712,174,4962,9848
"2008","MISSOURI","SCHUYLER",775,69,1139,1983
"2008","MISSOURI","SCOTLAND",793,56,1249,2098
"2008","MISSOURI","SCOTT",6258,205,11563,18026
"2008","MISSOURI","SHANNON",1637,126,2075,3838
"2008","MISSOURI","SHELBY",1114,36,2166,3316
"2008","MISSOURI","ST. CHARLES",84183,1796,102550,188529
"2008","MISSOURI","ST. CLAIR",1886,121,2981,4988
"2008","MISSOURI","ST. FRANCOIS",11540,350,12660,24550
"2008","MISSOURI","ST. LOUIS CITY",132925,1271,24662,158858
"2008","MISSOURI","ST. LOUIS COUNTY",333123,5026,221705,559854
"2008","MISSOURI","STE. GENEVIEVE",4979,114,3732,8825
"2008","MISSOURI","STODDARD",3899,191,9172,13262
"2008","MISSOURI","STONE",5029,211,11147,16387
"2008","MISSOURI","SULLIVAN",1173,89,1607,2869
"2008","MISSOURI","TANEY",6683,245,14736,21664
"2008","MISSOURI","TEXAS",3410,226,7215,10851
"2008","MISSOURI","VERNON",3381,163,5334,8878
"2008","MISSOURI","WARREN",6705,196,8675,15576
"2008","MISSOURI","WASHINGTON",4711,197,4706,9614
"2008","MISSOURI","WAYNE",2243,127,3784,6154
"2008","MISSOURI","WEBSTER",5685,240,10431,16356
"2008","MISSOURI","WORTH",427,40,707,1174
"2008","MISSOURI","WRIGHT",2557,173,5784,8514
"2008","MONTANA","BEAVERHEAD",1617,138,3008,4763
"2008","MONTANA","BIG HORN",3516,75,1628,5219
"2008","MONTANA","BLAINE",1702,173,1139,3014
"2008","MONTANA","BROADWATER",854,68,1853,2775
"2008","MONTANA","CARBON",2443,199,3108,5750
"2008","MONTANA","CARTER",111,182,573,866
"2008","MONTANA","CASCADE",17664,875,16857,35396
"2008","MONTANA","CHOUTEAU",1122,110,1634,2866
"2008","MONTANA","CUSTER",2267,168,3047,5482
"2008","MONTANA","DANIELS",343,36,694,1073
"2008","MONTANA","DAWSON",1593,218,2639,4450
"2008","MONTANA","DEER LODGE",3402,170,1502,5074
"2008","MONTANA","FALLON",318,157,1064,1539
"2008","MONTANA","FERGUS",1933,191,4108,6232
"2008","MONTANA","FLATHEAD",16138,2047,25559,43744
"2008","MONTANA","GALLATIN",24205,1386,22578,48169
"2008","MONTANA","GARFIELD",110,19,598,727
"2008","MONTANA","GLACIER",3423,97,1451,4971
"2008","MONTANA","GOLDEN VALLEY",124,25,343,492
"2008","MONTANA","GRANITE",601,104,1013,1718
"2008","MONTANA","HILL",3596,278,2787,6661
"2008","MONTANA","JEFFERSON",2582,221,3538,6341
"2008","MONTANA","JUDITH BASIN",397,38,801,1236
"2008","MONTANA","LAKE",6766,655,6498,13919
"2008","MONTANA","LEWIS AND CLARK",17114,1353,14966,33433
"2008","MONTANA","LIBERTY",367,40,594,1001
"2008","MONTANA","LINCOLN",3025,498,5704,9227
"2008","MONTANA","MADISON",1607,139,2822,4568
"2008","MONTANA","MCCONE",321,59,726,1106
"2008","MONTANA","MEAGHER",298,44,624,966
"2008","MONTANA","MINERAL",845,123,1053,2021
"2008","MONTANA","MISSOULA",36531,1830,20743,59104
"2008","MONTANA","MUSSELSHELL",636,89,1581,2306
"2008","MONTANA","PARK",4173,1266,4376,9815
"2008","MONTANA","PETROLEUM",68,5,227,300
"2008","MONTANA","PHILLIPS",638,163,1423,2224
"2008","MONTANA","PONDERA",1223,74,1588,2885
"2008","MONTANA","POWDER RIVER",208,394,802,1404
"2008","MONTANA","POWELL",1021,236,1683,2940
"2008","MONTANA","PRAIRIE",211,116,503,830
"2008","MONTANA","RAVALLI",8400,699,13002,22101
"2008","MONTANA","RICHLAND",1203,129,3184,4516
"2008","MONTANA","ROOSEVELT",2564,910,1473,4947
"2008","MONTANA","ROSEBUD",1919,123,1768,3810
"2008","MONTANA","SANDERS",1970,335,3563,5868
"2008","MONTANA","SHERIDAN",953,66,987,2006
"2008","MONTANA","SILVER BOW",11676,475,4818,16969
"2008","MONTANA","STILLWATER",1512,164,2991,4667
"2008","MONTANA","SWEET GRASS",541,264,1494,2299
"2008","MONTANA","TETON",1294,104,1874,3272
"2008","MONTANA","TOOLE",737,67,1317,2121
"2008","MONTANA","TREASURE",156,16,314,486
"2008","MONTANA","VALLEY",1645,660,2121,4426
"2008","MONTANA","WHEATLAND",289,37,657,983
"2008","MONTANA","WIBAUX",146,38,379,563
"2008","MONTANA","YELLOWSTONE",32038,1910,36483,70431
"2008","NEBRASKA","ADAMS",4685,273,8252,13210
"2008","NEBRASKA","ANTELOPE",757,45,2383,3185
"2008","NEBRASKA","ARTHUR",39,7,217,263
"2008","NEBRASKA","BANNER",62,6,348,416
"2008","NEBRASKA","BLAINE",43,7,266,316
"2008","NEBRASKA","BOONE",742,52,2042,2836
"2008","NEBRASKA","BOX BUTTE",1886,161,2932,4979
"2008","NEBRASKA","BOYD",250,21,839,1110
"2008","NEBRASKA","BROWN",311,48,1208,1567
"2008","NEBRASKA","BUFFALO",5867,329,13097,19293
"2008","NEBRASKA","BURT",1413,67,1907,3387
"2008","NEBRASKA","BUTLER",1190,92,2557,3839
"2008","NEBRASKA","CASS",4753,249,7120,12122
"2008","NEBRASKA","CEDAR",1190,72,2912,4174
"2008","NEBRASKA","CHASE",341,26,1477,1844
"2008","NEBRASKA","CHERRY",599,100,2360,3059
"2008","NEBRASKA","CHEYENNE",1173,94,3572,4839
"2008","NEBRASKA","CLAY",780,76,2177,3033
"2008","NEBRASKA","COLFAX",1125,60,2018,3203
"2008","NEBRASKA","CUMING",1274,81,2732,4087
"2008","NEBRASKA","CUSTER",1192,85,4301,5578
"2008","NEBRASKA","DAKOTA",2994,110,3292,6396
"2008","NEBRASKA","DAWES",1285,114,2376,3775
"2008","NEBRASKA","DAWSON",2399,127,5460,7986
"2008","NEBRASKA","DEUEL",243,18,732,993
"2008","NEBRASKA","DIXON",946,63,1785,2794
"2008","NEBRASKA","DODGE",6689,304,8557,15550
"2008","NEBRASKA","DOUGLAS",116810,3600,106291,226701
"2008","NEBRASKA","DUNDY",218,18,783,1019
"2008","NEBRASKA","FILLMORE",962,72,1913,2947
"2008","NEBRASKA","FRANKLIN",442,31,1079,1552
"2008","NEBRASKA","FRONTIER",349,21,1034,1404
"2008","NEBRASKA","FURNAS",556,47,1725,2328
"2008","NEBRASKA","GAGE",4473,252,5435,10160
"2008","NEBRASKA","GARDEN",283,11,844,1138
"2008","NEBRASKA","GARFIELD",212,18,800,1030
"2008","NEBRASKA","GOSPER",260,12,776,1048
"2008","NEBRASKA","GRANT",41,8,318,367
"2008","NEBRASKA","GREELEY",458,26,715,1199
"2008","NEBRASKA","HALL",7855,439,12977,21271
"2008","NEBRASKA","HAMILTON",1332,78,3389,4799
"2008","NEBRASKA","HARLAN",402,35,1329,1766
"2008","NEBRASKA","HAYES",85,7,461,553
"2008","NEBRASKA","HITCHCOCK",346,32,1001,1379
"2008","NEBRASKA","HOLT",1089,139,3746,4974
"2008","NEBRASKA","HOOKER",75,8,355,438
"2008","NEBRASKA","HOWARD",1083,66,1847,2996
"2008","NEBRASKA","JEFFERSON",1520,74,2103,3697
"2008","NEBRASKA","JOHNSON",914,54,1142,2110
"2008","NEBRASKA","KEARNEY",876,50,2224,3150
"2008","NEBRASKA","KEITH",974,52,2942,3968
"2008","NEBRASKA","KEYA PAHA",115,9,409,533
"2008","NEBRASKA","KIMBALL",439,26,1346,1811
"2008","NEBRASKA","KNOX",1255,101,2728,4084
"2008","NEBRASKA","LANCASTER",65734,2358,59398,127490
"2008","NEBRASKA","LINCOLN",5046,414,10817,16277
"2008","NEBRASKA","LOGAN",81,8,327,416
"2008","NEBRASKA","LOUP",86,5,302,393
"2008","NEBRASKA","MADISON",4142,248,9655,14045
"2008","NEBRASKA","MCPHERSON",45,8,240,293
"2008","NEBRASKA","MERRICK",986,70,2375,3431
"2008","NEBRASKA","MORRILL",557,69,1725,2351
"2008","NEBRASKA","NANCE",549,42,1116,1707
"2008","NEBRASKA","NEMAHA",1240,100,2134,3474
"2008","NEBRASKA","NUCKOLLS",657,66,1498,2221
"2008","NEBRASKA","OTOE",2915,144,4033,7092
"2008","NEBRASKA","PAWNEE",483,42,859,1384
"2008","NEBRASKA","PERKINS",310,18,1092,1420
"2008","NEBRASKA","PHELPS",1050,63,3360,4473
"2008","NEBRASKA","PIERCE",783,58,2385,3226
"2008","NEBRASKA","PLATTE",3796,251,9373,13420
"2008","NEBRASKA","POLK",668,53,1822,2543
"2008","NEBRASKA","RED WILLOW",1216,93,3735,5044
"2008","NEBRASKA","RICHARDSON",1513,113,2342,3968
"2008","NEBRASKA","ROCK",139,22,640,801
"2008","NEBRASKA","SALINE",2674,143,2434,5251
"2008","NEBRASKA","SARPY",28010,1196,38816,68022
"2008","NEBRASKA","SAUNDERS",3767,257,6188,10212
"2008","NEBRASKA","SCOTTS BLUFF",4745,277,9708,14730
"2008","NEBRASKA","SEWARD",2703,179,4647,7529
"2008","NEBRASKA","SHERIDAN",454,67,1941,2462
"2008","NEBRASKA","SHERMAN",585,37,950,1572
"2008","NEBRASKA","SIOUX",117,12,603,732
"2008","NEBRASKA","STANTON",664,50,1781,2495
"2008","NEBRASKA","THAYER",860,50,1749,2659
"2008","NEBRASKA","THOMAS",51,8,331,390
"2008","NEBRASKA","THURSTON",1120,34,972,2126
"2008","NEBRASKA","VALLEY",706,60,1657,2423
"2008","NEBRASKA","WASHINGTON",3711,184,6425,10320
"2008","NEBRASKA","WAYNE",1249,56,2503,3808
"2008","NEBRASKA","WEBSTER",552,32,1233,1817
"2008","NEBRASKA","WHEELER",96,10,334,440
"2008","NEBRASKA","YORK",1607,113,4848,6568
"2008","NEVADA","CARSON CITY",11623,638,11419,23680
"2008","NEVADA","CHURCHILL",3494,279,6832,10605
"2008","NEVADA","CLARK",380765,13329,257078,651172
"2008","NEVADA","DOUGLAS",10672,584,14648,25904
"2008","NEVADA","ELKO",4541,509,10969,16019
"2008","NEVADA","ESMERALDA",104,32,303,439
"2008","NEVADA","EUREKA",144,37,564,745
"2008","NEVADA","HUMBOLDT",1909,169,3586,5664
"2008","NEVADA","LANDER",577,59,1466,2102
"2008","NEVADA","LINCOLN",518,91,1498,2107
"2008","NEVADA","LYON",8405,544,12154,21103
"2008","NEVADA","MINERAL",1082,94,1131,2307
"2008","NEVADA","NYE",7226,728,9537,17491
"2008","NEVADA","PERSHING",673,88,1075,1836
"2008","NEVADA","STOREY",1102,69,1247,2418
"2008","NEVADA","WASHOE",99671,3863,76880,180414
"2008","NEVADA","WHITE PINE",1230,172,2440,3842
"2008","NEW HAMPSHIRE","BELKNAP",16796,416,16402,33614
"2008","NEW HAMPSHIRE","CARROLL",15221,448,13387,29056
"2008","NEW HAMPSHIRE","CHESHIRE",26971,647,15205,42823
"2008","NEW HAMPSHIRE","COOS",9532,258,6558,16348
"2008","NEW HAMPSHIRE","GRAFTON",31446,757,17687,49890
"2008","NEW HAMPSHIRE","HILLSBOROUGH",104820,2711,97178,204709
"2008","NEW HAMPSHIRE","MERRIMACK",45078,1018,34010,80106
"2008","NEW HAMPSHIRE","ROCKINGHAM",83723,2182,81917,167822
"2008","NEW HAMPSHIRE","STRAFFORD",37990,837,25021,63848
"2008","NEW HAMPSHIRE","SULLIVAN",13249,336,9169,22754
"2008","NEW JERSEY","ATLANTIC",67830,341,49902,118073
"2008","NEW JERSEY","BERGEN",225367,1153,186118,412638
"2008","NEW JERSEY","BURLINGTON",131219,569,89626,221414
"2008","NEW JERSEY","CAMDEN",159259,515,73819,233593
"2008","NEW JERSEY","CAPE MAY",22893,200,27288,50381
"2008","NEW JERSEY","CUMBERLAND",34919,205,22360,57484
"2008","NEW JERSEY","ESSEX",240306,635,74063,315004
"2008","NEW JERSEY","GLOUCESTER",77267,400,60315,137982
"2008","NEW JERSEY","HUDSON",154140,648,55360,210148
"2008","NEW JERSEY","HUNTERDON",29776,231,39092,69099
"2008","NEW JERSEY","MERCER",107926,400,50223,158549
"2008","NEW JERSEY","MIDDLESEX",193812,872,123695,318379
"2008","NEW JERSEY","MONMOUTH",148737,745,160433,309915
"2008","NEW JERSEY","MORRIS",112275,542,132331,245148
"2008","NEW JERSEY","OCEAN",110189,594,160677,271460
"2008","NEW JERSEY","PASSAIC",113257,387,72552,186196
"2008","NEW JERSEY","SALEM",16044,99,14816,30959
"2008","NEW JERSEY","SOMERSET",79321,357,70085,149763
"2008","NEW JERSEY","SUSSEX",28840,316,44184,73340
"2008","NEW JERSEY","UNION",141417,465,78768,220650
"2008","NEW JERSEY","WARREN",20628,195,27500,48323
"2008","NEW MEXICO","BERNALILLO",171556,3701,110521,285778
"2008","NEW MEXICO","CATRON",664,50,1398,2112
"2008","NEW MEXICO","CHAVES",8197,264,13651,22112
"2008","NEW MEXICO","CIBOLA",5827,139,3131,9097
"2008","NEW MEXICO","COLFAX",3490,89,2805,6384
"2008","NEW MEXICO","CURRY",4670,169,9599,14438
"2008","NEW MEXICO","DE BACA",359,9,676,1044
"2008","NEW MEXICO","DONA ANA",40282,930,28068,69280
"2008","NEW MEXICO","EDDY",7351,242,12500,20093
"2008","NEW MEXICO","GRANT",8142,207,5406,13755
"2008","NEW MEXICO","GUADALUPE",1557,19,620,2196
"2008","NEW MEXICO","HARDING",260,8,358,626
"2008","NEW MEXICO","HIDALGO",993,22,936,1951
"2008","NEW MEXICO","LEA",5108,190,13347,18645
"2008","NEW MEXICO","LINCOLN",3535,160,6001,9696
"2008","NEW MEXICO","LOS ALAMOS",5824,181,5064,11069
"2008","NEW MEXICO","LUNA",4311,159,3870,8340
"2008","NEW MEXICO","MCKINLEY",16572,253,6382,23207
"2008","NEW MEXICO","MORA",2168,23,569,2760
"2008","NEW MEXICO","OTERO",8610,350,12806,21766
"2008","NEW MEXICO","QUAY",1547,82,2367,3996
"2008","NEW MEXICO","RIO ARRIBA",12703,151,4086,16940
"2008","NEW MEXICO","ROOSEVELT",2303,106,4311,6720
"2008","NEW MEXICO","SAN JUAN",18028,614,27869,46511
"2008","NEW MEXICO","SAN MIGUEL",10320,143,2478,12941
"2008","NEW MEXICO","SANDOVAL",32669,768,25193,58630
"2008","NEW MEXICO","SANTA FE",55567,849,15807,72223
"2008","NEW MEXICO","SIERRA",2352,116,3017,5485
"2008","NEW MEXICO","SOCORRO",4696,167,3032,7895
"2008","NEW MEXICO","TAOS",13816,204,2866,16886
"2008","NEW MEXICO","TORRANCE",3087,119,3735,6941
"2008","NEW MEXICO","UNION",492,23,1227,1742
"2008","NEW MEXICO","VALENCIA",15366,397,13136,28899
"2008","NEW YORK","ALBANY",93937,2613,50586,147136
"2008","NEW YORK","ALLEGANY",7016,339,11013,18368
"2008","NEW YORK","BRONX",338261,1342,41683,381286
"2008","NEW YORK","BROOME",47204,1437,40077,88718
"2008","NEW YORK","CATTARAUGUS",14307,511,17770,32588
"2008","NEW YORK","CAYUGA",18128,621,15243,33992
"2008","NEW YORK","CHAUTAUQUA",29129,1064,28579,58772
"2008","NEW YORK","CHEMUNG",18888,443,19364,38695
"2008","NEW YORK","CHENANGO",10100,410,10337,20847
"2008","NEW YORK","CLINTON",20216,519,12579,33314
"2008","NEW YORK","COLUMBIA",17556,515,13337,31408
"2008","NEW YORK","CORTLAND",11861,361,9678,21900
"2008","NEW YORK","DELAWARE",9462,403,10524,20389
"2008","NEW YORK","DUTCHESS",71060,1566,59628,132254
"2008","NEW YORK","ERIE",256299,6871,178815,441985
"2008","NEW YORK","ESSEX",10390,288,7913,18591
"2008","NEW YORK","FRANKLIN",10571,249,6676,17496
"2008","NEW YORK","FULTON",9695,401,11709,21805
"2008","NEW YORK","GENESEE",10762,399,15705,26866
"2008","NEW YORK","GREENE",9850,406,12059,22315
"2008","NEW YORK","HAMILTON",1225,45,2141,3411
"2008","NEW YORK","HERKIMER",12094,471,14619,27184
"2008","NEW YORK","JEFFERSON",18166,462,20219,38847
"2008","NEW YORK","KINGS",603525,4274,151872,759671
"2008","NEW YORK","LEWIS",4986,174,5969,11129
"2008","NEW YORK","LIVINGSTON",13655,442,16030,30127
"2008","NEW YORK","MADISON",14692,652,14434,29778
"2008","NEW YORK","MONROE",207225,4347,144153,355725
"2008","NEW YORK","MONTGOMERY",9080,384,10711,20175
"2008","NEW YORK","NASSAU",342067,4589,288758,635414
"2008","NEW YORK","NEW YORK",572126,5239,89906,667271
"2008","NEW YORK","NIAGARA",47303,1556,46348,95207
"2008","NEW YORK","ONEIDA",43506,1551,49256,94313
"2008","NEW YORK","ONONDAGA",129317,3905,84972,218194
"2008","NEW YORK","ONTARIO",25103,746,25171,51020
"2008","NEW YORK","ORANGE",78326,1550,72042,151918
"2008","NEW YORK","ORLEANS",6614,252,9708,16574
"2008","NEW YORK","OSWEGO",24777,907,23571,49255
"2008","NEW YORK","OTSEGO",13570,505,12026,26101
"2008","NEW YORK","PUTNAM",21613,455,25145,47213
"2008","NEW YORK","QUEENS",447906,3794,145898,597598
"2008","NEW YORK","RENSSELAER",39753,1393,32840,73986
"2008","NEW YORK","RICHMOND",79311,1107,86062,166480
"2008","NEW YORK","ROCKLAND",69543,841,61752,132136
"2008","NEW YORK","SARATOGA",56645,1755,52855,111255
"2008","NEW YORK","SCHENECTADY",38611,1409,29758,69778
"2008","NEW YORK","SCHOHARIE",6009,301,8071,14381
"2008","NEW YORK","SCHUYLER",3933,125,4542,8600
"2008","NEW YORK","SENECA",7422,265,7038,14725
"2008","NEW YORK","ST. LAWRENCE",23706,580,16956,41242
"2008","NEW YORK","STEUBEN",17148,540,24203,41891
"2008","NEW YORK","SUFFOLK",346379,5833,306815,659027
"2008","NEW YORK","SULLIVAN",16850,403,13900,31153
"2008","NEW YORK","TIOGA",10172,382,12536,23090
"2008","NEW YORK","TOMPKINS",29826,732,11927,42485
"2008","NEW YORK","ULSTER",52539,1395,32527,86461
"2008","NEW YORK","WARREN",16281,496,15429,32206
"2008","NEW YORK","WASHINGTON",12741,442,12533,25716
"2008","NEW YORK","WAYNE",18184,579,22239,41002
"2008","NEW YORK","WESTCHESTER",261810,3213,147824,412847
"2008","NEW YORK","WYOMING",6379,281,10998,17658
"2008","NEW YORK","YATES",4890,105,5269,10264
"2008","NORTH CAROLINA","ALAMANCE",28918,576,34859,64353
"2008","NORTH CAROLINA","ALEXANDER",5167,297,11790,17254
"2008","NORTH CAROLINA","ALLEGHANY",2021,118,3124,5263
"2008","NORTH CAROLINA","ANSON",6456,70,4207,10733
"2008","NORTH CAROLINA","ASHE",4872,281,7916,13069
"2008","NORTH CAROLINA","AVERY",2178,84,5681,7943
"2008","NORTH CAROLINA","BEAUFORT",9454,96,13460,23010
"2008","NORTH CAROLINA","BERTIE",6365,22,3376,9763
"2008","NORTH CAROLINA","BLADEN",7853,95,7532,15480
"2008","NORTH CAROLINA","BRUNSWICK",21331,524,30753,52608
"2008","NORTH CAROLINA","BUNCOMBE",69716,1585,52494,123795
"2008","NORTH CAROLINA","BURKE",14901,440,22102,37443
"2008","NORTH CAROLINA","CABARRUS",31546,524,45924,77994
"2008","NORTH CAROLINA","CALDWELL",12081,548,22526,35155
"2008","NORTH CAROLINA","CAMDEN",1597,84,3140,4821
"2008","NORTH CAROLINA","CARTERET",11130,336,23131,34597
"2008","NORTH CAROLINA","CASWELL",5545,109,5208,10862
"2008","NORTH CAROLINA","CATAWBA",25656,802,42993,69451
"2008","NORTH CAROLINA","CHATHAM",17862,350,14668,32880
"2008","NORTH CAROLINA","CHEROKEE",3785,158,8643,12586
"2008","NORTH CAROLINA","CHOWAN",3688,51,3773,7512
"2008","NORTH CAROLINA","CLAY",1734,102,3707,5543
"2008","NORTH CAROLINA","CLEVELAND",17363,394,26078,43835
"2008","NORTH CAROLINA","COLUMBUS",11076,212,12994,24282
"2008","NORTH CAROLINA","CRAVEN",19352,345,24901,44598
"2008","NORTH CAROLINA","CUMBERLAND",74693,731,52151,127575
"2008","NORTH CAROLINA","CURRITUCK",3737,131,7234,11102
"2008","NORTH CAROLINA","DARE",8074,229,9745,18048
"2008","NORTH CAROLINA","DAVIDSON",22433,729,45419,68581
"2008","NORTH CAROLINA","DAVIE",6178,209,13981,20368
"2008","NORTH CAROLINA","DUPLIN",8958,112,10834,19904
"2008","NORTH CAROLINA","DURHAM",103456,1088,32353,136897
"2008","NORTH CAROLINA","EDGECOMBE",17403,82,8445,25930
"2008","NORTH CAROLINA","FORSYTH",91085,1374,73674,166133
"2008","NORTH CAROLINA","FRANKLIN",13085,281,13273,26639
"2008","NORTH CAROLINA","GASTON",31384,511,52507,84402
"2008","NORTH CAROLINA","GATES",2830,43,2547,5420
"2008","NORTH CAROLINA","GRAHAM",1265,82,2824,4171
"2008","NORTH CAROLINA","GRANVILLE",13074,204,11447,24725
"2008","NORTH CAROLINA","GREENE",3796,35,4272,8103
"2008","NORTH CAROLINA","GUILFORD",142101,1952,97718,241771
"2008","NORTH CAROLINA","HALIFAX",16047,83,8961,25091
"2008","NORTH CAROLINA","HARNETT",16785,341,23579,40705
"2008","NORTH CAROLINA","HAYWOOD",12730,427,14910,28067
"2008","NORTH CAROLINA","HENDERSON",20082,602,30930,51614
"2008","NORTH CAROLINA","HERTFORD",7513,48,3089,10650
"2008","NORTH CAROLINA","HOKE",9227,107,6293,15627
"2008","NORTH CAROLINA","HYDE",1241,16,1212,2469
"2008","NORTH CAROLINA","IREDELL",27318,696,45148,73162
"2008","NORTH CAROLINA","JACKSON",8766,246,7854,16866
"2008","NORTH CAROLINA","JOHNSTON",26795,600,43622,71017
"2008","NORTH CAROLINA","JONES",2378,32,2817,5227
"2008","NORTH CAROLINA","LEE",10784,229,12775,23788
"2008","NORTH CAROLINA","LENOIR",13378,118,13401,26897
"2008","NORTH CAROLINA","LINCOLN",11713,454,23631,35798
"2008","NORTH CAROLINA","MACON",6620,301,10317,17238
"2008","NORTH CAROLINA","MADISON",5026,161,5192,10379
"2008","NORTH CAROLINA","MARTIN",6539,45,5957,12541
"2008","NORTH CAROLINA","MCDOWELL",6571,281,11534,18386
"2008","NORTH CAROLINA","MECKLENBURG",253958,3011,153848,410817
"2008","NORTH CAROLINA","MITCHELL",2238,109,5499,7846
"2008","NORTH CAROLINA","MONTGOMERY",4926,129,6155,11210
"2008","NORTH CAROLINA","MOORE",17624,390,27314,45328
"2008","NORTH CAROLINA","NASH",23099,291,23728,47118
"2008","NORTH CAROLINA","NEW HANOVER",49145,976,50544,100665
"2008","NORTH CAROLINA","NORTHAMPTON",6903,44,3671,10618
"2008","NORTH CAROLINA","ONSLOW",19499,426,30278,50203
"2008","NORTH CAROLINA","ORANGE",53806,838,20266,74910
"2008","NORTH CAROLINA","PAMLICO",2838,51,3823,6712
"2008","NORTH CAROLINA","PASQUOTANK",10272,130,7778,18180
"2008","NORTH CAROLINA","PENDER",9907,224,13618,23749
"2008","NORTH CAROLINA","PERQUIMANS",2772,51,3678,6501
"2008","NORTH CAROLINA","PERSON",8446,156,10030,18632
"2008","NORTH CAROLINA","PITT",40501,456,33927,74884
"2008","NORTH CAROLINA","POLK",4396,176,5990,10562
"2008","NORTH CAROLINA","RANDOLPH",16414,735,40998,58147
"2008","NORTH CAROLINA","RICHMOND",9713,190,9424,19327
"2008","NORTH CAROLINA","ROBESON",23058,343,17433,40834
"2008","NORTH CAROLINA","ROCKINGHAM",17255,458,23899,41612
"2008","NORTH CAROLINA","ROWAN",23391,718,37451,61560
"2008","NORTH CAROLINA","RUTHERFORD",9641,310,18769,28720
"2008","NORTH CAROLINA","SAMPSON",11836,164,14038,26038
"2008","NORTH CAROLINA","SCOTLAND",8151,61,6005,14217
"2008","NORTH CAROLINA","STANLY",8878,299,19329,28506
"2008","NORTH CAROLINA","STOKES",6875,380,14488,21743
"2008","NORTH CAROLINA","SURRY",10475,320,18730,29525
"2008","NORTH CAROLINA","SWAIN",2806,92,2900,5798
"2008","NORTH CAROLINA","TRANSYLVANIA",7275,233,9401,16909
"2008","NORTH CAROLINA","TYRRELL",933,17,960,1910
"2008","NORTH CAROLINA","UNION",31189,777,54123,86089
"2008","NORTH CAROLINA","VANCE",13166,99,7606,20871
"2008","NORTH CAROLINA","WAKE",250891,4353,187001,442245
"2008","NORTH CAROLINA","WARREN",7086,46,3063,10195
"2008","NORTH CAROLINA","WASHINGTON",3748,36,2670,6454
"2008","NORTH CAROLINA","WATAUGA",14558,470,13344,28372
"2008","NORTH CAROLINA","WAYNE",22671,259,26952,49882
"2008","NORTH CAROLINA","WILKES",8934,502,20288,29724
"2008","NORTH CAROLINA","WILSON",19652,164,17375,37191
"2008","NORTH CAROLINA","YADKIN",4527,211,12409,17147
"2008","NORTH CAROLINA","YANCEY",4486,186,5045,9717
"2008","NORTH DAKOTA","ADAMS",435,48,788,1271
"2008","NORTH DAKOTA","BARNES",2741,127,2826,5694
"2008","NORTH DAKOTA","BENSON",1569,32,773,2374
"2008","NORTH DAKOTA","BILLINGS",114,10,375,499
"2008","NORTH DAKOTA","BOTTINEAU",1387,70,2059,3516
"2008","NORTH DAKOTA","BOWMAN",478,55,1107,1640
"2008","NORTH DAKOTA","BURKE",286,17,640,943
"2008","NORTH DAKOTA","BURLEIGH",15600,729,25443,41772
"2008","NORTH DAKOTA","CASS",37622,1231,32566,71419
"2008","NORTH DAKOTA","CAVALIER",930,72,1128,2130
"2008","NORTH DAKOTA","DICKEY",1044,51,1525,2620
"2008","NORTH DAKOTA","DIVIDE",464,37,630,1131
"2008","NORTH DAKOTA","DUNN",527,37,1080,1644
"2008","NORTH DAKOTA","EDDY",583,34,548,1165
"2008","NORTH DAKOTA","EMMONS",546,61,1230,1837
"2008","NORTH DAKOTA","FOSTER",687,50,914,1651
"2008","NORTH DAKOTA","GOLDEN VALLEY",210,23,642,875
"2008","NORTH DAKOTA","GRAND FORKS",16104,529,14520,31153
"2008","NORTH DAKOTA","GRANT",280,462,587,1329
"2008","NORTH DAKOTA","GRIGGS",598,34,682,1314
"2008","NORTH DAKOTA","HETTINGER",406,49,893,1348
"2008","NORTH DAKOTA","KIDDER",422,54,752,1228
"2008","NORTH DAKOTA","LAMOURE",868,63,1310,2241
"2008","NORTH DAKOTA","LOGAN",299,32,726,1057
"2008","NORTH DAKOTA","MCHENRY",981,61,1374,2416
"2008","NORTH DAKOTA","MCINTOSH",579,37,916,1532
"2008","NORTH DAKOTA","MCKENZIE",933,42,1740,2715
"2008","NORTH DAKOTA","MCLEAN",1867,102,2767,4736
"2008","NORTH DAKOTA","MERCER",1476,132,2789,4397
"2008","NORTH DAKOTA","MORTON",5079,316,7869,13264
"2008","NORTH DAKOTA","MOUNTRAIL",1477,55,1406,2938
"2008","NORTH DAKOTA","NELSON",907,45,800,1752
"2008","NORTH DAKOTA","OLIVER",332,26,682,1040
"2008","NORTH DAKOTA","PEMBINA",1494,91,1722,3307
"2008","NORTH DAKOTA","PIERCE",792,46,1301,2139
"2008","NORTH DAKOTA","RAMSEY",2314,87,2361,4762
"2008","NORTH DAKOTA","RANSOM",1371,64,998,2433
"2008","NORTH DAKOTA","RENVILLE",505,42,799,1346
"2008","NORTH DAKOTA","RICHLAND",3513,150,3900,7563
"2008","NORTH DAKOTA","ROLETTE",3403,86,1045,4534
"2008","NORTH DAKOTA","SARGENT",1115,34,778,1927
"2008","NORTH DAKOTA","SHERIDAN",229,19,555,803
"2008","NORTH DAKOTA","SIOUX",1145,18,215,1378
"2008","NORTH DAKOTA","SLOPE",106,8,297,411
"2008","NORTH DAKOTA","STARK",3802,244,7024,11070
"2008","NORTH DAKOTA","STEELE",614,14,404,1032
"2008","NORTH DAKOTA","STUTSMAN",4056,229,5499,9784
"2008","NORTH DAKOTA","TOWNER",621,40,536,1197
"2008","NORTH DAKOTA","TRAILL",2136,60,1845,4041
"2008","NORTH DAKOTA","WALSH",2325,142,2415,4882
"2008","NORTH DAKOTA","WARD",10144,416,15061,25621
"2008","NORTH DAKOTA","WELLS",841,68,1468,2377
"2008","NORTH DAKOTA","WILLIAMS",2921,161,6291,9373
"2008","OHIO","ADAMS",4170,304,6914,11388
"2008","OHIO","ALLEN",19521,801,29941,50263
"2008","OHIO","ASHLAND",9300,710,15158,25168
"2008","OHIO","ASHTABULA",25027,898,18949,44874
"2008","OHIO","ATHENS",20722,634,9742,31098
"2008","OHIO","AUGLAIZE",6727,364,16395,23486
"2008","OHIO","BELMONT",16302,687,15422,32411
"2008","OHIO","BROWN",7503,418,12192,20113
"2008","OHIO","BUTLER",66030,2406,105340,173776
"2008","OHIO","CARROLL",6423,433,7097,13953
"2008","OHIO","CHAMPAIGN",7385,361,11141,18887
"2008","OHIO","CLARK",31958,1178,33634,66770
"2008","OHIO","CLERMONT",31611,1310,62559,95480
"2008","OHIO","CLINTON",6558,338,12410,19306
"2008","OHIO","COLUMBIANA",21882,1013,25585,48480
"2008","OHIO","COSHOCTON",7689,499,8675,16863
"2008","OHIO","CRAWFORD",8288,569,12316,21173
"2008","OHIO","CUYAHOGA",458204,7046,199864,665114
"2008","OHIO","DARKE",7964,539,17290,25793
"2008","OHIO","DEFIANCE",8399,391,10407,19197
"2008","OHIO","DELAWARE",36653,985,54778,92416
"2008","OHIO","ERIE",23148,649,17432,41229
"2008","OHIO","FAIRFIELD",29250,1116,41580,71946
"2008","OHIO","FAYETTE",4401,191,7102,11694
"2008","OHIO","FRANKLIN",334684,7129,218478,560291
"2008","OHIO","FULTON",9900,384,11689,21973
"2008","OHIO","GALLIA",4777,294,8247,13318
"2008","OHIO","GEAUGA",21250,756,29096,51102
"2008","OHIO","GREENE",33540,1113,48936,83589
"2008","OHIO","GUERNSEY",7625,503,9197,17325
"2008","OHIO","HAMILTON",224644,4331,195107,424082
"2008","OHIO","HANCOCK",13870,691,22420,36981
"2008","OHIO","HARDIN",5013,352,7749,13114
"2008","OHIO","HARRISON",3683,232,3872,7787
"2008","OHIO","HENRY",6320,281,8239,14840
"2008","OHIO","HIGHLAND",6857,423,11908,19188
"2008","OHIO","HOCKING",6231,338,6326,12895
"2008","OHIO","HOLMES",3141,252,7720,11113
"2008","OHIO","HURON",12076,622,12884,25582
"2008","OHIO","JACKSON",5397,377,8219,13993
"2008","OHIO","JEFFERSON",17635,745,17559,35939
"2008","OHIO","KNOX",11014,577,16640,28231
"2008","OHIO","LAKE",60155,2038,59142,121335
"2008","OHIO","LAWRENCE",11262,517,15415,27194
"2008","OHIO","LICKING",33896,1501,46886,82283
"2008","OHIO","LOGAN",7936,433,13848,22217
"2008","OHIO","LORAIN",85276,2515,59068,146859
"2008","OHIO","LUCAS",142852,3272,73706,219830
"2008","OHIO","MADISON",6532,316,10603,17451
"2008","OHIO","MAHONING",79173,2540,45319,127032
"2008","OHIO","MARION",12870,693,15454,29017
"2008","OHIO","MEDINA",40924,1338,48189,90451
"2008","OHIO","MEIGS",4094,245,6015,10354
"2008","OHIO","MERCER",5853,318,15100,21271
"2008","OHIO","MIAMI",18372,1018,33417,52807
"2008","OHIO","MONROE",3705,211,3066,6982
"2008","OHIO","MONTGOMERY",145997,3835,128679,278511
"2008","OHIO","MORGAN",2966,202,3440,6608
"2008","OHIO","MORROW",6177,399,10067,16643
"2008","OHIO","MUSKINGUM",17730,792,20549,39071
"2008","OHIO","NOBLE",2474,248,3450,6172
"2008","OHIO","OTTAWA",12049,402,10618,23069
"2008","OHIO","PAULDING",4165,287,5317,9769
"2008","OHIO","PERRY",7261,422,7721,15404
"2008","OHIO","PICKAWAY",9077,421,14228,23726
"2008","OHIO","PIKE",6033,311,6162,12506
"2008","OHIO","PORTAGE",41856,1527,34822,78205
"2008","OHIO","PREBLE",6999,441,13562,21002
"2008","OHIO","PUTNAM",5281,327,13072,18680
"2008","OHIO","RICHLAND",25727,1361,34034,61122
"2008","OHIO","ROSS",14455,626,16759,31840
"2008","OHIO","SANDUSKY",15601,582,14190,30373
"2008","OHIO","SCIOTO",14926,651,16994,32571
"2008","OHIO","SENECA",13087,539,13823,27449
"2008","OHIO","SHELBY",7317,427,15924,23668
"2008","OHIO","STARK",96990,3812,86743,187545
"2008","OHIO","SUMMIT",155105,3455,110499,269059
"2008","OHIO","TRUMBULL",64145,2579,40164,106888
"2008","OHIO","TUSCARAWAS",21498,998,20454,42950
"2008","OHIO","UNION",8761,423,15744,24928
"2008","OHIO","VAN WERT",5178,306,9168,14652
"2008","OHIO","VINTON",2463,162,3021,5646
"2008","OHIO","WARREN",33398,1127,71691,106216
"2008","OHIO","WASHINGTON",12368,545,17019,29932
"2008","OHIO","WAYNE",21712,1088,29342,52142
"2008","OHIO","WILLIAMS",8174,343,9880,18397
"2008","OHIO","WOOD",34285,1090,29648,65023
"2008","OHIO","WYANDOT",4461,246,6270,10977
"2008","OKLAHOMA","ADAIR",2052,0,4638,6690
"2008","OKLAHOMA","ALFALFA",411,0,2023,2434
"2008","OKLAHOMA","ATOKA",1370,0,3511,4881
"2008","OKLAHOMA","BEAVER",265,0,2199,2464
"2008","OKLAHOMA","BECKHAM",1625,0,5772,7397
"2008","OKLAHOMA","BLAINE",1011,0,3101,4112
"2008","OKLAHOMA","BRYAN",4426,0,9307,13733
"2008","OKLAHOMA","CADDO",3404,0,6413,9817
"2008","OKLAHOMA","CANADIAN",11426,0,36428,47854
"2008","OKLAHOMA","CARTER",5603,0,13241,18844
"2008","OKLAHOMA","CHEROKEE",7194,0,9186,16380
"2008","OKLAHOMA","CHOCTAW",1860,0,3730,5590
"2008","OKLAHOMA","CIMARRON",152,0,1119,1271
"2008","OKLAHOMA","CLEVELAND",39681,0,64749,104430
"2008","OKLAHOMA","COAL",600,0,1672,2272
"2008","OKLAHOMA","COMANCHE",14120,0,20127,34247
"2008","OKLAHOMA","COTTON",690,0,1793,2483
"2008","OKLAHOMA","CRAIG",2073,0,3858,5931
"2008","OKLAHOMA","CREEK",8318,0,20187,28505
"2008","OKLAHOMA","CUSTER",2660,0,7842,10502
"2008","OKLAHOMA","DELAWARE",5085,0,10277,15362
"2008","OKLAHOMA","DEWEY",346,0,1857,2203
"2008","OKLAHOMA","ELLIS",282,0,1627,1909
"2008","OKLAHOMA","GARFIELD",5545,0,17067,22612
"2008","OKLAHOMA","GARVIN",3028,0,7710,10738
"2008","OKLAHOMA","GRADY",5520,0,15195,20715
"2008","OKLAHOMA","GRANT",514,0,1836,2350
"2008","OKLAHOMA","GREER",566,0,1548,2114
"2008","OKLAHOMA","HARMON",333,0,757,1090
"2008","OKLAHOMA","HARPER",221,0,1342,1563
"2008","OKLAHOMA","HASKELL",1474,0,3207,4681
"2008","OKLAHOMA","HUGHES",1709,0,3134,4843
"2008","OKLAHOMA","JACKSON",2264,0,6719,8983
"2008","OKLAHOMA","JEFFERSON",805,0,1652,2457
"2008","OKLAHOMA","JOHNSTON",1249,0,2708,3957
"2008","OKLAHOMA","KAY",5463,0,13230,18693
"2008","OKLAHOMA","KINGFISHER",1009,0,5372,6381
"2008","OKLAHOMA","KIOWA",1226,0,2537,3763
"2008","OKLAHOMA","LATIMER",1313,0,2860,4173
"2008","OKLAHOMA","LE FLORE",5136,0,11605,16741
"2008","OKLAHOMA","LINCOLN",3504,0,10470,13974
"2008","OKLAHOMA","LOGAN",5717,0,12556,18273
"2008","OKLAHOMA","LOVE",1257,0,2589,3846
"2008","OKLAHOMA","MAJOR",515,0,2956,3471
"2008","OKLAHOMA","MARSHALL",1643,0,3730,5373
"2008","OKLAHOMA","MAYES",5749,0,10234,15983
"2008","OKLAHOMA","MCCLAIN",3551,0,11193,14744
"2008","OKLAHOMA","MCCURTAIN",2794,0,7745,10539
"2008","OKLAHOMA","MCINTOSH",3320,0,4903,8223
"2008","OKLAHOMA","MURRAY",1592,0,3746,5338
"2008","OKLAHOMA","MUSKOGEE",11294,0,15289,26583
"2008","OKLAHOMA","NOBLE",1174,0,3881,5055
"2008","OKLAHOMA","NOWATA",1411,0,3031,4442
"2008","OKLAHOMA","OKFUSKEE",1480,0,2643,4123
"2008","OKLAHOMA","OKLAHOMA",116182,0,163172,279354
"2008","OKLAHOMA","OKMULGEE",6191,0,8727,14918
"2008","OKLAHOMA","OSAGE",7498,0,12160,19658
"2008","OKLAHOMA","OTTAWA",4268,0,6905,11173
"2008","OKLAHOMA","PAWNEE",2063,0,4533,6596
"2008","OKLAHOMA","PAYNE",10601,0,18435,29036
"2008","OKLAHOMA","PITTSBURG",5457,0,11752,17209
"2008","OKLAHOMA","PONTOTOC",4512,0,9750,14262
"2008","OKLAHOMA","POTTAWATOMIE",7910,0,17753,25663
"2008","OKLAHOMA","PUSHMATAHA",1265,0,3208,4473
"2008","OKLAHOMA","ROGER MILLS",287,0,1502,1789
"2008","OKLAHOMA","ROGERS",10772,0,27743,38515
"2008","OKLAHOMA","SEMINOLE",2977,0,5600,8577
"2008","OKLAHOMA","SEQUOYAH",4454,0,9466,13920
"2008","OKLAHOMA","STEPHENS",4538,0,14394,18932
"2008","OKLAHOMA","TEXAS",923,0,5336,6259
"2008","OKLAHOMA","TILLMAN",1042,0,2195,3237
"2008","OKLAHOMA","TULSA",96133,0,158363,254496
"2008","OKLAHOMA","WAGONER",8810,0,21441,30251
"2008","OKLAHOMA","WASHINGTON",6308,0,16457,22765
"2008","OKLAHOMA","WASHITA",1052,0,3724,4776
"2008","OKLAHOMA","WOODS",873,0,3043,3916
"2008","OKLAHOMA","WOODWARD",1350,0,6404,7754
"2008","OREGON","BAKER",2805,322,5650,8777
"2008","OREGON","BENTON",29901,1313,15264,46478
"2008","OREGON","CLACKAMAS",103476,4807,83595,191878
"2008","OREGON","CLATSOP",10701,655,7192,18548
"2008","OREGON","COLUMBIA",13390,965,10413,24768
"2008","OREGON","COOS",14401,1196,15354,30951
"2008","OREGON","CROOK",3632,349,6371,10352
"2008","OREGON","CURRY",5230,456,6646,12332
"2008","OREGON","DESCHUTES",38819,1899,39064,79782
"2008","OREGON","DOUGLAS",20298,1720,30919,52937
"2008","OREGON","GILLIAM",430,32,648,1110
"2008","OREGON","GRANT",1006,118,2785,3909
"2008","OREGON","HARNEY",950,138,2595,3683
"2008","OREGON","HOOD RIVER",6302,263,3265,9830
"2008","OREGON","JACKSON",49090,2914,49043,101047
"2008","OREGON","JEFFERSON",3682,234,4402,8318
"2008","OREGON","JOSEPHINE",17412,1664,22973,42049
"2008","OREGON","KLAMATH",9370,916,19113,29399
"2008","OREGON","LAKE",957,93,2638,3688
"2008","OREGON","LANE",114037,5038,63835,182910
"2008","OREGON","LINCOLN",14258,840,8791,23889
"2008","OREGON","LINN",22163,1748,28071,51982
"2008","OREGON","MALHEUR",2949,327,7157,10433
"2008","OREGON","MARION",61816,3688,59059,124563
"2008","OREGON","MORROW",1410,139,2509,4058
"2008","OREGON","MULTNOMAH",279696,9843,75171,364710
"2008","OREGON","POLK",17536,957,17714,36207
"2008","OREGON","SHERMAN",385,28,634,1047
"2008","OREGON","TILLAMOOK",7072,468,5757,13297
"2008","OREGON","UMATILLA",9484,785,15254,25523
"2008","OREGON","UNION",4613,400,7581,12594
"2008","OREGON","WALLOWA",1492,137,2836,4465
"2008","OREGON","WASCO",5906,371,5103,11380
"2008","OREGON","WASHINGTON",141544,5903,89185,236632
"2008","OREGON","WHEELER",281,33,498,812
"2008","OREGON","YAMHILL",20797,1339,21390,43526
"2008","PENNSYLVANIA","ADAMS",17633,507,26349,44489
"2008","PENNSYLVANIA","ALLEGHENY",373153,5880,272347,651380
"2008","PENNSYLVANIA","ARMSTRONG",11138,392,18542,30072
"2008","PENNSYLVANIA","BEAVER",40499,1069,42895,84463
"2008","PENNSYLVANIA","BEDFORD",6059,258,16124,22441
"2008","PENNSYLVANIA","BERKS",97047,2336,80513,179896
"2008","PENNSYLVANIA","BLAIR",19813,560,32708,53081
"2008","PENNSYLVANIA","BRADFORD",10306,419,15057,25782
"2008","PENNSYLVANIA","BUCKS",179031,3644,150248,332923
"2008","PENNSYLVANIA","BUTLER",32260,1021,57074,90355
"2008","PENNSYLVANIA","CAMBRIA",32451,1176,31995,65622
"2008","PENNSYLVANIA","CAMERON",879,109,1323,2311
"2008","PENNSYLVANIA","CARBON",13464,498,12957,26919
"2008","PENNSYLVANIA","CENTRE",41950,795,32992,75737
"2008","PENNSYLVANIA","CHESTER",137833,2051,114421,254305
"2008","PENNSYLVANIA","CLARION",6756,272,10737,17765
"2008","PENNSYLVANIA","CLEARFIELD",14555,557,18662,33774
"2008","PENNSYLVANIA","CLINTON",7097,192,7504,14793
"2008","PENNSYLVANIA","COLUMBIA",13230,334,14477,28041
"2008","PENNSYLVANIA","CRAWFORD",16780,544,20750,38074
"2008","PENNSYLVANIA","CUMBERLAND",48306,1253,63739,113298
"2008","PENNSYLVANIA","DAUPHIN",69975,1313,58238,129526
"2008","PENNSYLVANIA","DELAWARE",169030,2730,109322,281082
"2008","PENNSYLVANIA","ELK",7290,292,6676,14258
"2008","PENNSYLVANIA","ERIE",75775,1516,50351,127642
"2008","PENNSYLVANIA","FAYETTE",25866,607,26081,52554
"2008","PENNSYLVANIA","FOREST",1038,40,1366,2444
"2008","PENNSYLVANIA","FRANKLIN",21169,560,41906,63635
"2008","PENNSYLVANIA","FULTON",1576,88,4642,6306
"2008","PENNSYLVANIA","GREENE",7829,243,7889,15961
"2008","PENNSYLVANIA","HUNTINGDON",6621,280,11745,18646
"2008","PENNSYLVANIA","INDIANA",17065,507,19727,37299
"2008","PENNSYLVANIA","JEFFERSON",6447,297,12057,18801
"2008","PENNSYLVANIA","JUNIATA",3068,159,6484,9711
"2008","PENNSYLVANIA","LACKAWANNA",67520,858,39488,107866
"2008","PENNSYLVANIA","LANCASTER",99586,1943,126568,228097
"2008","PENNSYLVANIA","LAWRENCE",19711,522,21851,42084
"2008","PENNSYLVANIA","LEBANON",23310,628,34314,58252
"2008","PENNSYLVANIA","LEHIGH",87089,1993,63382,152464
"2008","PENNSYLVANIA","LUZERNE",72492,1544,61127,135163
"2008","PENNSYLVANIA","LYCOMING",18381,574,30280,49235
"2008","PENNSYLVANIA","MCKEAN",6465,258,9224,15947
"2008","PENNSYLVANIA","MERCER",26411,820,26565,53796
"2008","PENNSYLVANIA","MIFFLIN",5375,197,10929,16501
"2008","PENNSYLVANIA","MONROE",39453,639,28293,68385
"2008","PENNSYLVANIA","MONTGOMERY",253393,3466,165552,422411
"2008","PENNSYLVANIA","MONTOUR",3364,85,4574,8023
"2008","PENNSYLVANIA","NORTHAMPTON",75255,1775,58551,135581
"2008","PENNSYLVANIA","NORTHUMBERLAND",14329,569,19018,33916
"2008","PENNSYLVANIA","PERRY",6396,279,13058,19733
"2008","PENNSYLVANIA","PHILADELPHIA",595980,3954,117221,717155
"2008","PENNSYLVANIA","PIKE",11493,286,12518,24297
"2008","PENNSYLVANIA","POTTER",2300,98,5109,7507
"2008","PENNSYLVANIA","SCHUYLKILL",28300,987,33767,63054
"2008","PENNSYLVANIA","SNYDER",5382,197,9900,15479
"2008","PENNSYLVANIA","SOMERSET",12878,603,21686,35167
"2008","PENNSYLVANIA","SULLIVAN",1233,46,1841,3120
"2008","PENNSYLVANIA","SUSQUEHANNA",8381,269,10633,19283
"2008","PENNSYLVANIA","TIOGA",6390,249,11326,17965
"2008","PENNSYLVANIA","UNION",7333,208,9859,17400
"2008","PENNSYLVANIA","VENANGO",9238,332,13718,23288
"2008","PENNSYLVANIA","WARREN",8537,272,9685,18494
"2008","PENNSYLVANIA","WASHINGTON",46122,1128,50752,98002
"2008","PENNSYLVANIA","WAYNE",9892,239,12702,22833
"2008","PENNSYLVANIA","WESTMORELAND",72721,1770,102294,176785
"2008","PENNSYLVANIA","WYOMING",5985,161,6983,13129
"2008","PENNSYLVANIA","YORK",82839,2076,109268,194183
"2008","RHODE ISLAND","BRISTOL",16162,483,9260,25905
"2008","RHODE ISLAND","FEDERAL PRECINCT",0,0,0,0
"2008","RHODE ISLAND","KENT",48406,1888,33780,84074
"2008","RHODE ISLAND","NEWPORT",25479,801,15717,41997
"2008","RHODE ISLAND","PROVIDENCE",167442,5178,81010,253630
"2008","RHODE ISLAND","WASHINGTON",39082,1454,25624,66160
"2008","SOUTH CAROLINA","ABBEVILLE",4593,144,6264,11001
"2008","SOUTH CAROLINA","AIKEN",26101,820,42849,69770
"2008","SOUTH CAROLINA","ALLENDALE",3029,48,947,4024
"2008","SOUTH CAROLINA","ANDERSON",24132,965,48690,73787
"2008","SOUTH CAROLINA","BAMBERG",4426,79,2309,6814
"2008","SOUTH CAROLINA","BARNWELL",4931,98,4769,9798
"2008","SOUTH CAROLINA","BEAUFORT",30396,653,37821,68870
"2008","SOUTH CAROLINA","BERKELEY",27755,821,36205,64781
"2008","SOUTH CAROLINA","CALHOUN",3970,73,3695,7738
"2008","SOUTH CAROLINA","CHARLESTON",82698,1914,69822,154434
"2008","SOUTH CAROLINA","CHEROKEE",7215,246,13305,20766
"2008","SOUTH CAROLINA","CHESTER",7478,185,6318,13981
"2008","SOUTH CAROLINA","CHESTERFIELD",7842,192,8325,16359
"2008","SOUTH CAROLINA","CLARENDON",8673,121,6758,15552
"2008","SOUTH CAROLINA","COLLETON",8616,180,8525,17321
"2008","SOUTH CAROLINA","DARLINGTON",14505,285,14544,29334
"2008","SOUTH CAROLINA","DILLON",7408,135,5874,13417
"2008","SOUTH CAROLINA","DORCHESTER",21806,670,29929,52405
"2008","SOUTH CAROLINA","EDGEFIELD",5075,111,6334,11520
"2008","SOUTH CAROLINA","FAIRFIELD",7591,116,3912,11619
"2008","SOUTH CAROLINA","FLORENCE",28012,500,29861,58373
"2008","SOUTH CAROLINA","GEORGETOWN",14199,301,15790,30290
"2008","SOUTH CAROLINA","GREENVILLE",70886,3408,116363,190657
"2008","SOUTH CAROLINA","GREENWOOD",12348,324,16995,29667
"2008","SOUTH CAROLINA","HAMPTON",5816,95,3439,9350
"2008","SOUTH CAROLINA","HORRY",38879,1310,64609,104798
"2008","SOUTH CAROLINA","JASPER",5389,100,3365,8854
"2008","SOUTH CAROLINA","KERSHAW",11226,293,16466,27985
"2008","SOUTH CAROLINA","LANCASTER",12139,341,16441,28921
"2008","SOUTH CAROLINA","LAURENS",10578,370,15334,26282
"2008","SOUTH CAROLINA","LEE",5960,119,3074,9153
"2008","SOUTH CAROLINA","LEXINGTON",33303,1249,74960,109512
"2008","SOUTH CAROLINA","MARION",9608,150,5416,15174
"2008","SOUTH CAROLINA","MARLBORO",6794,86,3996,10876
"2008","SOUTH CAROLINA","MCCORMICK",2755,40,2437,5232
"2008","SOUTH CAROLINA","NEWBERRY",6708,200,9616,16524
"2008","SOUTH CAROLINA","OCONEE",9481,487,21164,31132
"2008","SOUTH CAROLINA","ORANGEBURG",27263,376,12115,39754
"2008","SOUTH CAROLINA","PICKENS",11691,885,32552,45128
"2008","SOUTH CAROLINA","RICHLAND",105656,1440,57941,165037
"2008","SOUTH CAROLINA","SALUDA",3323,89,5191,8603
"2008","SOUTH CAROLINA","SPARTANBURG",41632,1654,65042,108328
"2008","SOUTH CAROLINA","SUMTER",25431,346,18581,44358
"2008","SOUTH CAROLINA","UNION",5935,167,7449,13551
"2008","SOUTH CAROLINA","WILLIAMSBURG",11279,160,5004,16443
"2008","SOUTH CAROLINA","YORK",37918,1278,54500,93696
"2008","SOUTH DAKOTA","AURORA",655,19,794,1468
"2008","SOUTH DAKOTA","BEADLE",3493,83,4054,7630
"2008","SOUTH DAKOTA","BENNETT",557,18,614,1189
"2008","SOUTH DAKOTA","BON HOMME",1367,37,1712,3116
"2008","SOUTH DAKOTA","BROOKINGS",7207,151,6431,13789
"2008","SOUTH DAKOTA","BROWN",9041,145,8067,17253
"2008","SOUTH DAKOTA","BRULE",965,34,1407,2406
"2008","SOUTH DAKOTA","BUFFALO",454,2,156,612
"2008","SOUTH DAKOTA","BUTTE",1306,78,2821,4205
"2008","SOUTH DAKOTA","CAMPBELL",243,10,591,844
"2008","SOUTH DAKOTA","CHARLES MIX",1807,21,2109,3937
"2008","SOUTH DAKOTA","CLARK",830,25,1065,1920
"2008","SOUTH DAKOTA","CLAY",3808,55,2296,6159
"2008","SOUTH DAKOTA","CODINGTON",5595,107,6374,12076
"2008","SOUTH DAKOTA","CORSON",837,18,535,1390
"2008","SOUTH DAKOTA","CUSTER",1475,66,2909,4450
"2008","SOUTH DAKOTA","DAVISON",3554,80,4731,8365
"2008","SOUTH DAKOTA","DAY",1785,21,1372,3178
"2008","SOUTH DAKOTA","DEUEL",1054,36,1088,2178
"2008","SOUTH DAKOTA","DEWEY",1328,18,659,2005
"2008","SOUTH DAKOTA","DOUGLAS",424,18,1293,1735
"2008","SOUTH DAKOTA","EDMUNDS",819,21,1213,2053
"2008","SOUTH DAKOTA","FALL RIVER",1338,69,2348,3755
"2008","SOUTH DAKOTA","FAULK",426,9,739,1174
"2008","SOUTH DAKOTA","GRANT",1786,37,1951,3774
"2008","SOUTH DAKOTA","GREGORY",771,24,1423,2218
"2008","SOUTH DAKOTA","HAAKON",187,15,939,1141
"2008","SOUTH DAKOTA","HAMLIN",1043,33,1661,2737
"2008","SOUTH DAKOTA","HAND",718,16,1247,1981
"2008","SOUTH DAKOTA","HANSON",961,27,1426,2414
"2008","SOUTH DAKOTA","HARDING",135,12,575,722
"2008","SOUTH DAKOTA","HUGHES",3037,51,5298,8386
"2008","SOUTH DAKOTA","HUTCHINSON",1242,34,2285,3561
"2008","SOUTH DAKOTA","HYDE",226,3,547,776
"2008","SOUTH DAKOTA","JACKSON",435,15,668,1118
"2008","SOUTH DAKOTA","JERAULD",542,4,546,1092
"2008","SOUTH DAKOTA","JONES",147,8,463,618
"2008","SOUTH DAKOTA","KINGSBURY",1277,27,1435,2739
"2008","SOUTH DAKOTA","LAKE",3033,50,2993,6076
"2008","SOUTH DAKOTA","LAWRENCE",4932,157,6787,11876
"2008","SOUTH DAKOTA","LINCOLN",8642,156,11803,20601
"2008","SOUTH DAKOTA","LYMAN",710,19,894,1623
"2008","SOUTH DAKOTA","MARSHALL",1261,16,900,2177
"2008","SOUTH DAKOTA","MCCOOK",1219,40,1646,2905
"2008","SOUTH DAKOTA","MCPHERSON",441,8,915,1364
"2008","SOUTH DAKOTA","MEADE",3751,199,7515,11465
"2008","SOUTH DAKOTA","MELLETTE",373,11,445,829
"2008","SOUTH DAKOTA","MINER",605,16,577,1198
"2008","SOUTH DAKOTA","MINNEHAHA",39838,709,39251,79798
"2008","SOUTH DAKOTA","MOODY",1663,32,1508,3203
"2008","SOUTH DAKOTA","PENNINGTON",17802,382,27603,45787
"2008","SOUTH DAKOTA","PERKINS",499,55,1102,1656
"2008","SOUTH DAKOTA","POTTER",482,15,937,1434
"2008","SOUTH DAKOTA","ROBERTS",2672,31,1781,4484
"2008","SOUTH DAKOTA","SANBORN",500,12,669,1181
"2008","SOUTH DAKOTA","SHANNON",2971,12,331,3314
"2008","SOUTH DAKOTA","SPINK",1550,29,1660,3239
"2008","SOUTH DAKOTA","STANLEY",510,13,1017,1540
"2008","SOUTH DAKOTA","SULLY",233,9,581,823
"2008","SOUTH DAKOTA","TODD",2208,28,571,2807
"2008","SOUTH DAKOTA","TRIPP",914,36,1859,2809
"2008","SOUTH DAKOTA","TURNER",1681,47,2538,4266
"2008","SOUTH DAKOTA","UNION",3244,66,4310,7620
"2008","SOUTH DAKOTA","WALWORTH",923,29,1668,2620
"2008","SOUTH DAKOTA","YANKTON",4838,90,5039,9967
"2008","SOUTH DAKOTA","ZIEBACH",554,16,312,882
"2008","TENNESSEE","ANDERSON",11396,499,19675,31570
"2008","TENNESSEE","BEDFORD",5027,263,10217,15507
"2008","TENNESSEE","BENTON",2645,138,3696,6479
"2008","TENNESSEE","BLEDSOE",1517,101,3166,4784
"2008","TENNESSEE","BLOUNT",15253,821,35571,51645
"2008","TENNESSEE","BRADLEY",9357,501,28333,38191
"2008","TENNESSEE","CAMPBELL",3867,226,8535,12628
"2008","TENNESSEE","CANNON",2011,124,3322,5457
"2008","TENNESSEE","CARROLL",3980,211,7455,11646
"2008","TENNESSEE","CARTER",5587,330,15852,21769
"2008","TENNESSEE","CHEATHAM",5498,228,10702,16428
"2008","TENNESSEE","CHESTER",1797,75,4587,6459
"2008","TENNESSEE","CLAIBORNE",3078,167,7175,10420
"2008","TENNESSEE","CLAY",1248,70,1676,2994
"2008","TENNESSEE","COCKE",3340,196,8945,12481
"2008","TENNESSEE","COFFEE",7132,408,13250,20790
"2008","TENNESSEE","CROCKETT",1967,76,3994,6037
"2008","TENNESSEE","CUMBERLAND",7889,387,17436,25712
"2008","TENNESSEE","DAVIDSON",158423,3148,102915,264486
"2008","TENNESSEE","DECATUR",1566,96,3101,4763
"2008","TENNESSEE","DEKALB",2832,148,4085,7065
"2008","TENNESSEE","DICKSON",7506,336,11677,19519
"2008","TENNESSEE","DYER",4411,180,9859,14450
"2008","TENNESSEE","FAYETTE",6892,189,12173,19254
"2008","TENNESSEE","FENTRESS",1831,119,4789,6739
"2008","TENNESSEE","FRANKLIN",6613,280,10539,17432
"2008","TENNESSEE","GIBSON",7406,331,13516,21253
"2008","TENNESSEE","GILES",4614,173,6902,11689
"2008","TENNESSEE","GRAINGER",2066,140,5297,7503
"2008","TENNESSEE","GREENE",7110,409,17151,24670
"2008","TENNESSEE","GRUNDY",1971,98,2563,4632
"2008","TENNESSEE","HAMBLEN",6807,354,15508,22669
"2008","TENNESSEE","HAMILTON",64246,1572,81702,147520
"2008","TENNESSEE","HANCOCK",604,49,1588,2241
"2008","TENNESSEE","HARDEMAN",5919,93,5225,11237
"2008","TENNESSEE","HARDIN",2794,164,7077,10035
"2008","TENNESSEE","HAWKINS",5930,354,14756,21040
"2008","TENNESSEE","HAYWOOD",4893,63,3165,8121
"2008","TENNESSEE","HENDERSON",3021,144,7669,10834
"2008","TENNESSEE","HENRY",5153,210,8182,13545
"2008","TENNESSEE","HICKMAN",3563,151,4784,8498
"2008","TENNESSEE","HOUSTON",1678,68,1608,3354
"2008","TENNESSEE","HUMPHREYS",3600,162,3818,7580
"2008","TENNESSEE","JACKSON",2224,92,2185,4501
"2008","TENNESSEE","JEFFERSON",5178,262,13092,18532
"2008","TENNESSEE","JOHNSON",1837,133,4621,6591
"2008","TENNESSEE","KNOX",70215,2856,113015,186086
"2008","TENNESSEE","LAKE",1024,39,1175,2238
"2008","TENNESSEE","LAUDERDALE",4322,83,4933,9338
"2008","TENNESSEE","LAWRENCE",5161,293,10566,16020
"2008","TENNESSEE","LEWIS",1804,79,2951,4834
"2008","TENNESSEE","LINCOLN",3695,204,9231,13130
"2008","TENNESSEE","LOUDON",6058,311,15815,22184
"2008","TENNESSEE","MACON",2060,155,5145,7360
"2008","TENNESSEE","MADISON",20209,347,23290,43846
"2008","TENNESSEE","MARION",4506,185,6746,11437
"2008","TENNESSEE","MARSHALL",4320,214,6755,11289
"2008","TENNESSEE","MAURY",13058,421,20288,33767
"2008","TENNESSEE","MCMINN",5541,259,12989,18789
"2008","TENNESSEE","MCNAIRY",3131,156,7135,10422
"2008","TENNESSEE","MEIGS",1372,68,2797,4237
"2008","TENNESSEE","MONROE",5053,240,11484,16777
"2008","TENNESSEE","MONTGOMERY",25716,627,30175,56518
"2008","TENNESSEE","MOORE",881,61,2010,2952
"2008","TENNESSEE","MORGAN",1969,136,4717,6822
"2008","TENNESSEE","OBION",4308,211,8873,13392
"2008","TENNESSEE","OVERTON",3419,176,4497,8092
"2008","TENNESSEE","PERRY",1329,75,1596,3000
"2008","TENNESSEE","PICKETT",854,31,1786,2671
"2008","TENNESSEE","POLK",2124,110,4267,6501
"2008","TENNESSEE","PUTNAM",9739,476,17101,27316
"2008","TENNESSEE","RHEA",2907,157,8042,11106
"2008","TENNESSEE","ROANE",7224,394,15658,23276
"2008","TENNESSEE","ROBERTSON",9318,393,17903,27614
"2008","TENNESSEE","RUTHERFORD",40460,1385,59892,101737
"2008","TENNESSEE","SCOTT",1720,132,4931,6783
"2008","TENNESSEE","SEQUATCHIE",1717,110,3610,5437
"2008","TENNESSEE","SEVIER",8604,415,24922,33941
"2008","TENNESSEE","SHELBY",256297,2800,145458,404555
"2008","TENNESSEE","SMITH",2992,186,4563,7741
"2008","TENNESSEE","STEWART",2470,81,2956,5507
"2008","TENNESSEE","SULLIVAN",18354,835,44808,63997
"2008","TENNESSEE","SUMNER",21487,792,44949,67228
"2008","TENNESSEE","TIPTON",7931,220,17165,25316
"2008","TENNESSEE","TROUSDALE",1475,76,1688,3239
"2008","TENNESSEE","UNICOI",2107,105,5011,7223
"2008","TENNESSEE","UNION",1829,103,4467,6399
"2008","TENNESSEE","VAN BUREN",849,63,1294,2206
"2008","TENNESSEE","WARREN",5515,323,8562,14400
"2008","TENNESSEE","WASHINGTON",15941,700,32341,48982
"2008","TENNESSEE","WAYNE",1355,96,4076,5527
"2008","TENNESSEE","WEAKLEY",4596,239,8855,13690
"2008","TENNESSEE","WHITE",3372,172,6103,9647
"2008","TENNESSEE","WILLIAMSON",27886,902,64858,93646
"2008","TENNESSEE","WILSON",15886,678,34595,51159
"2008","TEXAS","ANDERSON",4630,141,11884,16655
"2008","TEXAS","ANDREWS",790,23,3816,4629
"2008","TEXAS","ANGELINA",9379,205,19569,29153
"2008","TEXAS","ARANSAS",3006,79,6693,9778
"2008","TEXAS","ARCHER",740,30,3595,4365
"2008","TEXAS","ARMSTRONG",128,6,856,990
"2008","TEXAS","ATASCOSA",4415,61,5462,9938
"2008","TEXAS","AUSTIN",2821,114,8786,11721
"2008","TEXAS","BAILEY",682,16,1618,2316
"2008","TEXAS","BANDERA",2250,112,6935,9297
"2008","TEXAS","BASTROP",11687,414,13817,25918
"2008","TEXAS","BAYLOR",366,15,1262,1643
"2008","TEXAS","BEE",3645,41,4471,8157
"2008","TEXAS","BELL",40413,679,49242,90334
"2008","TEXAS","BEXAR",275527,3913,246275,525715
"2008","TEXAS","BLANCO",1467,54,3418,4939
"2008","TEXAS","BORDEN",40,5,316,361
"2008","TEXAS","BOSQUE",1797,87,5762,7646
"2008","TEXAS","BOWIE",10815,209,24162,35186
"2008","TEXAS","BRAZORIA",36480,945,67515,104940
"2008","TEXAS","BRAZOS",20502,706,37465,58673
"2008","TEXAS","BREWSTER",1970,75,1855,3900
"2008","TEXAS","BRISCOE",205,8,617,830
"2008","TEXAS","BROOKS",1747,6,556,2309
"2008","TEXAS","BROWN",2822,141,12052,15015
"2008","TEXAS","BURLESON",2053,65,4547,6665
"2008","TEXAS","BURNET",4608,226,12059,16893
"2008","TEXAS","CALDWELL",5403,138,6107,11648
"2008","TEXAS","CALHOUN",2729,44,4106,6879
"2008","TEXAS","CALLAHAN",1063,64,4589,5716
"2008","TEXAS","CAMERON",48480,506,26671,75657
"2008","TEXAS","CAMP",1734,35,2798,4567
"2008","TEXAS","CARSON",406,26,2548,2980
"2008","TEXAS","CASS",3490,77,8279,11846
"2008","TEXAS","CASTRO",719,10,1562,2291
"2008","TEXAS","CHAMBERS",3188,116,9988,13292
"2008","TEXAS","CHEROKEE",4610,112,11695,16417
"2008","TEXAS","CHILDRESS",497,17,1782,2296
"2008","TEXAS","CLAY",1085,41,4213,5339
"2008","TEXAS","COCHRAN",284,15,758,1057
"2008","TEXAS","COKE",299,18,1252,1569
"2008","TEXAS","COLEMAN",643,48,3011,3702
"2008","TEXAS","COLLIN",109047,2639,184897,296583
"2008","TEXAS","COLLINGSWORTH",234,18,943,1195
"2008","TEXAS","COLORADO",2508,50,5795,8353
"2008","TEXAS","COMAL",12384,541,35233,48158
"2008","TEXAS","COMANCHE",1334,70,3813,5217
"2008","TEXAS","CONCHO",257,13,807,1077
"2008","TEXAS","COOKE",3051,110,11871,15032
"2008","TEXAS","CORYELL",6619,163,11550,18332
"2008","TEXAS","COTTLE",187,9,509,705
"2008","TEXAS","CRANE",319,16,1119,1454
"2008","TEXAS","CROCKETT",512,7,1026,1545
"2008","TEXAS","CROSBY",684,9,1221,1914
"2008","TEXAS","CULBERSON",492,10,257,759
"2008","TEXAS","DALLAM",302,18,1269,1589
"2008","TEXAS","DALLAS",422989,5474,310000,738463
"2008","TEXAS","DAWSON",1152,38,2906,4096
"2008","TEXAS","DEAF SMITH",1247,31,3466,4744
"2008","TEXAS","DELTA",589,18,1580,2187
"2008","TEXAS","DENTON",91160,2168,149935,243263
"2008","TEXAS","DEWITT",1716,22,4888,6626
"2008","TEXAS","DICKENS",234,8,730,972
"2008","TEXAS","DIMMIT",2692,21,874,3587
"2008","TEXAS","DONLEY",291,25,1374,1690
"2008","TEXAS","DUVAL",3298,35,1076,4409
"2008","TEXAS","EASTLAND",1271,73,5165,6509
"2008","TEXAS","ECTOR",9123,284,26199,35606
"2008","TEXAS","EDWARDS",346,16,673,1035
"2008","TEXAS","EL PASO",122021,1429,61783,185233
"2008","TEXAS","ELLIS",15333,442,38078,53853
"2008","TEXAS","ERATH",3128,123,10768,14019
"2008","TEXAS","FALLS",2225,46,3328,5599
"2008","TEXAS","FANNIN",3464,138,8092,11694
"2008","TEXAS","FAYETTE",3014,118,7582,10714
"2008","TEXAS","FISHER",687,14,1083,1784
"2008","TEXAS","FLOYD",730,7,1784,2521
"2008","TEXAS","FOARD",198,13,327,538
"2008","TEXAS","FORT BEND",98368,1248,103206,202822
"2008","TEXAS","FRANKLIN",1036,63,3392,4491
"2008","TEXAS","FREESTONE",2034,49,5205,7288
"2008","TEXAS","FRIO",2405,13,1644,4062
"2008","TEXAS","GAINES",650,32,3385,4067
"2008","TEXAS","GALVESTON",41805,941,62258,105004
"2008","TEXAS","GARZA",375,19,1356,1750
"2008","TEXAS","GILLESPIE",2576,199,9563,12338
"2008","TEXAS","GLASSCOCK",52,3,502,557
"2008","TEXAS","GOLIAD",1329,28,2298,3655
"2008","TEXAS","GONZALES",2167,44,4076,6287
"2008","TEXAS","GRAY",1153,56,6924,8133
"2008","TEXAS","GRAYSON",13900,441,31136,45477
"2008","TEXAS","GREGG",13166,241,29203,42610
"2008","TEXAS","GRIMES",2704,56,5562,8322
"2008","TEXAS","GUADALUPE",16156,436,30869,47461
"2008","TEXAS","HALE",2708,64,7171,9943
"2008","TEXAS","HALL",324,10,930,1264
"2008","TEXAS","HAMILTON",863,39,2876,3778
"2008","TEXAS","HANSFORD",240,15,1847,2102
"2008","TEXAS","HARDEMAN",373,23,1199,1595
"2008","TEXAS","HARDIN",3939,160,16603,20702
"2008","TEXAS","HARRIS",590982,8607,571883,1171472
"2008","TEXAS","HARRISON",8887,168,17103,26158
"2008","TEXAS","HARTLEY",250,24,1711,1985
"2008","TEXAS","HASKELL",699,29,1388,2116
"2008","TEXAS","HAYS",28431,983,29638,59052
"2008","TEXAS","HEMPHILL",216,9,1345,1570
"2008","TEXAS","HENDERSON",7913,223,20857,28993
"2008","TEXAS","HIDALGO",90261,855,39668,130784
"2008","TEXAS","HILL",3811,113,9264,13188
"2008","TEXAS","HOCKLEY",1797,53,5795,7645
"2008","TEXAS","HOOD",5087,210,17299,22596
"2008","TEXAS","HOPKINS",3530,90,9299,12919
"2008","TEXAS","HOUSTON",2656,96,5872,8624
"2008","TEXAS","HOWARD",2545,115,7029,9689
"2008","TEXAS","HUDSPETH",430,10,458,898
"2008","TEXAS","HUNT",8594,357,20573,29524
"2008","TEXAS","HUTCHINSON",1322,78,7361,8761
"2008","TEXAS","IRION",164,9,644,817
"2008","TEXAS","JACK",470,25,2528,3023
"2008","TEXAS","JACKSON",1301,33,3723,5057
"2008","TEXAS","JASPER",3658,96,9022,12776
"2008","TEXAS","JEFF DAVIS",468,19,749,1236
"2008","TEXAS","JEFFERSON",44888,503,42905,88296
"2008","TEXAS","JIM HOGG",1336,7,472,1815
"2008","TEXAS","JIM WELLS",6706,65,4841,11612
"2008","TEXAS","JOHNSON",12912,453,36685,50050
"2008","TEXAS","JONES",1528,77,4203,5808
"2008","TEXAS","KARNES",1760,31,2736,4527
"2008","TEXAS","KAUFMAN",11161,249,23735,35145
"2008","TEXAS","KENDALL",3599,176,12971,16746
"2008","TEXAS","KENEDY",108,0,94,202
"2008","TEXAS","KENT",99,7,342,448
"2008","TEXAS","KERR",5570,234,16752,22556
"2008","TEXAS","KIMBLE",342,14,1487,1843
"2008","TEXAS","KING",8,4,151,163
"2008","TEXAS","KINNEY",633,11,907,1551
"2008","TEXAS","KLEBERG",5256,80,4540,9876
"2008","TEXAS","KNOX",367,15,986,1368
"2008","TEXAS","LA SALLE",1052,10,714,1776
"2008","TEXAS","LAMAR",5243,167,12952,18362
"2008","TEXAS","LAMB",1156,25,3344,4525
"2008","TEXAS","LAMPASAS",1903,80,5651,7634
"2008","TEXAS","LAVACA",1869,61,6293,8223
"2008","TEXAS","LEE",2000,65,4312,6377
"2008","TEXAS","LEON",1418,57,5566,7041
"2008","TEXAS","LIBERTY",5991,187,15448,21626
"2008","TEXAS","LIMESTONE",2516,57,5079,7652
"2008","TEXAS","LIPSCOMB",155,8,1093,1256
"2008","TEXAS","LIVE OAK",1048,33,3095,4176
"2008","TEXAS","LLANO",2250,98,7281,9629
"2008","TEXAS","LOVING",12,0,67,79
"2008","TEXAS","LUBBOCK",30486,744,66304,97534
"2008","TEXAS","LYNN",627,16,1473,2116
"2008","TEXAS","MADISON",1146,37,2891,4074
"2008","TEXAS","MARION",1644,41,2567,4252
"2008","TEXAS","MARTIN",314,12,1389,1715
"2008","TEXAS","MASON",546,31,1544,2121
"2008","TEXAS","MATAGORDA",4440,98,7835,12373
"2008","TEXAS","MAVERICK",8554,69,2316,10939
"2008","TEXAS","MCCULLOCH",728,19,2263,3010
"2008","TEXAS","MCLENNAN",29998,632,49044,79674
"2008","TEXAS","MCMULLEN",132,5,400,537
"2008","TEXAS","MEDINA",5147,110,10480,15737
"2008","TEXAS","MENARD",295,11,712,1018
"2008","TEXAS","MIDLAND",9691,370,36155,46216
"2008","TEXAS","MILAM",3044,96,5217,8357
"2008","TEXAS","MILLS",398,26,1753,2177
"2008","TEXAS","MITCHELL",586,30,1815,2431
"2008","TEXAS","MONTAGUE",1597,108,6245,7950
"2008","TEXAS","MONTGOMERY",36703,1260,119884,157847
"2008","TEXAS","MOORE",1123,32,4282,5437
"2008","TEXAS","MORRIS",2055,35,3158,5248
"2008","TEXAS","MOTLEY",67,5,522,594
"2008","TEXAS","NACOGDOCHES",8393,170,14828,23391
"2008","TEXAS","NAVARRO",5400,111,10810,16321
"2008","TEXAS","NEWTON",1751,63,3446,5260
"2008","TEXAS","NOLAN",1521,57,3485,5063
"2008","TEXAS","NUECES",47912,927,52391,101230
"2008","TEXAS","OCHILTREE",243,15,2851,3109
"2008","TEXAS","OLDHAM",102,5,813,920
"2008","TEXAS","ORANGE",7646,251,21509,29406
"2008","TEXAS","PALO PINTO",2499,127,7264,9890
"2008","TEXAS","PANOLA",2586,48,7582,10216
"2008","TEXAS","PARKER",10502,475,36974,47951
"2008","TEXAS","PARMER",719,25,2969,3713
"2008","TEXAS","PECOS",1476,54,2480,4010
"2008","TEXAS","POLK",6230,188,13731,20149
"2008","TEXAS","POTTER",8939,313,20761,30013
"2008","TEXAS","PRESIDIO",1252,16,489,1757
"2008","TEXAS","RAINS",1048,42,3146,4236
"2008","TEXAS","RANDALL",9468,416,41948,51832
"2008","TEXAS","REAGAN",197,2,795,994
"2008","TEXAS","REAL",375,15,1238,1628
"2008","TEXAS","RED RIVER",1539,52,3461,5052
"2008","TEXAS","REEVES",1606,26,1445,3077
"2008","TEXAS","REFUGIO",1382,24,1855,3261
"2008","TEXAS","ROBERTS",41,0,477,518
"2008","TEXAS","ROBERTSON",2675,55,3980,6710
"2008","TEXAS","ROCKWALL",8492,274,23300,32066
"2008","TEXAS","RUNNELS",720,29,3118,3867
"2008","TEXAS","RUSK",4983,93,13646,18722
"2008","TEXAS","SABINE",1077,48,3749,4874
"2008","TEXAS","SAN AUGUSTINE",1328,45,2342,3715
"2008","TEXAS","SAN JACINTO",2721,86,6151,8958
"2008","TEXAS","SAN PATRICIO",8854,138,12404,21396
"2008","TEXAS","SAN SABA",487,29,1941,2457
"2008","TEXAS","SCHLEICHER",324,10,970,1304
"2008","TEXAS","SCURRY",1088,67,4414,5569
"2008","TEXAS","SHACKELFORD",208,13,1284,1505
"2008","TEXAS","SHELBY",2548,42,6630,9220
"2008","TEXAS","SHERMAN",127,9,884,1020
"2008","TEXAS","SMITH",23726,648,55187,79561
"2008","TEXAS","SOMERVELL",799,57,2677,3533
"2008","TEXAS","STARR",8274,26,1492,9792
"2008","TEXAS","STEPHENS",626,31,2869,3526
"2008","TEXAS","STERLING",97,2,520,619
"2008","TEXAS","STONEWALL",206,5,524,735
"2008","TEXAS","SUTTON",381,8,1189,1578
"2008","TEXAS","SWISHER",813,39,1683,2535
"2008","TEXAS","TARRANT",274880,5253,348420,628553
"2008","TEXAS","TAYLOR",12690,432,34317,47439
"2008","TEXAS","TERRELL",186,10,323,519
"2008","TEXAS","TERRY",1379,22,2879,4280
"2008","TEXAS","THROCKMORTON",166,1,671,838
"2008","TEXAS","TITUS",3145,72,6028,9245
"2008","TEXAS","TOM GREEN",11158,341,27362,38861
"2008","TEXAS","TRAVIS",254017,6716,136981,397714
"2008","TEXAS","TRINITY",1925,57,4095,6077
"2008","TEXAS","TYLER",2166,100,5644,7910
"2008","TEXAS","UPSHUR",3790,152,11222,15164
"2008","TEXAS","UPTON",288,11,898,1197
"2008","TEXAS","UVALDE",4126,50,4590,8766
"2008","TEXAS","VAL VERDE",6982,86,5752,12820
"2008","TEXAS","VAN ZANDT",4505,156,15734,20395
"2008","TEXAS","VICTORIA",9832,221,19878,29931
"2008","TEXAS","WALKER",7334,189,11623,19146
"2008","TEXAS","WALLER",7153,90,8265,15508
"2008","TEXAS","WARD",899,36,2667,3602
"2008","TEXAS","WASHINGTON",4034,167,10176,14377
"2008","TEXAS","WEBB",33452,250,13119,46821
"2008","TEXAS","WHARTON",4937,50,9431,14418
"2008","TEXAS","WHEELER",314,13,1918,2245
"2008","TEXAS","WICHITA",13868,383,31731,45982
"2008","TEXAS","WILBARGER",1196,30,3283,4509
"2008","TEXAS","WILLACY",3409,38,1456,4903
"2008","TEXAS","WILLIAMSON",67691,2389,88323,158403
"2008","TEXAS","WILSON",5362,100,10904,16366
"2008","TEXAS","WINKLER",477,26,1529,2032
"2008","TEXAS","WISE",4471,195,15973,20639
"2008","TEXAS","WOOD",4010,116,13658,17784
"2008","TEXAS","YOAKUM",450,19,1989,2458
"2008","TEXAS","YOUNG",1303,60,5942,7305
"2008","TEXAS","ZAPATA",1939,8,919,2866
"2008","TEXAS","ZAVALA",3263,17,596,3876
"2008","UTAH","BEAVER",542,65,1902,2509
"2008","UTAH","BOX ELDER",3311,519,15228,19058
"2008","UTAH","CACHE",10294,1911,29127,41332
"2008","UTAH","CARBON",3468,218,4091,7777
"2008","UTAH","DAGGETT",131,11,297,439
"2008","UTAH","DAVIS",30477,3084,77341,110902
"2008","UTAH","DUCHESNE",911,144,4689,5744
"2008","UTAH","EMERY",973,117,3358,4448
"2008","UTAH","GARFIELD",405,44,1710,2159
"2008","UTAH","GRAND",2067,139,1871,4077
"2008","UTAH","IRON",3258,674,12518,16450
"2008","UTAH","JUAB",741,192,2683,3616
"2008","UTAH","KANE",856,86,2212,3154
"2008","UTAH","MILLARD",758,328,3653,4739
"2008","UTAH","MORGAN",689,161,3311,4161
"2008","UTAH","PIUTE",141,22,635,798
"2008","UTAH","RICH",154,21,831,1006
"2008","UTAH","SALT LAKE",176988,10069,176692,363749
"2008","UTAH","SAN JUAN",2406,86,2638,5130
"2008","UTAH","SANPETE",1631,476,6664,8771
"2008","UTAH","SEVIER",1359,254,6394,8007
"2008","UTAH","SUMMIT",9532,321,6956,16809
"2008","UTAH","TOOELE",5830,509,10998,17337
"2008","UTAH","UINTAH",1462,248,8441,10151
"2008","UTAH","UTAH",29567,5488,122224,157279
"2008","UTAH","WASATCH",2892,209,5430,8531
"2008","UTAH","WASHINGTON",10826,1392,37311,49529
"2008","UTAH","WAYNE",335,39,940,1314
"2008","UTAH","WEBER",25666,1843,45885,73394
"2008","VERMONT","ADDISON",13202,369,5667,19238
"2008","VERMONT","BENNINGTON",12524,472,6133,19129
"2008","VERMONT","CALEDONIA",8900,356,5472,14728
"2008","VERMONT","CHITTENDEN",59611,1592,22237,83440
"2008","VERMONT","ESSEX",1733,84,1284,3101
"2008","VERMONT","FRANKLIN",13179,428,7853,21460
"2008","VERMONT","GRAND ISLE",2694,85,1490,4269
"2008","VERMONT","LAMOILLE",8914,239,3515,12668
"2008","VERMONT","ORANGE",9799,333,5047,15179
"2008","VERMONT","ORLEANS",7998,291,4482,12771
"2008","VERMONT","RUTLAND",19355,678,11584,31617
"2008","VERMONT","WASHINGTON",22324,747,9129,32200
"2008","VERMONT","WINDHAM",17585,499,5997,24081
"2008","VERMONT","WINDSOR",21444,637,9084,31165
"2008","VIRGINIA","ACCOMACK",7607,183,7833,15623
"2008","VIRGINIA","ALBEMARLE",29792,616,20576,50984
"2008","VIRGINIA","ALEXANDRIA",50473,710,19181,70364
"2008","VIRGINIA","ALLEGHANY",3553,101,3715,7369
"2008","VIRGINIA","AMELIA",2488,71,3970,6529
"2008","VIRGINIA","AMHERST",6094,136,8470,14700
"2008","VIRGINIA","APPOMATTOX",2641,86,4903,7630
"2008","VIRGINIA","ARLINGTON",78994,1283,29876,110153
"2008","VIRGINIA","AUGUSTA",9825,393,23120,33338
"2008","VIRGINIA","BATH",1043,40,1349,2432
"2008","VIRGINIA","BEDFORD",12225,422,25917,38564
"2008","VIRGINIA","BLAND",864,64,2031,2959
"2008","VIRGINIA","BOTETOURT",5693,242,11471,17406
"2008","VIRGINIA","BRISTOL",2665,115,4579,7359
"2008","VIRGINIA","BRUNSWICK",4973,64,2877,7914
"2008","VIRGINIA","BUCHANAN",4063,130,4541,8734
"2008","VIRGINIA","BUCKINGHAM",3489,77,3428,6994
"2008","VIRGINIA","BUENA VISTA",1108,33,1282,2423
"2008","VIRGINIA","CAMPBELL",8091,279,17444,25814
"2008","VIRGINIA","CAROLINE",7163,139,5617,12919
"2008","VIRGINIA","CARROLL",4109,283,8187,12579
"2008","VIRGINIA","CHARLES CITY",2838,27,1288,4153
"2008","VIRGINIA","CHARLOTTE",2705,80,3372,6157
"2008","VIRGINIA","CHARLOTTESVILLE",15705,261,4078,20044
"2008","VIRGINIA","CHESAPEAKE",53994,902,52625,107521
"2008","VIRGINIA","CHESTERFIELD",74310,1365,86413,162088
"2008","VIRGINIA","CLARKE",3457,134,3840,7431
"2008","VIRGINIA","COLONIAL HEIGHTS",2562,126,6161,8849
"2008","VIRGINIA","COVINGTON",1304,30,1020,2354
"2008","VIRGINIA","CRAIG",877,49,1695,2621
"2008","VIRGINIA","CULPEPER",8802,228,10711,19741
"2008","VIRGINIA","CUMBERLAND",2255,51,2418,4724
"2008","VIRGINIA","DANVILLE",12352,177,8361,20890
"2008","VIRGINIA","DICKENSON",3278,151,3324,6753
"2008","VIRGINIA","DINWIDDIE",6246,120,6526,12892
"2008","VIRGINIA","EMPORIA",1702,18,897,2617
"2008","VIRGINIA","ESSEX",2934,51,2379,5364
"2008","VIRGINIA","FAIRFAX",316934,5033,205685,527652
"2008","VIRGINIA","FALLS CHURCH",4695,85,1970,6750
"2008","VIRGINIA","FAUQUIER",14616,376,19227,34219
"2008","VIRGINIA","FLOYD",2937,138,4441,7516
"2008","VIRGINIA","FLUVANNA",6185,130,6420,12735
"2008","VIRGINIA","FRANKLIN",12437,401,16990,29828
"2008","VIRGINIA","FREDERICK",12961,502,20149,33612
"2008","VIRGINIA","FREDERICKSBURG",6155,109,3413,9677
"2008","VIRGINIA","GALAX",1052,33,1317,2402
"2008","VIRGINIA","GILES",3192,141,4462,7795
"2008","VIRGINIA","GLOUCESTER",6916,217,12089,19222
"2008","VIRGINIA","GOOCHLAND",4813,106,7643,12562
"2008","VIRGINIA","GRAYSON",2480,200,4540,7220
"2008","VIRGINIA","GREENE",3174,106,4980,8260
"2008","VIRGINIA","GREENSVILLE",3122,36,1729,4887
"2008","VIRGINIA","HALIFAX",8126,124,8600,16850
"2008","VIRGINIA","HAMPTON",46917,550,20476,67943
"2008","VIRGINIA","HANOVER",18447,457,37344,56248
"2008","VIRGINIA","HARRISONBURG",8444,183,6048,14675
"2008","VIRGINIA","HENRICO",86323,1262,67381,154966
"2008","VIRGINIA","HENRY",11118,339,13758,25215
"2008","VIRGINIA","HIGHLAND",590,34,930,1554
"2008","VIRGINIA","HOPEWELL",5285,90,4149,9524
"2008","VIRGINIA","ISLE OF WIGHT",8573,166,11258,19997
"2008","VIRGINIA","JAMES CITY",17352,339,20912,38603
"2008","VIRGINIA","KING AND QUEEN",1918,24,1763,3705
"2008","VIRGINIA","KING GEORGE",4473,113,5888,10474
"2008","VIRGINIA","KING WILLIAM",3344,78,4966,8388
"2008","VIRGINIA","LANCASTER",3235,56,3647,6938
"2008","VIRGINIA","LEE",3219,183,5825,9227
"2008","VIRGINIA","LEXINGTON",1543,22,914,2479
"2008","VIRGINIA","LOUDOUN",74845,1278,63336,139459
"2008","VIRGINIA","LOUISA",6978,193,8182,15353
"2008","VIRGINIA","LUNENBURG",2703,47,2900,5650
"2008","VIRGINIA","LYNCHBURG",16269,434,17638,34341
"2008","VIRGINIA","MADISON",2862,79,3758,6699
"2008","VIRGINIA","MANASSAS",7518,134,5975,13627
"2008","VIRGINIA","MANASSAS PARK",2463,43,1634,4140
"2008","VIRGINIA","MARTINSVILLE",4139,70,2311,6520
"2008","VIRGINIA","MATHEWS",1934,50,3456,5440
"2008","VIRGINIA","MECKLENBURG",7127,138,7817,15082
"2008","VIRGINIA","MIDDLESEX",2391,70,3545,6006
"2008","VIRGINIA","MONTGOMERY",21031,594,19028,40653
"2008","VIRGINIA","NELSON",4391,95,3647,8133
"2008","VIRGINIA","NEW KENT",3493,113,6385,9991
"2008","VIRGINIA","NEWPORT NEWS",51972,656,28667,81295
"2008","VIRGINIA","NORFOLK",62819,813,24814,88446
"2008","VIRGINIA","NORTHAMPTON",3800,73,2713,6586
"2008","VIRGINIA","NORTHUMBERLAND",3312,53,4041,7406
"2008","VIRGINIA","NORTON",743,25,744,1512
"2008","VIRGINIA","NOTTOWAY",3413,76,3499,6988
"2008","VIRGINIA","ORANGE",7107,188,8506,15801
"2008","VIRGINIA","PAGE",4235,113,6041,10389
"2008","VIRGINIA","PATRICK",2879,161,5491,8531
"2008","VIRGINIA","PETERSBURG",13774,183,1583,15540
"2008","VIRGINIA","PITTSYLVANIA",11415,288,18730,30433
"2008","VIRGINIA","POQUOSON",1748,88,5229,7065
"2008","VIRGINIA","PORTSMOUTH",32327,354,13984,46665
"2008","VIRGINIA","POWHATAN",4237,131,10088,14456
"2008","VIRGINIA","PRINCE EDWARD",5101,113,4174,9388
"2008","VIRGINIA","PRINCE GEORGE",7130,124,8752,16006
"2008","VIRGINIA","PRINCE WILLIAM",93435,1390,67621,162446
"2008","VIRGINIA","PULASKI",5918,275,8857,15050
"2008","VIRGINIA","RADFORD",2930,81,2418,5429
"2008","VIRGINIA","RAPPAHANNOCK",2105,73,2227,4405
"2008","VIRGINIA","RICHMOND",75241,848,20741,96830
"2008","VIRGINIA","ROANOKE",44746,1036,45965,91747
"2008","VIRGINIA","ROCKBRIDGE",4347,116,5732,10195
"2008","VIRGINIA","ROCKINGHAM",10453,413,22468,33334
"2008","VIRGINIA","RUSSELL",4932,173,6389,11494
"2008","VIRGINIA","SALEM",5164,154,7088,12406
"2008","VIRGINIA","SCOTT",2725,170,6980,9875
"2008","VIRGINIA","SHENANDOAH",6912,306,12005,19223
"2008","VIRGINIA","SMYTH",4239,246,7817,12302
"2008","VIRGINIA","SOUTHAMPTON",4402,82,4583,9067
"2008","VIRGINIA","SPOTSYLVANIA",24897,562,28610,54069
"2008","VIRGINIA","STAFFORD",25716,518,29221,55455
"2008","VIRGINIA","STAUNTON",5569,116,5330,11015
"2008","VIRGINIA","SUFFOLK",22446,297,17165,39908
"2008","VIRGINIA","SURRY",2626,36,1663,4325
"2008","VIRGINIA","SUSSEX",3301,36,2026,5363
"2008","VIRGINIA","TAZEWELL",5596,264,11201,17061
"2008","VIRGINIA","VIRGINIA BEACH",98885,2045,100319,201249
"2008","VIRGINIA","WARREN",6997,250,8879,16126
"2008","VIRGINIA","WASHINGTON",8063,360,16077,24500
"2008","VIRGINIA","WAYNESBORO",3906,139,4815,8860
"2008","VIRGINIA","WESTMORELAND",4577,81,3719,8377
"2008","VIRGINIA","WILLIAMSBURG",4328,106,2353,6787
"2008","VIRGINIA","WINCHESTER",5268,133,4725,10126
"2008","VIRGINIA","WISE",4995,229,8914,14138
"2008","VIRGINIA","WYTHE",4107,177,8207,12491
"2008","VIRGINIA","YORK",13700,364,19833,33897
"2008","WASHINGTON","ADAMS",1552,84,3222,4858
"2008","WASHINGTON","ASOTIN",4139,190,5451,9780
"2008","WASHINGTON","BENTON",26288,1278,45345,72911
"2008","WASHINGTON","CHELAN",13781,572,17605,31958
"2008","WASHINGTON","CLALLAM",19470,850,18199,38519
"2008","WASHINGTON","CLARK",95356,3196,84212,182764
"2008","WASHINGTON","COLUMBIA",686,43,1499,2228
"2008","WASHINGTON","COWLITZ",24597,1078,19554,45229
"2008","WASHINGTON","DOUGLAS",5848,263,9098,15209
"2008","WASHINGTON","FERRY",1467,118,1916,3501
"2008","WASHINGTON","FRANKLIN",7361,298,12037,19696
"2008","WASHINGTON","GARFIELD",385,20,968,1373
"2008","WASHINGTON","GRANT",9601,684,17153,27438
"2008","WASHINGTON","GRAYS HARBOR",16354,726,12104,29184
"2008","WASHINGTON","ISLAND",22058,675,19426,42159
"2008","WASHINGTON","JEFFERSON",13252,409,6330,19991
"2008","WASHINGTON","KING",648230,14086,259716,922032
"2008","WASHINGTON","KITSAP",68624,2416,53297,124337
"2008","WASHINGTON","KITTITAS",8030,367,9471,17868
"2008","WASHINGTON","KLICKITAT",4965,255,4944,10164
"2008","WASHINGTON","LEWIS",13624,803,20278,34705
"2008","WASHINGTON","LINCOLN",2032,142,3803,5977
"2008","WASHINGTON","MASON",15050,656,12600,28306
"2008","WASHINGTON","OKANOGAN",7613,459,8798,16870
"2008","WASHINGTON","PACIFIC",6094,288,4555,10937
"2008","WASHINGTON","PEND OREILLE",2562,273,3717,6552
"2008","WASHINGTON","PIERCE",181824,6023,141673,329520
"2008","WASHINGTON","SAN JUAN",7374,199,2958,10531
"2008","WASHINGTON","SKAGIT",30053,1146,24687,55886
"2008","WASHINGTON","SKAMANIA",2817,149,2524,5490
"2008","WASHINGTON","SNOHOMISH",187294,6317,126722,320333
"2008","WASHINGTON","SPOKANE",105786,5411,108314,219511
"2008","WASHINGTON","STEVENS",8499,710,13132,22341
"2008","WASHINGTON","THURSTON",75882,2461,48366,126709
"2008","WASHINGTON","WAHKIAKUM",1121,68,1105,2294
"2008","WASHINGTON","WALLA WALLA",10081,464,14182,24727
"2008","WASHINGTON","WHATCOM",58236,1898,40205,100339
"2008","WASHINGTON","WHITMAN",9070,415,8104,17589
"2008","WASHINGTON","YAKIMA",33792,1324,41946,77062
"2008","WEST VIRGINIA","BARBOUR",2419,128,3685,6232
"2008","WEST VIRGINIA","BERKELEY",15994,457,20841,37292
"2008","WEST VIRGINIA","BOONE",4529,209,3632,8370
"2008","WEST VIRGINIA","BRAXTON",2704,76,2629,5409
"2008","WEST VIRGINIA","BROOKE",4717,179,4961,9857
"2008","WEST VIRGINIA","CABELL",15292,507,18793,34592
"2008","WEST VIRGINIA","CALHOUN",993,70,1366,2429
"2008","WEST VIRGINIA","CLAY",1421,89,1755,3265
"2008","WEST VIRGINIA","DODDRIDGE",735,65,2218,3018
"2008","WEST VIRGINIA","FAYETTE",7242,294,7658,15194
"2008","WEST VIRGINIA","GILMER",1004,72,1445,2521
"2008","WEST VIRGINIA","GRANT",997,55,3166,4218
"2008","WEST VIRGINIA","GREENBRIER",5881,284,7567,13732
"2008","WEST VIRGINIA","HAMPSHIRE",2983,142,5222,8347
"2008","WEST VIRGINIA","HANCOCK",5504,198,7518,13220
"2008","WEST VIRGINIA","HARDY",1901,130,3376,5407
"2008","WEST VIRGINIA","HARRISON",13582,466,17824,31872
"2008","WEST VIRGINIA","JACKSON",4861,227,7148,12236
"2008","WEST VIRGINIA","JEFFERSON",11687,258,10600,22545
"2008","WEST VIRGINIA","KANAWHA",40594,938,40952,82484
"2008","WEST VIRGINIA","LEWIS",2109,162,4335,6606
"2008","WEST VIRGINIA","LINCOLN",3029,169,3637,6835
"2008","WEST VIRGINIA","LOGAN",5873,266,7326,13465
"2008","WEST VIRGINIA","MARION",11618,488,11501,23607
"2008","WEST VIRGINIA","MARSHALL",5996,246,7759,14001
"2008","WEST VIRGINIA","MASON",4484,266,5853,10603
"2008","WEST VIRGINIA","MCDOWELL",3430,118,2882,6430
"2008","WEST VIRGINIA","MERCER",7450,326,13246,21022
"2008","WEST VIRGINIA","MINERAL",3750,181,7616,11547
"2008","WEST VIRGINIA","MINGO",3582,169,4587,8338
"2008","WEST VIRGINIA","MONONGALIA",17060,544,15775,33379
"2008","WEST VIRGINIA","MONROE",2014,164,3397,5575
"2008","WEST VIRGINIA","MORGAN",2721,127,4428,7276
"2008","WEST VIRGINIA","NICHOLAS",4357,200,4804,9361
"2008","WEST VIRGINIA","OHIO",8593,253,10694,19540
"2008","WEST VIRGINIA","PENDLETON",1310,50,2035,3395
"2008","WEST VIRGINIA","PLEASANTS",1142,61,1772,2975
"2008","WEST VIRGINIA","POCAHONTAS",1548,83,2011,3642
"2008","WEST VIRGINIA","PRESTON",4205,266,7325,11796
"2008","WEST VIRGINIA","PUTNAM",9334,284,15162,24780
"2008","WEST VIRGINIA","RALEIGH",10237,474,17548,28259
"2008","WEST VIRGINIA","RANDOLPH",4539,234,6060,10833
"2008","WEST VIRGINIA","RITCHIE",998,67,2781,3846
"2008","WEST VIRGINIA","ROANE",2511,109,2943,5563
"2008","WEST VIRGINIA","SUMMERS",2290,135,2891,5316
"2008","WEST VIRGINIA","TAYLOR",2462,136,3605,6203
"2008","WEST VIRGINIA","TUCKER",1288,96,2123,3507
"2008","WEST VIRGINIA","TYLER",1241,85,2415,3741
"2008","WEST VIRGINIA","UPSHUR",2925,135,5911,8971
"2008","WEST VIRGINIA","WAYNE",6137,346,8947,15430
"2008","WEST VIRGINIA","WEBSTER",1552,119,1386,3057
"2008","WEST VIRGINIA","WETZEL",2942,170,3342,6454
"2008","WEST VIRGINIA","WIRT",782,48,1496,2326
"2008","WEST VIRGINIA","WOOD",12573,533,22896,36002
"2008","WEST VIRGINIA","WYOMING",2735,174,4621,7530
"2008","WISCONSIN","ADAMS",5806,206,3974,9986
"2008","WISCONSIN","ASHLAND",5818,122,2634,8574
"2008","WISCONSIN","BARRON",12078,351,10457,22886
"2008","WISCONSIN","BAYFIELD",5972,131,3365,9468
"2008","WISCONSIN","BROWN",67269,1631,55854,124754
"2008","WISCONSIN","BUFFALO",3949,128,2923,7000
"2008","WISCONSIN","BURNETT",4337,151,4200,8688
"2008","WISCONSIN","CALUMET",13295,457,12722,26474
"2008","WISCONSIN","CHIPPEWA",16239,500,13492,30231
"2008","WISCONSIN","CLARK",7454,350,6383,14187
"2008","WISCONSIN","COLUMBIA",16661,418,12193,29272
"2008","WISCONSIN","CRAWFORD",4987,164,2830,7981
"2008","WISCONSIN","DANE",205984,3890,73065,282939
"2008","WISCONSIN","DODGE",19183,625,23015,42823
"2008","WISCONSIN","DOOR",10142,227,7112,17481
"2008","WISCONSIN","DOUGLAS",15830,401,7835,24066
"2008","WISCONSIN","DUNN",13002,421,9566,22989
"2008","WISCONSIN","EAU CLAIRE",33146,905,20959,55010
"2008","WISCONSIN","FLORENCE",1134,39,1512,2685
"2008","WISCONSIN","FOND DU LAC",23463,696,28164,52323
"2008","WISCONSIN","FOREST",2673,47,1963,4683
"2008","WISCONSIN","GRANT",14875,377,9068,24320
"2008","WISCONSIN","GREEN",11502,302,6730,18534
"2008","WISCONSIN","GREEN LAKE",4000,143,5393,9536
"2008","WISCONSIN","IOWA",7987,153,3829,11969
"2008","WISCONSIN","IRON",1914,54,1464,3432
"2008","WISCONSIN","JACKSON",5572,127,3552,9251
"2008","WISCONSIN","JEFFERSON",21448,622,21096,43166
"2008","WISCONSIN","JUNEAU",6186,196,5148,11530
"2008","WISCONSIN","KENOSHA",45836,1344,31609,78789
"2008","WISCONSIN","KEWAUNEE",5902,174,4711,10787
"2008","WISCONSIN","LA CROSSE",38524,993,23701,63218
"2008","WISCONSIN","LAFAYETTE",4732,115,2984,7831
"2008","WISCONSIN","LANGLADE",5182,139,5081,10402
"2008","WISCONSIN","LINCOLN",8424,325,6519,15268
"2008","WISCONSIN","MANITOWOC",22428,752,19234,42414
"2008","WISCONSIN","MARATHON",36367,1228,30345,67940
"2008","WISCONSIN","MARINETTE",11195,334,9726,21255
"2008","WISCONSIN","MARQUETTE",4068,124,3654,7846
"2008","WISCONSIN","MENOMINEE",1257,6,185,1448
"2008","WISCONSIN","MILWAUKEE",319819,5928,149445,475192
"2008","WISCONSIN","MONROE",10198,288,8666,19152
"2008","WISCONSIN","OCONTO",9927,286,8755,18968
"2008","WISCONSIN","ONEIDA",11907,390,9630,21927
"2008","WISCONSIN","OUTAGAMIE",50294,1592,39677,91563
"2008","WISCONSIN","OZAUKEE",20579,614,32172,53365
"2008","WISCONSIN","PEPIN",2102,53,1616,3771
"2008","WISCONSIN","PIERCE",11803,492,9812,22107
"2008","WISCONSIN","POLK",10876,485,11282,22643
"2008","WISCONSIN","PORTAGE",24817,795,13810,39422
"2008","WISCONSIN","PRICE",4559,174,3461,8194
"2008","WISCONSIN","RACINE",53408,1280,45954,100642
"2008","WISCONSIN","RICHLAND",5041,111,3298,8450
"2008","WISCONSIN","ROCK",50529,1276,27364,79169
"2008","WISCONSIN","RUSK",3855,164,3253,7272
"2008","WISCONSIN","SAUK",18617,447,11562,30626
"2008","WISCONSIN","SAWYER",4765,121,4199,9085
"2008","WISCONSIN","SHAWANO",10259,292,9538,20089
"2008","WISCONSIN","SHEBOYGAN",30395,911,30801,62107
"2008","WISCONSIN","ST. CROIX",21177,807,22837,44821
"2008","WISCONSIN","TAYLOR",4563,197,4586,9346
"2008","WISCONSIN","TREMPEALEAU",8321,185,4808,13314
"2008","WISCONSIN","VERNON",8463,245,5367,14075
"2008","WISCONSIN","VILAS",6491,204,7055,13750
"2008","WISCONSIN","WALWORTH",24177,760,25485,50422
"2008","WISCONSIN","WASHBURN",4693,116,4303,9112
"2008","WISCONSIN","WASHINGTON",25719,963,47729,74411
"2008","WISCONSIN","WAUKESHA",85339,2406,145152,232897
"2008","WISCONSIN","WAUPACA",12952,327,12232,25511
"2008","WISCONSIN","WAUSHARA",5868,211,5770,11849
"2008","WISCONSIN","WINNEBAGO",48167,1564,37946,87677
"2008","WISCONSIN","WOOD",21710,761,16581,39052
"2008","WYOMING","ALBANY",8644,621,7936,17201
"2008","WYOMING","BIG HORN",1108,188,4045,5341
"2008","WYOMING","CAMPBELL",2990,384,13011,16385
"2008","WYOMING","CARBON",2336,233,4331,6900
"2008","WYOMING","CONVERSE",1380,199,4922,6501
"2008","WYOMING","CROOK",612,127,2967,3706
"2008","WYOMING","FREMONT",6016,616,11083,17715
"2008","WYOMING","GOSHEN",1832,191,3942,5965
"2008","WYOMING","HOT SPRINGS",619,111,1834,2564
"2008","WYOMING","JOHNSON",908,133,3334,4375
"2008","WYOMING","LARAMIE",16072,1185,24549,41806
"2008","WYOMING","LINCOLN",1823,307,6485,8615
"2008","WYOMING","NATRONA",10475,1092,21906,33473
"2008","WYOMING","NIOBRARA",244,43,1017,1304
"2008","WYOMING","PARK",3757,453,10839,15049
"2008","WYOMING","PLATTE",1407,188,3002,4597
"2008","WYOMING","SHERIDAN",4458,404,10177,15039
"2008","WYOMING","SUBLETTE",936,123,3316,4375
"2008","WYOMING","SWEETWATER",5762,711,10360,16833
"2008","WYOMING","TETON",7472,322,4565,12359
"2008","WYOMING","UINTA",2317,338,5763,8418
"2008","WYOMING","WASHAKIE",1042,102,2956,4100
"2008","WYOMING","WESTON",658,138,2618,3414
"2012","ALABAMA","AUTAUGA",6363,190,17379,23932
"2012","ALABAMA","BALDWIN",18424,898,66016,85338
"2012","ALABAMA","BARBOUR",5912,47,5550,11509
"2012","ALABAMA","BIBB",2202,86,6132,8420
"2012","ALABAMA","BLOUNT",2970,279,20757,24006
"2012","ALABAMA","BULLOCK",4061,10,1251,5322
"2012","ALABAMA","BUTLER",4374,35,5087,9496
"2012","ALABAMA","CALHOUN",15511,468,30278,46257
"2012","ALABAMA","CHAMBERS",6871,114,7626,14611
"2012","ALABAMA","CHEROKEE",2132,141,7506,9779
"2012","ALABAMA","CHILTON",3397,133,13932,17462
"2012","ALABAMA","CHOCTAW",3786,30,4152,7968
"2012","ALABAMA","CLARKE",6334,47,7470,13851
"2012","ALABAMA","CLAY",1777,68,4817,6662
"2012","ALABAMA","CLEBURNE",971,62,5272,6305
"2012","ALABAMA","COFFEE",4925,179,14666,19770
"2012","ALABAMA","COLBERT",9166,283,13936,23385
"2012","ALABAMA","CONECUH",3555,28,3439,7022
"2012","ALABAMA","COOSA",2191,29,3049,5269
"2012","ALABAMA","COVINGTON",3158,112,12153,15423
"2012","ALABAMA","CRENSHAW",2050,37,4331,6418
"2012","ALABAMA","CULLMAN",5052,406,28999,34457
"2012","ALABAMA","DALE",5286,163,13108,18557
"2012","ALABAMA","DALLAS",14612,53,6288,20953
"2012","ALABAMA","DEKALB",5239,293,18331,23863
"2012","ALABAMA","ELMORE",8954,278,26253,35485
"2012","ALABAMA","ESCAMBIA",5489,93,9287,14869
"2012","ALABAMA","ETOWAH",12803,597,29130,42530
"2012","ALABAMA","FAYETTE",1817,75,6054,7946
"2012","ALABAMA","FRANKLIN",3171,121,7567,10859
"2012","ALABAMA","GENEVA",2039,106,9175,11320
"2012","ALABAMA","GREENE",4521,15,804,5340
"2012","ALABAMA","HALE",5411,22,3210,8643
"2012","ALABAMA","HENRY",3083,49,5628,8760
"2012","ALABAMA","HOUSTON",12367,281,29270,41918
"2012","ALABAMA","JACKSON",5822,316,14439,20577
"2012","ALABAMA","JEFFERSON",159876,2359,141683,303918
"2012","ALABAMA","LAMAR",1646,63,5457,7166
"2012","ALABAMA","LAUDERDALE",12511,502,23911,36924
"2012","ALABAMA","LAWRENCE",5069,169,8874,14112
"2012","ALABAMA","LEE",21381,784,32194,54359
"2012","ALABAMA","LIMESTONE",9829,335,25295,35459
"2012","ALABAMA","LOWNDES",5747,18,1756,7521
"2012","ALABAMA","MACON",9045,18,1331,10394
"2012","ALABAMA","MADISON",62015,2160,90884,155059
"2012","ALABAMA","MARENGO",6167,34,5336,11537
"2012","ALABAMA","MARION",2249,159,9697,12105
"2012","ALABAMA","MARSHALL",6299,400,25867,32566
"2012","ALABAMA","MOBILE",78760,1211,94893,174864
"2012","ALABAMA","MONROE",4914,53,5741,10708
"2012","ALABAMA","MONTGOMERY",63085,507,38332,101924
"2012","ALABAMA","MORGAN",13439,493,35391,49323
"2012","ALABAMA","PERRY",4568,25,1506,6099
"2012","ALABAMA","PICKENS",4455,32,5124,9611
"2012","ALABAMA","PIKE",6035,109,7963,14107
"2012","ALABAMA","RANDOLPH",3078,96,7224,10398
"2012","ALABAMA","RUSSELL",10500,101,8278,18879
"2012","ALABAMA","SHELBY",20051,1020,71436,92507
"2012","ALABAMA","ST. CLAIR",5801,316,29031,35148
"2012","ALABAMA","SUMTER",5421,20,1586,7027
"2012","ALABAMA","TALLADEGA",13905,222,19246,33373
"2012","ALABAMA","TALLAPOOSA",6319,114,12396,18829
"2012","ALABAMA","TUSCALOOSA",32048,794,45748,78590
"2012","ALABAMA","WALKER",6557,313,21651,28521
"2012","ALABAMA","WASHINGTON",2976,41,5761,8778
"2012","ALABAMA","WILCOX",4868,4,1679,6551
"2012","ALABAMA","WINSTON",1286,116,8312,9714
"2012","ALASKA","DISTRICT 1",1518,305,5899,7722
"2012","ALASKA","DISTRICT 10",1344,298,4928,6570
"2012","ALASKA","DISTRICT 11",2222,352,6057,8631
"2012","ALASKA","DISTRICT 12",1901,281,4300,6482
"2012","ALASKA","DISTRICT 13",2425,204,3078,5707
"2012","ALASKA","DISTRICT 14",3340,275,3453,7068
"2012","ALASKA","DISTRICT 15",3283,293,2875,6451
"2012","ALASKA","DISTRICT 16",4013,292,2876,7181
"2012","ALASKA","DISTRICT 17",2853,194,1542,4589
"2012","ALASKA","DISTRICT 18",4247,314,2369,6930
"2012","ALASKA","DISTRICT 19",4126,305,3855,8286
"2012","ALASKA","DISTRICT 2",3096,453,5509,9058
"2012","ALASKA","DISTRICT 20",3081,339,4544,7964
"2012","ALASKA","DISTRICT 21",3316,288,5262,8866
"2012","ALASKA","DISTRICT 22",2859,251,3445,6555
"2012","ALASKA","DISTRICT 23",3167,277,4926,8370
"2012","ALASKA","DISTRICT 24",3128,249,3912,7289
"2012","ALASKA","DISTRICT 25",3739,353,4569,8661
"2012","ALASKA","DISTRICT 26",3169,354,6968,10491
"2012","ALASKA","DISTRICT 27",4463,345,6015,10823
"2012","ALASKA","DISTRICT 28",2188,379,5882,8449
"2012","ALASKA","DISTRICT 29",1933,304,5774,8011
"2012","ALASKA","DISTRICT 3",2034,266,3769,6069
"2012","ALASKA","DISTRICT 30",3578,435,5492,9505
"2012","ALASKA","DISTRICT 31",4679,437,4219,9335
"2012","ALASKA","DISTRICT 32",5930,503,3095,9528
"2012","ALASKA","DISTRICT 33",2716,466,4289,7471
"2012","ALASKA","DISTRICT 34",4662,452,3523,8637
"2012","ALASKA","DISTRICT 35",2830,298,3804,6932
"2012","ALASKA","DISTRICT 36",3341,245,1386,4972
"2012","ALASKA","DISTRICT 37",2631,187,1517,4335
"2012","ALASKA","DISTRICT 38",4101,454,2259,6814
"2012","ALASKA","DISTRICT 39",3645,349,2566,6560
"2012","ALASKA","DISTRICT 4",2864,337,3586,6787
"2012","ALASKA","DISTRICT 40",2717,171,1347,4235
"2012","ALASKA","DISTRICT 5",3644,472,4027,8143
"2012","ALASKA","DISTRICT 6",2145,394,5254,7793
"2012","ALASKA","DISTRICT 7",1962,366,5247,7575
"2012","ALASKA","DISTRICT 8",2083,333,5826,8242
"2012","ALASKA","DISTRICT 9",1667,309,5432,7408
"2012","ALASKA","DISTRICT 99",0,0,0,0
"2012","ARIZONA","APACHE",17147,451,8250,25848
"2012","ARIZONA","COCHISE",18546,960,29497,49003
"2012","ARIZONA","COCONINO",29257,1254,21220,51731
"2012","ARIZONA","GILA",7697,376,13455,21528
"2012","ARIZONA","GRAHAM",3609,170,8076,11855
"2012","ARIZONA","GREENLEE",1310,72,1592,2974
"2012","ARIZONA","LA PAZ",1880,123,3714,5717
"2012","ARIZONA","MARICOPA",602288,24385,749885,1376558
"2012","ARIZONA","MOHAVE",19533,1309,49168,70010
"2012","ARIZONA","NAVAJO",16945,506,19884,37335
"2012","ARIZONA","PIMA",201251,6220,174779,382250
"2012","ARIZONA","PINAL",44306,1930,62079,108315
"2012","ARIZONA","SANTA CRUZ",9486,173,4235,13894
"2012","ARIZONA","YAVAPAI",33918,1897,64468,100283
"2012","ARIZONA","YUMA",18059,542,23352,41953
"2012","ARKANSAS","ARKANSAS",2455,142,3897,6494
"2012","ARKANSAS","ASHLEY",2859,195,4867,7921
"2012","ARKANSAS","BAXTER",5172,479,13688,19339
"2012","ARKANSAS","BENTON",22636,1975,54646,79257
"2012","ARKANSAS","BOONE",3772,460,11159,15391
"2012","ARKANSAS","BRADLEY",1449,69,2134,3652
"2012","ARKANSAS","CALHOUN",660,56,1458,2174
"2012","ARKANSAS","CARROLL",3696,362,6125,10183
"2012","ARKANSAS","CHICOT",2649,42,1670,4361
"2012","ARKANSAS","CLARK",3811,255,4343,8409
"2012","ARKANSAS","CLAY",1738,147,3225,5110
"2012","ARKANSAS","CLEBURNE",2620,334,8693,11647
"2012","ARKANSAS","CLEVELAND",845,108,2313,3266
"2012","ARKANSAS","COLUMBIA",3557,108,5790,9455
"2012","ARKANSAS","CONWAY",3005,211,4514,7730
"2012","ARKANSAS","CRAIGHEAD",10527,823,20350,31700
"2012","ARKANSAS","CRAWFORD",4881,565,15145,20591
"2012","ARKANSAS","CRITTENDEN",9487,231,6998,16716
"2012","ARKANSAS","CROSS",2279,133,4269,6681
"2012","ARKANSAS","DALLAS",1337,82,1665,3084
"2012","ARKANSAS","DESHA",2443,81,1896,4420
"2012","ARKANSAS","DREW",2630,116,3887,6633
"2012","ARKANSAS","FAULKNER",13621,1117,26722,41460
"2012","ARKANSAS","FRANKLIN",1726,183,4631,6540
"2012","ARKANSAS","FULTON",1452,121,2949,4522
"2012","ARKANSAS","GARLAND",13804,910,26014,40728
"2012","ARKANSAS","GRANT",1468,182,4829,6479
"2012","ARKANSAS","GREENE",4000,690,9071,13761
"2012","ARKANSAS","HEMPSTEAD",2468,169,4284,6921
"2012","ARKANSAS","HOT SPRING",3830,333,7097,11260
"2012","ARKANSAS","HOWARD",1471,99,2892,4462
"2012","ARKANSAS","INDEPENDENCE",3281,388,8728,12397
"2012","ARKANSAS","IZARD",1524,179,3575,5278
"2012","ARKANSAS","JACKSON",2095,180,3072,5347
"2012","ARKANSAS","JEFFERSON",17470,393,9520,27383
"2012","ARKANSAS","JOHNSON",2799,235,5064,8098
"2012","ARKANSAS","LAFAYETTE",1173,43,1713,2929
"2012","ARKANSAS","LAWRENCE",1788,216,3536,5540
"2012","ARKANSAS","LEE",2107,37,1280,3424
"2012","ARKANSAS","LINCOLN",1425,102,2199,3726
"2012","ARKANSAS","LITTLE RIVER",1552,114,3385,5051
"2012","ARKANSAS","LOGAN",2009,243,5079,7331
"2012","ARKANSAS","LONOKE",5625,609,17880,24114
"2012","ARKANSAS","MADISON",2099,206,4263,6568
"2012","ARKANSAS","MARION",2037,240,4774,7051
"2012","ARKANSAS","MILLER",4518,189,10622,15329
"2012","ARKANSAS","MISSISSIPPI",6467,305,6603,13375
"2012","ARKANSAS","MONROE",1583,62,1585,3230
"2012","ARKANSAS","MONTGOMERY",920,115,2369,3404
"2012","ARKANSAS","NEVADA",1314,74,1996,3384
"2012","ARKANSAS","NEWTON",993,160,2508,3661
"2012","ARKANSAS","OUACHITA",4633,161,5521,10315
"2012","ARKANSAS","PERRY",1187,170,2581,3938
"2012","ARKANSAS","PHILLIPS",5202,130,2598,7930
"2012","ARKANSAS","PIKE",851,90,2847,3788
"2012","ARKANSAS","POINSETT",2390,196,4974,7560
"2012","ARKANSAS","POLK",1556,215,5955,7726
"2012","ARKANSAS","POPE",5126,550,14763,20439
"2012","ARKANSAS","PRAIRIE",880,108,2153,3141
"2012","ARKANSAS","PULASKI",87248,3149,68984,159381
"2012","ARKANSAS","RANDOLPH",2046,209,3701,5956
"2012","ARKANSAS","SALINE",12869,1230,32963,47062
"2012","ARKANSAS","SCOTT",897,112,2631,3640
"2012","ARKANSAS","SEARCY",814,181,2699,3694
"2012","ARKANSAS","SEBASTIAN",13092,1101,29169,43362
"2012","ARKANSAS","SEVIER",1042,152,3136,4330
"2012","ARKANSAS","SHARP",2092,270,4921,7283
"2012","ARKANSAS","ST. FRANCIS",4910,84,3368,8362
"2012","ARKANSAS","STONE",1356,222,3776,5354
"2012","ARKANSAS","UNION",6196,282,10699,17177
"2012","ARKANSAS","VAN BUREN",1832,233,4365,6430
"2012","ARKANSAS","WASHINGTON",28236,2536,39688,70460
"2012","ARKANSAS","WHITE",5765,738,20011,26514
"2012","ARKANSAS","WOODRUFF",1340,118,1227,2685
"2012","ARKANSAS","YELL",1722,210,4042,5974
"2012","CALIFORNIA","ALAMEDA",469684,17776,108182,595642
"2012","CALIFORNIA","ALPINE",389,28,236,653
"2012","CALIFORNIA","AMADOR",6830,538,10281,17649
"2012","CALIFORNIA","BUTTE",42669,3604,44479,90752
"2012","CALIFORNIA","CALAVERAS",8670,751,12365,21786
"2012","CALIFORNIA","COLUSA",2314,119,3601,6034
"2012","CALIFORNIA","CONTRA COSTA",290824,10885,136517,438226
"2012","CALIFORNIA","DEL NORTE",3791,365,4614,8770
"2012","CALIFORNIA","EL DORADO",35166,2635,50973,88774
"2012","CALIFORNIA","FRESNO",129129,5208,124490,258827
"2012","CALIFORNIA","GLENN",3301,278,5632,9211
"2012","CALIFORNIA","HUMBOLDT",34457,4188,18825,57470
"2012","CALIFORNIA","IMPERIAL",25136,652,12777,38565
"2012","CALIFORNIA","INYO",3422,274,4340,8036
"2012","CALIFORNIA","KERN",89495,5359,126618,221472
"2012","CALIFORNIA","KINGS",12979,768,17671,31418
"2012","CALIFORNIA","LAKE",13163,1028,9200,23391
"2012","CALIFORNIA","LASSEN",3053,334,7296,10683
"2012","CALIFORNIA","LOS ANGELES",2216903,78831,885333,3181067
"2012","CALIFORNIA","MADERA",16018,996,22852,39866
"2012","CALIFORNIA","MARIN",99896,3740,30880,134516
"2012","CALIFORNIA","MARIPOSA",3498,362,5140,9000
"2012","CALIFORNIA","MENDOCINO",23193,2166,9658,35017
"2012","CALIFORNIA","MERCED",33005,1471,27581,62057
"2012","CALIFORNIA","MODOC",1111,98,2777,3986
"2012","CALIFORNIA","MONO",2733,163,2285,5181
"2012","CALIFORNIA","MONTEREY",82920,3208,37390,123518
"2012","CALIFORNIA","NAPA",35870,1572,19526,56968
"2012","CALIFORNIA","NEVADA",24663,2027,24986,51676
"2012","CALIFORNIA","ORANGE",512440,27892,582332,1122664
"2012","CALIFORNIA","PLACER",66818,4583,99921,171322
"2012","CALIFORNIA","PLUMAS",4026,300,5721,10047
"2012","CALIFORNIA","RIVERSIDE",329063,14717,318127,661907
"2012","CALIFORNIA","SACRAMENTO",300503,13792,202514,516809
"2012","CALIFORNIA","SAN BENITO",11276,425,7343,19044
"2012","CALIFORNIA","SAN BERNARDINO",305109,14050,262358,581517
"2012","CALIFORNIA","SAN DIEGO",626957,28599,536726,1192282
"2012","CALIFORNIA","SAN FRANCISCO",301723,12410,47076,361209
"2012","CALIFORNIA","SAN JOAQUIN",114121,4505,86071,204697
"2012","CALIFORNIA","SAN LUIS OBISPO",61258,4413,59967,125638
"2012","CALIFORNIA","SAN MATEO",206085,6879,72756,285720
"2012","CALIFORNIA","SANTA BARBARA",94129,4585,64606,163320
"2012","CALIFORNIA","SANTA CLARA",450818,17430,174843,643091
"2012","CALIFORNIA","SANTA CRUZ",90805,5243,24047,120095
"2012","CALIFORNIA","SHASTA",25819,2449,48067,76335
"2012","CALIFORNIA","SIERRA",653,86,1056,1795
"2012","CALIFORNIA","SISKIYOU",8046,787,11077,19910
"2012","CALIFORNIA","SOLANO",96783,3569,52092,152444
"2012","CALIFORNIA","SONOMA",153942,7782,54784,216508
"2012","CALIFORNIA","STANISLAUS",77724,4186,73459,155369
"2012","CALIFORNIA","SUTTER",12192,712,18122,31026
"2012","CALIFORNIA","TEHAMA",7934,808,14235,22977
"2012","CALIFORNIA","TRINITY",2674,284,2716,5674
"2012","CALIFORNIA","TULARE",41752,2392,56956,101100
"2012","CALIFORNIA","TUOLUMNE",9998,809,13880,24687
"2012","CALIFORNIA","VENTURA",170929,8087,147958,326974
"2012","CALIFORNIA","YOLO",48715,2392,23368,74475
"2012","CALIFORNIA","YUBA",7711,714,11275,19700
"2012","COLORADO","ADAMS",100649,4609,70972,176230
"2012","COLORADO","ALAMOSA",3811,199,2705,6715
"2012","COLORADO","ARAPAHOE",153905,6023,125588,285516
"2012","COLORADO","ARCHULETA",2679,183,3872,6734
"2012","COLORADO","BACA",467,80,1559,2106
"2012","COLORADO","BENT",815,52,1075,1942
"2012","COLORADO","BOULDER",125091,4427,49981,179499
"2012","COLORADO","BROOMFIELD",16966,803,15008,32777
"2012","COLORADO","CHAFFEE",5086,306,5070,10462
"2012","COLORADO","CHEYENNE",172,32,889,1093
"2012","COLORADO","CLEAR CREEK",3119,194,2430,5743
"2012","COLORADO","CONEJOS",2213,53,1835,4101
"2012","COLORADO","COSTILLA",1340,51,446,1837
"2012","COLORADO","CROWLEY",535,43,924,1502
"2012","COLORADO","CUSTER",868,59,1788,2715
"2012","COLORADO","DELTA",4622,388,10915,15925
"2012","COLORADO","DENVER",222018,6565,73111,301694
"2012","COLORADO","DOLORES",334,52,859,1245
"2012","COLORADO","DOUGLAS",60991,2586,104204,167781
"2012","COLORADO","EAGLE",12792,465,9411,22668
"2012","COLORADO","EL PASO",111819,7404,170952,290175
"2012","COLORADO","ELBERT",3603,309,10266,14178
"2012","COLORADO","FREMONT",6704,538,13174,20416
"2012","COLORADO","GARFIELD",11305,568,12535,24408
"2012","COLORADO","GILPIN",1892,100,1346,3338
"2012","COLORADO","GRAND",3684,250,4253,8187
"2012","COLORADO","GUNNISON",5044,282,3341,8667
"2012","COLORADO","HINSDALE",229,18,353,600
"2012","COLORADO","HUERFANO",1953,115,1646,3714
"2012","COLORADO","JACKSON",216,32,600,848
"2012","COLORADO","JEFFERSON",159296,7559,144197,311052
"2012","COLORADO","KIOWA",118,26,677,821
"2012","COLORADO","KIT CARSON",838,79,2785,3702
"2012","COLORADO","LA PLATA",15489,901,12794,29184
"2012","COLORADO","LAKE",1839,103,1098,3040
"2012","COLORADO","LARIMER",92747,5057,82376,180180
"2012","COLORADO","LAS ANIMAS",3445,154,3263,6862
"2012","COLORADO","LINCOLN",552,48,1687,2287
"2012","COLORADO","LOGAN",2712,233,6179,9124
"2012","COLORADO","MESA",23846,1629,47472,72947
"2012","COLORADO","MINERAL",291,15,344,650
"2012","COLORADO","MOFFAT",1330,143,4695,6168
"2012","COLORADO","MONTEZUMA",4542,375,7401,12318
"2012","COLORADO","MONTROSE",6138,440,13552,20130
"2012","COLORADO","MORGAN",3912,263,6602,10777
"2012","COLORADO","OTERO",3647,163,4382,8192
"2012","COLORADO","OURAY",1646,75,1481,3202
"2012","COLORADO","PARK",3862,268,5236,9366
"2012","COLORADO","PHILLIPS",588,40,1637,2265
"2012","COLORADO","PITKIN",6849,202,3024,10075
"2012","COLORADO","PROWERS",1519,114,3230,4863
"2012","COLORADO","PUEBLO",42551,1749,31894,76194
"2012","COLORADO","RIO BLANCO",568,77,2724,3369
"2012","COLORADO","RIO GRANDE",2478,137,2918,5533
"2012","COLORADO","ROUTT",7547,301,5469,13317
"2012","COLORADO","SAGUACHE",1864,102,964,2930
"2012","COLORADO","SAN JUAN",266,28,212,506
"2012","COLORADO","SAN MIGUEL",2992,110,1154,4256
"2012","COLORADO","SEDGWICK",419,38,881,1338
"2012","COLORADO","SUMMIT",9347,394,5571,15312
"2012","COLORADO","TELLER",4333,372,8702,13407
"2012","COLORADO","WASHINGTON",468,47,2076,2591
"2012","COLORADO","WELD",49050,3041,63775,115866
"2012","COLORADO","YUMA",987,100,3490,4577
"2012","CONNECTICUT","FAIRFIELD",217294,3668,175168,396130
"2012","CONNECTICUT","HARTFORD",244639,4363,143238,392240
"2012","CONNECTICUT","LITCHFIELD",43856,1370,47201,92427
"2012","CONNECTICUT","MIDDLESEX",47855,1092,34591,83538
"2012","CONNECTICUT","NEW HAVEN",218972,3697,138357,361026
"2012","CONNECTICUT","NEW LONDON",67144,1839,46119,115102
"2012","CONNECTICUT","STATEWIDE WRITEIN",0,918,0,918
"2012","CONNECTICUT","TOLLAND",39366,1112,30450,70928
"2012","CONNECTICUT","WINDHAM",25957,769,19768,46494
"2012","DELAWARE","KENT",35527,1034,32135,68696
"2012","DELAWARE","NEW CASTLE",167082,3700,81230,252012
"2012","DELAWARE","SUSSEX",39975,1135,52119,93229
"2012","DISTRICT OF COLUMBIA","DISTRICT OF COLUMBIA",267070,5313,21381,293764
"2012","FLORIDA","ALACHUA",69699,1922,48797,120418
"2012","FLORIDA","BAKER",2311,82,8975,11368
"2012","FLORIDA","BAY",22051,934,56876,79861
"2012","FLORIDA","BRADFORD",3325,91,8219,11635
"2012","FLORIDA","BREVARD",122993,3266,159300,285559
"2012","FLORIDA","BROWARD",508312,4009,244101,756422
"2012","FLORIDA","CALHOUN",1664,122,4366,6152
"2012","FLORIDA","CHARLOTTE",35906,780,47996,84682
"2012","FLORIDA","CITRUS",28460,813,44662,73935
"2012","FLORIDA","CLAY",25759,808,70022,96589
"2012","FLORIDA","COLLIER",51698,894,96520,149112
"2012","FLORIDA","COLUMBIA",8462,272,18429,27163
"2012","FLORIDA","DESOTO",4174,104,5587,9865
"2012","FLORIDA","DIXIE",1798,91,5052,6941
"2012","FLORIDA","DUVAL",196737,3496,211615,411848
"2012","FLORIDA","ESCAMBIA",58185,1606,88711,148502
"2012","FLORIDA","FLAGLER",23207,419,26969,50595
"2012","FLORIDA","FRANKLIN",1845,59,3570,5474
"2012","FLORIDA","GADSDEN",15770,99,6630,22499
"2012","FLORIDA","GILCHRIST",1885,107,5917,7909
"2012","FLORIDA","GLADES",1603,42,2344,3989
"2012","FLORIDA","GULF",2014,99,4995,7108
"2012","FLORIDA","HAMILTON",2228,41,3138,5407
"2012","FLORIDA","HARDEE",2463,67,4696,7226
"2012","FLORIDA","HENDRY",4751,79,5355,10185
"2012","FLORIDA","HERNANDO",37830,899,44938,83667
"2012","FLORIDA","HIGHLANDS",16148,381,25915,42444
"2012","FLORIDA","HILLSBOROUGH",286467,5449,250186,542102
"2012","FLORIDA","HOLMES",1264,91,6919,8274
"2012","FLORIDA","INDIAN RIVER",27492,522,43450,71464
"2012","FLORIDA","JACKSON",7342,181,13418,20941
"2012","FLORIDA","JEFFERSON",3945,55,3808,7808
"2012","FLORIDA","LAFAYETTE",687,44,2668,3399
"2012","FLORIDA","LAKE",61799,1369,87643,150811
"2012","FLORIDA","LEE",110157,1846,154163,266166
"2012","FLORIDA","LEON",90881,1667,55805,148353
"2012","FLORIDA","LEVY",6119,226,12054,18399
"2012","FLORIDA","LIBERTY",942,41,2301,3284
"2012","FLORIDA","MADISON",4176,65,4474,8715
"2012","FLORIDA","MANATEE",66503,1361,85627,153491
"2012","FLORIDA","MARION",66831,1511,93043,161385
"2012","FLORIDA","MARTIN",30107,583,48183,78873
"2012","FLORIDA","MIAMI-DADE",541440,3893,332981,878314
"2012","FLORIDA","MONROE",19404,419,19234,39057
"2012","FLORIDA","NASSAU",10251,348,29929,40528
"2012","FLORIDA","OKALOOSA",23421,1209,70168,94798
"2012","FLORIDA","OKEECHOBEE",4856,140,7328,12324
"2012","FLORIDA","ORANGE",273665,4105,188589,466359
"2012","FLORIDA","OSCEOLA",67239,867,40592,108698
"2012","FLORIDA","PALM BEACH",349651,3672,247398,600721
"2012","FLORIDA","PASCO",98263,2883,112427,213573
"2012","FLORIDA","PINELLAS",239104,5340,213258,457702
"2012","FLORIDA","POLK",114622,2484,131577,248683
"2012","FLORIDA","PUTNAM",11667,331,19326,31324
"2012","FLORIDA","SANTA ROSA",17768,892,58186,76846
"2012","FLORIDA","SARASOTA",95119,1857,110504,207480
"2012","FLORIDA","SEMINOLE",96445,2232,109943,208620
"2012","FLORIDA","ST. JOHNS",35190,1092,78513,114795
"2012","FLORIDA","ST. LUCIE",65869,956,56202,123027
"2012","FLORIDA","SUMTER",19524,309,40646,60479
"2012","FLORIDA","SUWANNEE",4751,206,12672,17629
"2012","FLORIDA","TAYLOR",2764,107,6249,9120
"2012","FLORIDA","UNION",1339,74,3980,5393
"2012","FLORIDA","VOLUSIA",114748,2298,117490,234536
"2012","FLORIDA","WAKULLA",5175,195,9290,14660
"2012","FLORIDA","WALTON",6671,333,21490,28494
"2012","FLORIDA","WASHINGTON",2820,141,8038,10999
"2012","GEORGIA","APPLING",1758,95,5233,7086
"2012","GEORGIA","ATKINSON",930,34,1938,2902
"2012","GEORGIA","BACON",791,47,3093,3931
"2012","GEORGIA","BAKER",794,10,785,1589
"2012","GEORGIA","BALDWIN",8483,166,7589,16238
"2012","GEORGIA","BANKS",780,61,5354,6195
"2012","GEORGIA","BARROW",6028,446,18725,25199
"2012","GEORGIA","BARTOW",8396,530,26876,35802
"2012","GEORGIA","BEN HILL",2512,48,3396,5956
"2012","GEORGIA","BERRIEN",1273,85,4843,6201
"2012","GEORGIA","BIBB",38585,510,25623,64718
"2012","GEORGIA","BLECKLEY",1269,51,3587,4907
"2012","GEORGIA","BRANTLEY",939,99,4964,6002
"2012","GEORGIA","BROOKS",3138,50,3554,6742
"2012","GEORGIA","BRYAN",3707,186,9560,13453
"2012","GEORGIA","BULLOCH",9593,318,14174,24085
"2012","GEORGIA","BURKE",5405,73,4301,9779
"2012","GEORGIA","BUTTS",2968,107,6306,9381
"2012","GEORGIA","CALHOUN",1298,7,883,2188
"2012","GEORGIA","CAMDEN",6377,263,11343,17983
"2012","GEORGIA","CANDLER",1157,27,2344,3528
"2012","GEORGIA","CARROLL",12688,581,28280,41549
"2012","GEORGIA","CATOOSA",5365,455,17858,23678
"2012","GEORGIA","CHARLTON",1197,40,2527,3764
"2012","GEORGIA","CHATHAM",60246,1178,47204,108628
"2012","GEORGIA","CHATTAHOOCHEE",729,26,735,1490
"2012","GEORGIA","CHATTOOGA",2232,138,5452,7822
"2012","GEORGIA","CHEROKEE",19841,1865,76514,98220
"2012","GEORGIA","CLARKE",25431,1122,13815,40368
"2012","GEORGIA","CLAY",862,3,537,1402
"2012","GEORGIA","CLAYTON",81479,424,14164,96067
"2012","GEORGIA","CLINCH",852,22,1598,2472
"2012","GEORGIA","COBB",133124,5270,171722,310116
"2012","GEORGIA","COFFEE",5057,149,9248,14454
"2012","GEORGIA","COLQUITT",3973,112,9243,13328
"2012","GEORGIA","COLUMBIA",16451,707,41765,58923
"2012","GEORGIA","COOK",2042,54,3935,6031
"2012","GEORGIA","COWETA",15168,734,39653,55555
"2012","GEORGIA","CRAWFORD",1706,59,3368,5133
"2012","GEORGIA","CRISP",3167,47,4182,7396
"2012","GEORGIA","DADE",1411,138,4471,6020
"2012","GEORGIA","DAWSON",1241,156,8847,10244
"2012","GEORGIA","DECATUR",4591,70,5824,10485
"2012","GEORGIA","DEKALB",238224,3649,64392,306265
"2012","GEORGIA","DODGE",2442,77,5214,7733
"2012","GEORGIA","DOOLY",2285,28,1985,4298
"2012","GEORGIA","DOUGHERTY",26295,175,11449,37919
"2012","GEORGIA","DOUGLAS",28441,585,26241,55267
"2012","GEORGIA","EARLY",2765,31,2557,5353
"2012","GEORGIA","ECHOLS",173,12,917,1102
"2012","GEORGIA","EFFINGHAM",4947,273,15596,20816
"2012","GEORGIA","ELBERT",3181,103,4859,8143
"2012","GEORGIA","EMANUEL",2927,56,5100,8083
"2012","GEORGIA","EVANS",1268,27,2268,3563
"2012","GEORGIA","FANNIN",2028,132,7857,10017
"2012","GEORGIA","FAYETTE",19736,757,38075,58568
"2012","GEORGIA","FLOYD",9640,456,22733,32829
"2012","GEORGIA","FORSYTH",14571,1252,65908,81731
"2012","GEORGIA","FRANKLIN",1499,149,6114,7762
"2012","GEORGIA","FULTON",255470,4819,137124,397413
"2012","GEORGIA","GILMER",1958,134,8926,11018
"2012","GEORGIA","GLASCOCK",176,22,1135,1333
"2012","GEORGIA","GLYNN",11950,290,20893,33133
"2012","GEORGIA","GORDON",3440,260,13197,16897
"2012","GEORGIA","GRADY",3419,53,5924,9396
"2012","GEORGIA","GREENE",3201,51,5071,8323
"2012","GEORGIA","GWINNETT",132509,4364,159855,296728
"2012","GEORGIA","HABERSHAM",2301,174,12166,14641
"2012","GEORGIA","HALL",12999,884,47481,61364
"2012","GEORGIA","HANCOCK",3308,11,769,4088
"2012","GEORGIA","HARALSON",1789,141,8446,10376
"2012","GEORGIA","HARRIS",4145,146,11197,15488
"2012","GEORGIA","HART",2870,124,6517,9511
"2012","GEORGIA","HEARD",948,64,3160,4172
"2012","GEORGIA","HENRY",43761,843,46774,91378
"2012","GEORGIA","HOUSTON",22702,692,34662,58056
"2012","GEORGIA","IRWIN",1141,30,2538,3709
"2012","GEORGIA","JACKSON",4238,331,19135,23704
"2012","GEORGIA","JASPER",1845,50,4136,6031
"2012","GEORGIA","JEFF DAVIS",1275,65,3996,5336
"2012","GEORGIA","JEFFERSON",4261,38,2999,7298
"2012","GEORGIA","JENKINS",1488,15,1887,3390
"2012","GEORGIA","JOHNSON",1305,27,2440,3772
"2012","GEORGIA","JONES",4274,87,7744,12105
"2012","GEORGIA","LAMAR",2602,91,4899,7592
"2012","GEORGIA","LANIER",1114,38,1820,2972
"2012","GEORGIA","LAURENS",7513,141,11950,19604
"2012","GEORGIA","LEE",3196,118,10314,13628
"2012","GEORGIA","LIBERTY",10457,148,5565,16170
"2012","GEORGIA","LINCOLN",1586,33,2807,4426
"2012","GEORGIA","LONG",1442,54,2306,3802
"2012","GEORGIA","LOWNDES",17470,340,21327,39137
"2012","GEORGIA","LUMPKIN",2055,203,8647,10905
"2012","GEORGIA","MACON",3211,25,1545,4781
"2012","GEORGIA","MADISON",2494,167,8443,11104
"2012","GEORGIA","MARION",1412,25,1733,3170
"2012","GEORGIA","MCDUFFIE",4044,73,5475,9592
"2012","GEORGIA","MCINTOSH",2864,68,3409,6341
"2012","GEORGIA","MERIWETHER",4331,77,4856,9264
"2012","GEORGIA","MILLER",852,18,1905,2775
"2012","GEORGIA","MITCHELL",4081,39,4155,8275
"2012","GEORGIA","MONROE",3785,131,8361,12277
"2012","GEORGIA","MONTGOMERY",1135,35,2662,3832
"2012","GEORGIA","MORGAN",2753,88,6186,9027
"2012","GEORGIA","MURRAY",2542,232,8443,11217
"2012","GEORGIA","MUSCOGEE",42573,520,27510,70603
"2012","GEORGIA","NEWTON",21851,401,20982,43234
"2012","GEORGIA","OCONEE",4421,298,13098,17817
"2012","GEORGIA","OGLETHORPE",1914,108,4251,6273
"2012","GEORGIA","PAULDING",15825,728,40846,57399
"2012","GEORGIA","PEACH",6148,81,5287,11516
"2012","GEORGIA","PICKENS",1975,158,10547,12680
"2012","GEORGIA","PIERCE",1124,55,5667,6846
"2012","GEORGIA","PIKE",1356,85,6668,8109
"2012","GEORGIA","POLK",3615,182,9811,13608
"2012","GEORGIA","PULASKI",1219,19,2444,3682
"2012","GEORGIA","PUTNAM",2926,81,6215,9222
"2012","GEORGIA","QUITMAN",612,6,510,1128
"2012","GEORGIA","RABUN",1559,150,5754,7463
"2012","GEORGIA","RANDOLPH",1770,17,1271,3058
"2012","GEORGIA","RICHMOND",52560,615,25845,79020
"2012","GEORGIA","ROCKDALE",22023,346,15716,38085
"2012","GEORGIA","SCHLEY",448,14,1286,1748
"2012","GEORGIA","SCREVEN",2774,39,3287,6100
"2012","GEORGIA","SEMINOLE",1478,46,2245,3769
"2012","GEORGIA","SPALDING",9898,279,14911,25088
"2012","GEORGIA","STEPHENS",2131,146,7221,9498
"2012","GEORGIA","STEWART",1323,8,745,2076
"2012","GEORGIA","SUMTER",6375,78,5378,11831
"2012","GEORGIA","TALBOT",2265,24,1202,3491
"2012","GEORGIA","TALIAFERRO",636,4,323,963
"2012","GEORGIA","TATTNALL",1897,64,4706,6667
"2012","GEORGIA","TAYLOR",1572,18,1948,3538
"2012","GEORGIA","TELFAIR",1805,51,2480,4336
"2012","GEORGIA","TERRELL",2544,20,1834,4398
"2012","GEORGIA","THOMAS",7653,144,11156,18953
"2012","GEORGIA","TIFT",4660,82,9185,13927
"2012","GEORGIA","TOOMBS",2746,74,6524,9344
"2012","GEORGIA","TOWNS",1273,62,4876,6211
"2012","GEORGIA","TREUTLEN",1074,24,1652,2750
"2012","GEORGIA","TROUP",10547,260,15179,25986
"2012","GEORGIA","TURNER",1510,21,2028,3559
"2012","GEORGIA","TWIGGS",2270,25,1907,4202
"2012","GEORGIA","UNION",2139,167,8773,11079
"2012","GEORGIA","UPSON",3959,74,7230,11263
"2012","GEORGIA","WALKER",5274,375,16247,21896
"2012","GEORGIA","WALTON",8148,428,29036,37612
"2012","GEORGIA","WARE",3900,98,7941,11939
"2012","GEORGIA","WARREN",1529,7,990,2526
"2012","GEORGIA","WASHINGTON",4714,59,4035,8808
"2012","GEORGIA","WAYNE",2596,116,7557,10269
"2012","GEORGIA","WEBSTER",582,4,601,1187
"2012","GEORGIA","WHEELER",772,22,1366,2160
"2012","GEORGIA","WHITE",1671,166,8651,10488
"2012","GEORGIA","WHITFIELD",7210,361,19305,26876
"2012","GEORGIA","WILCOX",1060,16,2053,3129
"2012","GEORGIA","WILKES",2087,39,2635,4761
"2012","GEORGIA","WILKINSON",2181,23,2246,4450
"2012","GEORGIA","WORTH",2487,63,5869,8419
"2012","HAWAII","HAWAII",47224,1477,14753,63454
"2012","HAWAII","HONOLULU",204349,3932,88461,296742
"2012","HAWAII","KAUAI",18641,610,6121,25372
"2012","HAWAII","MAUI",36052,999,11602,48653
"2012","IDAHO","ADA",77137,5855,97554,180546
"2012","IDAHO","ADAMS",577,70,1413,2060
"2012","IDAHO","BANNOCK",13214,1036,21010,35260
"2012","IDAHO","BEAR LAKE",302,31,2489,2822
"2012","IDAHO","BENEWAH",1164,124,2596,3884
"2012","IDAHO","BINGHAM",3822,341,13440,17603
"2012","IDAHO","BLAINE",5992,263,3939,10194
"2012","IDAHO","BOISE",1053,108,2284,3445
"2012","IDAHO","BONNER",6500,669,11367,18536
"2012","IDAHO","BONNEVILLE",9903,1034,32276,43213
"2012","IDAHO","BOUNDARY",1225,181,3138,4544
"2012","IDAHO","BUTTE",258,27,1001,1286
"2012","IDAHO","CAMAS",159,17,402,578
"2012","IDAHO","CANYON",19866,1855,44369,66090
"2012","IDAHO","CARIBOU",386,58,2608,3052
"2012","IDAHO","CASSIA",1098,144,7154,8396
"2012","IDAHO","CLARK",66,27,235,328
"2012","IDAHO","CLEARWATER",1032,123,2541,3696
"2012","IDAHO","CUSTER",530,78,1744,2352
"2012","IDAHO","ELMORE",2513,261,5227,8001
"2012","IDAHO","FRANKLIN",325,80,5195,5600
"2012","IDAHO","FREMONT",810,85,4907,5802
"2012","IDAHO","GEM",1957,222,5311,7490
"2012","IDAHO","GOODING",1287,135,3696,5118
"2012","IDAHO","IDAHO",1708,208,5921,7837
"2012","IDAHO","JEFFERSON",1303,183,9895,11381
"2012","IDAHO","JEROME",1699,178,4804,6681
"2012","IDAHO","KOOTENAI",18851,1596,39381,59828
"2012","IDAHO","LATAH",8306,864,7589,16759
"2012","IDAHO","LEMHI",960,121,3029,4110
"2012","IDAHO","LEWIS",396,45,1173,1614
"2012","IDAHO","LINCOLN",469,52,1141,1662
"2012","IDAHO","MADISON",832,135,13445,14412
"2012","IDAHO","MINIDOKA",1390,141,5442,6973
"2012","IDAHO","NEZ PERCE",6451,430,9967,16848
"2012","IDAHO","ONEIDA",217,34,1838,2089
"2012","IDAHO","OWYHEE",833,97,2794,3724
"2012","IDAHO","PAYETTE",2271,220,6004,8495
"2012","IDAHO","POWER",982,51,1870,2903
"2012","IDAHO","SHOSHONE",2277,172,2699,5148
"2012","IDAHO","TETON",1926,139,2458,4523
"2012","IDAHO","TWIN FALLS",7541,828,19773,28142
"2012","IDAHO","VALLEY",2095,160,2664,4919
"2012","IDAHO","WASHINGTON",1104,98,3128,4330
"2012","ILLINOIS","ADAMS",9648,543,20416,30607
"2012","ILLINOIS","ALEXANDER",1965,49,1487,3501
"2012","ILLINOIS","BOND",3020,221,4095,7336
"2012","ILLINOIS","BOONE",9883,386,11096,21365
"2012","ILLINOIS","BROWN",787,64,1513,2364
"2012","ILLINOIS","BUREAU",8134,333,8164,16631
"2012","ILLINOIS","CALHOUN",1080,56,1440,2576
"2012","ILLINOIS","CARROLL",3665,166,3555,7386
"2012","ILLINOIS","CASS",2053,102,2707,4862
"2012","ILLINOIS","CHAMPAIGN",40831,2216,35312,78359
"2012","ILLINOIS","CHRISTIAN",5494,322,8885,14701
"2012","ILLINOIS","CLARK",2591,125,5144,7860
"2012","ILLINOIS","CLAY",1584,134,4190,5908
"2012","ILLINOIS","CLINTON",5596,330,10524,16450
"2012","ILLINOIS","COLES",9262,465,11631,21358
"2012","ILLINOIS","COOK",1488537,27518,495542,2011597
"2012","ILLINOIS","CRAWFORD",2858,166,5585,8609
"2012","ILLINOIS","CUMBERLAND",1641,145,3509,5295
"2012","ILLINOIS","DE WITT",2601,165,4579,7345
"2012","ILLINOIS","DEKALB",21207,951,18934,41092
"2012","ILLINOIS","DOUGLAS",2430,133,5334,7897
"2012","ILLINOIS","DUPAGE",199460,6573,195046,401079
"2012","ILLINOIS","EDGAR",2565,122,5132,7819
"2012","ILLINOIS","EDWARDS",754,69,2405,3228
"2012","ILLINOIS","EFFINGHAM",3861,251,12501,16613
"2012","ILLINOIS","FAYETTE",2853,167,5951,8971
"2012","ILLINOIS","FORD",1656,121,4229,6006
"2012","ILLINOIS","FRANKLIN",7254,393,10267,17914
"2012","ILLINOIS","FULTON",8328,396,6632,15356
"2012","ILLINOIS","GALLATIN",1029,52,1492,2573
"2012","ILLINOIS","GREENE",2023,148,3451,5622
"2012","ILLINOIS","GRUNDY",9451,450,11343,21244
"2012","ILLINOIS","HAMILTON",1269,106,2566,3941
"2012","ILLINOIS","HANCOCK",3650,190,5271,9111
"2012","ILLINOIS","HARDIN",742,53,1535,2330
"2012","ILLINOIS","HENDERSON",1978,49,1541,3568
"2012","ILLINOIS","HENRY",12332,407,11583,24322
"2012","ILLINOIS","IROQUOIS",3413,251,9120,12784
"2012","ILLINOIS","JACKSON",13319,829,9864,24012
"2012","ILLINOIS","JASPER",1436,93,3514,5043
"2012","ILLINOIS","JEFFERSON",6089,420,9811,16320
"2012","ILLINOIS","JERSEY",3667,253,6039,9959
"2012","ILLINOIS","JO DAVIESS",5667,228,5534,11429
"2012","ILLINOIS","JOHNSON",1572,137,3963,5672
"2012","ILLINOIS","KANE",90332,2975,88335,181642
"2012","ILLINOIS","KANKAKEE",21595,778,23136,45509
"2012","ILLINOIS","KENDALL",22471,777,24047,47295
"2012","ILLINOIS","KNOX",13451,419,9408,23278
"2012","ILLINOIS","LAKE",153757,3972,129764,287493
"2012","ILLINOIS","LASALLE",23073,930,23256,47259
"2012","ILLINOIS","LAWRENCE",2011,121,3857,5989
"2012","ILLINOIS","LEE",6937,305,8059,15301
"2012","ILLINOIS","LIVINGSTON",5020,266,9753,15039
"2012","ILLINOIS","LOGAN",3978,231,7844,12053
"2012","ILLINOIS","MACON",22780,810,25309,48899
"2012","ILLINOIS","MACOUPIN",9464,600,10946,21010
"2012","ILLINOIS","MADISON",58922,2943,60608,122473
"2012","ILLINOIS","MARION",6225,291,9248,15764
"2012","ILLINOIS","MARSHALL",2455,105,3290,5850
"2012","ILLINOIS","MASON",2867,140,3265,6272
"2012","ILLINOIS","MASSAC",2092,125,4278,6495
"2012","ILLINOIS","MCDONOUGH",5967,340,6147,12454
"2012","ILLINOIS","MCHENRY",59797,2449,71598,133844
"2012","ILLINOIS","MCLEAN",31883,1552,39947,73382
"2012","ILLINOIS","MENARD",2100,103,3948,6151
"2012","ILLINOIS","MERCER",4507,151,3876,8534
"2012","ILLINOIS","MONROE",6215,329,10888,17432
"2012","ILLINOIS","MONTGOMERY",5058,299,6776,12133
"2012","ILLINOIS","MORGAN",5806,318,7972,14096
"2012","ILLINOIS","MOULTRIE",2144,129,3784,6057
"2012","ILLINOIS","OGLE",9514,431,13422,23367
"2012","ILLINOIS","PEORIA",40209,1428,36774,78411
"2012","ILLINOIS","PERRY",3819,223,5507,9549
"2012","ILLINOIS","PIATT",3090,204,5413,8707
"2012","ILLINOIS","PIKE",2278,148,4860,7286
"2012","ILLINOIS","POPE",650,60,1512,2222
"2012","ILLINOIS","PULASKI",1389,50,1564,3003
"2012","ILLINOIS","PUTNAM",1559,74,1502,3135
"2012","ILLINOIS","RANDOLPH",5759,343,8290,14392
"2012","ILLINOIS","RICHLAND",2362,164,4756,7282
"2012","ILLINOIS","ROCK ISLAND",39157,925,24934,65016
"2012","ILLINOIS","SALINE",3701,213,6806,10720
"2012","ILLINOIS","SANGAMON",42107,1965,50225,94297
"2012","ILLINOIS","SCHUYLER",1727,94,2069,3890
"2012","ILLINOIS","SCOTT",910,58,1587,2555
"2012","ILLINOIS","SHELBY",3342,210,6843,10395
"2012","ILLINOIS","ST. CLAIR",67285,2056,50125,119466
"2012","ILLINOIS","STARK",1095,39,1528,2662
"2012","ILLINOIS","STEPHENSON",10165,378,10512,21055
"2012","ILLINOIS","TAZEWELL",24438,1275,35335,61048
"2012","ILLINOIS","UNION",3137,188,4957,8282
"2012","ILLINOIS","VERMILION",12878,544,16892,30314
"2012","ILLINOIS","WABASH",1590,66,3478,5134
"2012","ILLINOIS","WARREN",4044,131,3618,7793
"2012","ILLINOIS","WASHINGTON",2450,163,4792,7405
"2012","ILLINOIS","WAYNE",1514,178,5988,7680
"2012","ILLINOIS","WHITE",2188,145,4731,7064
"2012","ILLINOIS","WHITESIDE",14833,487,10334,25654
"2012","ILLINOIS","WILL",144229,4189,128969,277387
"2012","ILLINOIS","WILLIAMSON",10647,587,17909,29143
"2012","ILLINOIS","WINNEBAGO",61732,2114,55138,118984
"2012","ILLINOIS","WOODFORD",5572,341,12961,18874
"2012","INDIANA","ADAMS",3806,268,8937,13011
"2012","INDIANA","ALLEN",60036,2290,84613,146939
"2012","INDIANA","BARTHOLOMEW",10625,618,18083,29326
"2012","INDIANA","BENTON",1159,90,2329,3578
"2012","INDIANA","BLACKFORD",1927,105,2711,4743
"2012","INDIANA","BOONE",8328,601,18808,27737
"2012","INDIANA","BROWN",3060,212,4332,7604
"2012","INDIANA","CARROLL",2635,176,4999,7810
"2012","INDIANA","CASS",5371,347,8443,14161
"2012","INDIANA","CLARK",20807,889,25450,47146
"2012","INDIANA","CLAY",3460,228,7096,10784
"2012","INDIANA","CLINTON",3308,237,6338,9883
"2012","INDIANA","CRAWFORD",2041,128,2421,4590
"2012","INDIANA","DAVIESS",2437,175,7638,10250
"2012","INDIANA","DEARBORN",6528,434,15394,22356
"2012","INDIANA","DECATUR",2941,248,7119,10308
"2012","INDIANA","DEKALB",5419,322,10587,16328
"2012","INDIANA","DELAWARE",22654,1063,21251,44968
"2012","INDIANA","DUBOIS",6522,366,11654,18542
"2012","INDIANA","ELKHART",24399,1075,42378,67852
"2012","INDIANA","FAYETTE",3555,237,5045,8837
"2012","INDIANA","FLOYD",14812,615,19878,35305
"2012","INDIANA","FOUNTAIN",2237,210,4664,7111
"2012","INDIANA","FRANKLIN",2909,227,7424,10560
"2012","INDIANA","FULTON",2621,188,5317,8126
"2012","INDIANA","GIBSON",4928,306,9487,14721
"2012","INDIANA","GRANT",9589,545,15151,25285
"2012","INDIANA","GREENE",4350,304,8457,13111
"2012","INDIANA","HAMILTON",43796,2320,90747,136863
"2012","INDIANA","HANCOCK",9319,728,22796,32843
"2012","INDIANA","HARRISON",6607,424,10640,17671
"2012","INDIANA","HENDRICKS",21112,1220,44312,66644
"2012","INDIANA","HENRY",7613,556,10838,19007
"2012","INDIANA","HOWARD",15135,828,20327,36290
"2012","INDIANA","HUNTINGTON",4596,307,10862,15765
"2012","INDIANA","JACKSON",5838,455,10419,16712
"2012","INDIANA","JASPER",4672,269,7955,12896
"2012","INDIANA","JAY",3063,193,4645,7901
"2012","INDIANA","JEFFERSON",5728,302,7096,13126
"2012","INDIANA","JENNINGS",3821,309,6120,10250
"2012","INDIANA","JOHNSON",17260,1191,39513,57964
"2012","INDIANA","KNOX",5228,305,9612,15145
"2012","INDIANA","KOSCIUSKO",6862,640,22558,30060
"2012","INDIANA","LAGRANGE",2898,187,6231,9316
"2012","INDIANA","LAKE",130897,2430,68431,201758
"2012","INDIANA","LAPORTE",24107,959,18615,43681
"2012","INDIANA","LAWRENCE",5779,421,11622,17822
"2012","INDIANA","MADISON",24407,1194,26769,52370
"2012","INDIANA","MARION",216336,6164,136509,359009
"2012","INDIANA","MARSHALL",6137,368,11260,17765
"2012","INDIANA","MARTIN",1351,130,3262,4743
"2012","INDIANA","MIAMI",4222,385,8174,12781
"2012","INDIANA","MONROE",33436,1306,22481,57223
"2012","INDIANA","MONTGOMERY",4271,345,9824,14440
"2012","INDIANA","MORGAN",7969,706,19591,28266
"2012","INDIANA","NEWTON",2212,151,3291,5654
"2012","INDIANA","NOBLE",5229,335,10680,16244
"2012","INDIANA","OHIO",994,66,1759,2819
"2012","INDIANA","ORANGE",2939,220,4617,7776
"2012","INDIANA","OWEN",2823,228,5062,8113
"2012","INDIANA","PARKE",2110,171,4234,6515
"2012","INDIANA","PERRY",4316,156,3403,7875
"2012","INDIANA","PIKE",2125,174,3627,5926
"2012","INDIANA","PORTER",37252,1381,34406,73039
"2012","INDIANA","POSEY",4533,263,7430,12226
"2012","INDIANA","PULASKI",1899,134,3366,5399
"2012","INDIANA","PUTNAM",4507,317,9005,13829
"2012","INDIANA","RANDOLPH",3769,202,6218,10189
"2012","INDIANA","RIPLEY",3241,258,7484,10983
"2012","INDIANA","RUSH",2221,172,4633,7026
"2012","INDIANA","SCOTT",3998,183,4539,8720
"2012","INDIANA","SHELBY",5359,423,10978,16760
"2012","INDIANA","SPENCER",4026,187,5515,9728
"2012","INDIANA","ST. JOSEPH",56460,1666,52578,110704
"2012","INDIANA","STARKE",3809,207,4738,8754
"2012","INDIANA","STEUBEN",4853,295,8547,13695
"2012","INDIANA","SULLIVAN",3191,197,4902,8290
"2012","INDIANA","SWITZERLAND",1437,88,1872,3397
"2012","INDIANA","TIPPECANOE",26711,1428,28757,56896
"2012","INDIANA","TIPTON",2432,160,4773,7365
"2012","INDIANA","UNION",1018,60,2022,3100
"2012","INDIANA","VANDERBURGH",31725,1290,39389,72404
"2012","INDIANA","VERMILLION",2979,176,3426,6581
"2012","INDIANA","VIGO",19712,796,19369,39877
"2012","INDIANA","WABASH",3973,257,8644,12874
"2012","INDIANA","WARREN",1324,99,2377,3800
"2012","INDIANA","WARRICK",8793,486,15351,24630
"2012","INDIANA","WASHINGTON",3909,295,6533,10737
"2012","INDIANA","WAYNE",10591,565,14321,25477
"2012","INDIANA","WELLS",3436,243,9256,12935
"2012","INDIANA","WHITE",3637,296,5970,9903
"2012","INDIANA","WHITLEY",4420,333,10258,15011
"2012","IOWA","ADAIR",1790,92,2114,3996
"2012","IOWA","ADAMS",1028,49,1108,2185
"2012","IOWA","ALLAMAKEE",3553,117,3264,6934
"2012","IOWA","APPANOOSE",2951,133,3161,6245
"2012","IOWA","AUDUBON",1611,44,1802,3457
"2012","IOWA","BENTON",6862,221,6940,14023
"2012","IOWA","BLACK HAWK",39821,1085,26235,67141
"2012","IOWA","BOONE",7512,320,6556,14388
"2012","IOWA","BREMER",6763,178,6405,13346
"2012","IOWA","BUCHANAN",5911,174,4450,10535
"2012","IOWA","BUENA VISTA",3700,129,4554,8383
"2012","IOWA","BUTLER",3329,110,4106,7545
"2012","IOWA","CALHOUN",2238,101,2891,5230
"2012","IOWA","CARROLL",4947,126,5601,10674
"2012","IOWA","CASS",2858,130,4217,7205
"2012","IOWA","CEDAR",4972,148,4529,9649
"2012","IOWA","CERRO GORDO",13316,380,10128,23824
"2012","IOWA","CHEROKEE",2634,119,3662,6415
"2012","IOWA","CHICKASAW",3554,94,2836,6484
"2012","IOWA","CLARKE",2189,117,2124,4430
"2012","IOWA","CLAY",3385,166,4951,8502
"2012","IOWA","CLAYTON",4806,168,4164,9138
"2012","IOWA","CLINTON",15141,427,9432,25000
"2012","IOWA","CRAWFORD",3066,91,3595,6752
"2012","IOWA","DALLAS",16576,552,20988,38116
"2012","IOWA","DAVIS",1520,115,2138,3773
"2012","IOWA","DECATUR",1791,95,1947,3833
"2012","IOWA","DELAWARE",4616,126,4636,9378
"2012","IOWA","DES MOINES",11888,361,8136,20385
"2012","IOWA","DICKINSON",4095,152,5912,10159
"2012","IOWA","DUBUQUE",28768,846,21280,50894
"2012","IOWA","EMMET",2099,81,2507,4687
"2012","IOWA","FAYETTE",5732,142,4492,10366
"2012","IOWA","FLOYD",4680,105,3472,8257
"2012","IOWA","FRANKLIN",2266,97,2823,5186
"2012","IOWA","FREMONT",1637,59,1972,3668
"2012","IOWA","GREENE",2375,91,2380,4846
"2012","IOWA","GRUNDY",2635,112,4215,6962
"2012","IOWA","GUTHRIE",2569,148,3171,5888
"2012","IOWA","HAMILTON",3782,154,3991,7927
"2012","IOWA","HANCOCK",2521,87,3317,5925
"2012","IOWA","HARDIN",4075,153,4670,8898
"2012","IOWA","HARRISON",3136,121,4065,7322
"2012","IOWA","HENRY",4460,202,5035,9697
"2012","IOWA","HOWARD",2768,82,1795,4645
"2012","IOWA","HUMBOLDT",1972,87,3099,5158
"2012","IOWA","IDA",1321,56,2286,3663
"2012","IOWA","IOWA",4144,153,4569,8866
"2012","IOWA","JACKSON",5907,158,4177,10242
"2012","IOWA","JASPER",10257,381,8877,19515
"2012","IOWA","JEFFERSON",4798,296,3436,8530
"2012","IOWA","JOHNSON",50666,1613,23698,75977
"2012","IOWA","JONES",5534,194,4721,10449
"2012","IOWA","KEOKUK",2303,120,2843,5266
"2012","IOWA","KOSSUTH",3850,136,4937,8923
"2012","IOWA","LEE",10714,412,7785,18911
"2012","IOWA","LINN",68581,2250,47622,118453
"2012","IOWA","LOUISA",2452,96,2420,4968
"2012","IOWA","LUCAS",1987,82,2254,4323
"2012","IOWA","LYON",1423,108,4978,6509
"2012","IOWA","MADISON",3630,190,4638,8458
"2012","IOWA","MAHASKA",4213,222,6448,10883
"2012","IOWA","MARION",7507,352,9828,17687
"2012","IOWA","MARSHALL",10257,335,8472,19064
"2012","IOWA","MILLS",2848,148,4216,7212
"2012","IOWA","MITCHELL",2831,112,2643,5586
"2012","IOWA","MONONA",2101,84,2557,4742
"2012","IOWA","MONROE",1731,73,2026,3830
"2012","IOWA","MONTGOMERY",1922,102,3001,5025
"2012","IOWA","MUSCATINE",11323,374,8168,19865
"2012","IOWA","O'BRIEN",1969,106,5266,7341
"2012","IOWA","OSCEOLA",912,52,2230,3194
"2012","IOWA","PAGE",2613,118,4348,7079
"2012","IOWA","PALO ALTO",2139,88,2660,4887
"2012","IOWA","PLYMOUTH",4164,189,8597,12950
"2012","IOWA","POCAHONTAS",1523,113,2396,4032
"2012","IOWA","POLK",128465,4321,96096,228882
"2012","IOWA","POTTAWATTAMIE",19644,797,21860,42301
"2012","IOWA","POWESHIEK",5357,194,4424,9975
"2012","IOWA","RINGGOLD",1186,45,1368,2599
"2012","IOWA","SAC",2122,75,3094,5291
"2012","IOWA","SCOTT",50652,1360,38251,90263
"2012","IOWA","SHELBY",2469,103,3911,6483
"2012","IOWA","SIOUX",2700,201,14407,17308
"2012","IOWA","STORY",26192,1290,19668,47150
"2012","IOWA","TAMA",4768,151,4098,9017
"2012","IOWA","TAYLOR",1262,50,1683,2995
"2012","IOWA","UNION",3043,101,2813,5957
"2012","IOWA","VAN BUREN",1402,103,2064,3569
"2012","IOWA","WAPELLO",8663,318,6789,15770
"2012","IOWA","WARREN",12551,469,13052,26072
"2012","IOWA","WASHINGTON",5115,327,5562,11004
"2012","IOWA","WAYNE",1251,66,1583,2900
"2012","IOWA","WEBSTER",9537,286,8469,18292
"2012","IOWA","WINNEBAGO",2903,109,2906,5918
"2012","IOWA","WINNESHIEK",6256,206,4622,11084
"2012","IOWA","WOODBURY",22302,876,21841,45019
"2012","IOWA","WORTH",2350,78,1744,4172
"2012","IOWA","WRIGHT",2836,93,3349,6278
"2012","KANSAS","ALLEN",1869,125,3316,5310
"2012","KANSAS","ANDERSON",944,95,2276,3315
"2012","KANSAS","ATCHISON",2567,190,3917,6674
"2012","KANSAS","BARBER",482,60,1772,2314
"2012","KANSAS","BARTON",2297,170,7874,10341
"2012","KANSAS","BOURBON",1996,156,4102,6254
"2012","KANSAS","BROWN",1076,88,2829,3993
"2012","KANSAS","BUTLER",7282,646,18157,26085
"2012","KANSAS","CHASE",358,38,875,1271
"2012","KANSAS","CHAUTAUQUA",280,46,1304,1630
"2012","KANSAS","CHEROKEE",2930,185,5456,8571
"2012","KANSAS","CHEYENNE",233,34,1159,1426
"2012","KANSAS","CLARK",174,38,805,1017
"2012","KANSAS","CLAY",834,64,2788,3686
"2012","KANSAS","CLOUD",974,130,2954,4058
"2012","KANSAS","COFFEY",898,105,2903,3906
"2012","KANSAS","COMANCHE",143,18,767,928
"2012","KANSAS","COWLEY",4319,310,8081,12710
"2012","KANSAS","CRAWFORD",6826,411,7708,14945
"2012","KANSAS","DECATUR",266,48,1218,1532
"2012","KANSAS","DICKINSON",2020,190,5832,8042
"2012","KANSAS","DONIPHAN",902,87,2414,3403
"2012","KANSAS","DOUGLAS",29267,1477,17401,48145
"2012","KANSAS","EDWARDS",298,28,1059,1385
"2012","KANSAS","ELK",281,39,1049,1369
"2012","KANSAS","ELLIS",3057,258,8399,11714
"2012","KANSAS","ELLSWORTH",702,80,1930,2712
"2012","KANSAS","FINNEY",2682,183,6219,9084
"2012","KANSAS","FORD",2600,160,5602,8362
"2012","KANSAS","FRANKLIN",3694,312,6984,10990
"2012","KANSAS","GEARY",3332,141,4372,7845
"2012","KANSAS","GOVE",176,39,1168,1383
"2012","KANSAS","GRAHAM",256,28,1056,1340
"2012","KANSAS","GRANT",456,39,1811,2306
"2012","KANSAS","GRAY",324,31,1603,1958
"2012","KANSAS","GREELEY",113,14,543,670
"2012","KANSAS","GREENWOOD",478,55,1590,2123
"2012","KANSAS","HAMILTON",163,21,693,877
"2012","KANSAS","HARPER",550,80,1759,2389
"2012","KANSAS","HARVEY",5373,333,8588,14294
"2012","KANSAS","HASKELL",215,22,1159,1396
"2012","KANSAS","HODGEMAN",179,13,868,1060
"2012","KANSAS","JACKSON",1901,133,3527,5561
"2012","KANSAS","JEFFERSON",2977,209,4827,8013
"2012","KANSAS","JEWELL",229,33,1235,1497
"2012","KANSAS","JOHNSON",110526,5438,158401,274365
"2012","KANSAS","KEARNY",268,21,1097,1386
"2012","KANSAS","KINGMAN",733,101,2397,3231
"2012","KANSAS","KIOWA",163,5,976,1144
"2012","KANSAS","LABETTE",3117,178,4742,8037
"2012","KANSAS","LANE",172,17,739,928
"2012","KANSAS","LEAVENWORTH",11357,669,17059,29085
"2012","KANSAS","LINCOLN",289,29,1165,1483
"2012","KANSAS","LINN",1170,120,3177,4467
"2012","KANSAS","LOGAN",197,27,1126,1350
"2012","KANSAS","LYON",5111,294,6470,11875
"2012","KANSAS","MARION",1385,135,3889,5409
"2012","KANSAS","MARSHALL",1469,109,3195,4773
"2012","KANSAS","MCPHERSON",3449,303,8545,12297
"2012","KANSAS","MEADE",258,23,1428,1709
"2012","KANSAS","MIAMI",4712,286,9858,14856
"2012","KANSAS","MITCHELL",584,54,2327,2965
"2012","KANSAS","MONTGOMERY",3501,286,8630,12417
"2012","KANSAS","MORRIS",718,71,1773,2562
"2012","KANSAS","MORTON",189,17,1072,1278
"2012","KANSAS","NEMAHA",1000,96,3930,5026
"2012","KANSAS","NEOSHO",2050,158,4272,6480
"2012","KANSAS","NESS",218,17,1209,1444
"2012","KANSAS","NORTON",398,49,1878,2325
"2012","KANSAS","OSAGE",2268,211,4427,6906
"2012","KANSAS","OSBORNE",324,35,1479,1838
"2012","KANSAS","OTTAWA",558,80,2295,2933
"2012","KANSAS","PAWNEE",718,54,1836,2608
"2012","KANSAS","PHILLIPS",382,48,2135,2565
"2012","KANSAS","POTTAWATOMIE",2335,340,6804,9479
"2012","KANSAS","PRATT",980,50,2771,3801
"2012","KANSAS","RAWLINS",190,31,1223,1444
"2012","KANSAS","RENO",8085,619,15718,24422
"2012","KANSAS","REPUBLIC",477,75,2134,2686
"2012","KANSAS","RICE",911,94,2676,3681
"2012","KANSAS","RILEY",8977,617,11507,21101
"2012","KANSAS","ROOKS",361,61,2038,2460
"2012","KANSAS","RUSH",367,37,1166,1570
"2012","KANSAS","RUSSELL",593,54,2553,3200
"2012","KANSAS","SALINE",7040,616,13840,21496
"2012","KANSAS","SCOTT",277,47,1728,2052
"2012","KANSAS","SEDGWICK",71977,4412,106506,182895
"2012","KANSAS","SEWARD",1490,69,3617,5176
"2012","KANSAS","SHAWNEE",36975,1751,37782,76508
"2012","KANSAS","SHERIDAN",168,20,1154,1342
"2012","KANSAS","SHERMAN",577,70,1976,2623
"2012","KANSAS","SMITH",358,41,1624,2023
"2012","KANSAS","STAFFORD",404,50,1385,1839
"2012","KANSAS","STANTON",143,11,605,759
"2012","KANSAS","STEVENS",252,33,1749,2034
"2012","KANSAS","SUMNER",2658,223,6260,9141
"2012","KANSAS","THOMAS",598,88,2788,3474
"2012","KANSAS","TREGO",291,27,1261,1579
"2012","KANSAS","WABAUNSEE",918,93,2256,3267
"2012","KANSAS","WALLACE",68,11,719,798
"2012","KANSAS","WASHINGTON",524,49,2316,2889
"2012","KANSAS","WICHITA",157,9,821,987
"2012","KANSAS","WILSON",818,74,2825,3717
"2012","KANSAS","WOODSON",380,32,1035,1447
"2012","KANSAS","WYANDOTTE",34302,940,15496,50738
"2012","KENTUCKY","ADAIR",1660,99,5841,7600
"2012","KENTUCKY","ALLEN",1808,108,5184,7100
"2012","KENTUCKY","ANDERSON",3315,183,6822,10320
"2012","KENTUCKY","BALLARD",1189,59,2647,3895
"2012","KENTUCKY","BARREN",5400,246,10922,16568
"2012","KENTUCKY","BATH",1770,77,2275,4122
"2012","KENTUCKY","BELL",2224,131,7127,9482
"2012","KENTUCKY","BOONE",15629,960,35922,52511
"2012","KENTUCKY","BOURBON",3075,156,4692,7923
"2012","KENTUCKY","BOYD",7776,389,10884,19049
"2012","KENTUCKY","BOYLE",4471,199,7703,12373
"2012","KENTUCKY","BRACKEN",1147,56,2029,3232
"2012","KENTUCKY","BREATHITT",1562,128,3318,5008
"2012","KENTUCKY","BRECKINRIDGE",2825,119,5025,7969
"2012","KENTUCKY","BULLITT",9971,502,21306,31779
"2012","KENTUCKY","BUTLER",1293,51,3716,5060
"2012","KENTUCKY","CALDWELL",1852,104,3904,5860
"2012","KENTUCKY","CALLOWAY",5317,315,9440,15072
"2012","KENTUCKY","CAMPBELL",15080,857,24240,40177
"2012","KENTUCKY","CARLISLE",750,34,1835,2619
"2012","KENTUCKY","CARROLL",1629,52,1999,3680
"2012","KENTUCKY","CARTER",3383,246,5279,8908
"2012","KENTUCKY","CASEY",1086,101,4904,6091
"2012","KENTUCKY","CHRISTIAN",8252,228,13475,21955
"2012","KENTUCKY","CLARK",5228,257,9931,15416
"2012","KENTUCKY","CLAY",1111,96,6176,7383
"2012","KENTUCKY","CLINTON",752,72,3569,4393
"2012","KENTUCKY","CRITTENDEN",960,55,2839,3854
"2012","KENTUCKY","CUMBERLAND",599,39,2216,2854
"2012","KENTUCKY","DAVIESS",16208,787,25092,42087
"2012","KENTUCKY","EDMONSON",1374,62,3232,4668
"2012","KENTUCKY","ELLIOTT",1186,87,1126,2399
"2012","KENTUCKY","ESTILL",1356,79,3749,5184
"2012","KENTUCKY","FAYETTE",62080,2991,60795,125866
"2012","KENTUCKY","FLEMING",1911,91,3780,5782
"2012","KENTUCKY","FLOYD",4733,373,9784,14890
"2012","KENTUCKY","FRANKLIN",11535,457,11345,23337
"2012","KENTUCKY","FULTON",1022,34,1425,2481
"2012","KENTUCKY","GALLATIN",1238,65,1758,3061
"2012","KENTUCKY","GARRARD",1661,106,5310,7077
"2012","KENTUCKY","GRANT",2810,134,5664,8608
"2012","KENTUCKY","GRAVES",4547,257,10699,15503
"2012","KENTUCKY","GRAYSON",2744,123,6404,9271
"2012","KENTUCKY","GREEN",1165,57,3634,4856
"2012","KENTUCKY","GREENUP",6027,286,8855,15168
"2012","KENTUCKY","HANCOCK",1833,89,2212,4134
"2012","KENTUCKY","HARDIN",15214,647,23357,39218
"2012","KENTUCKY","HARLAN",1830,175,8652,10657
"2012","KENTUCKY","HARRISON",2471,136,4556,7163
"2012","KENTUCKY","HART",2283,82,4257,6622
"2012","KENTUCKY","HENDERSON",8091,235,10296,18622
"2012","KENTUCKY","HENRY",2530,120,3940,6590
"2012","KENTUCKY","HICKMAN",686,22,1431,2139
"2012","KENTUCKY","HOPKINS",5789,297,13681,19767
"2012","KENTUCKY","JACKSON",612,84,4365,5061
"2012","KENTUCKY","JEFFERSON",186181,4975,148423,339579
"2012","KENTUCKY","JESSAMINE",6001,399,14233,20633
"2012","KENTUCKY","JOHNSON",1723,217,7095,9035
"2012","KENTUCKY","KENTON",24920,1395,41389,67704
"2012","KENTUCKY","KNOTT",1420,143,4130,5693
"2012","KENTUCKY","KNOX",2484,149,8467,11100
"2012","KENTUCKY","LARUE",1733,120,3911,5764
"2012","KENTUCKY","LAUREL",3905,352,18151,22408
"2012","KENTUCKY","LAWRENCE",1520,77,3995,5592
"2012","KENTUCKY","LEE",595,51,1977,2623
"2012","KENTUCKY","LESLIE",433,78,4439,4950
"2012","KENTUCKY","LETCHER",1702,245,6811,8758
"2012","KENTUCKY","LEWIS",1342,101,3326,4769
"2012","KENTUCKY","LINCOLN",2582,154,6416,9152
"2012","KENTUCKY","LIVINGSTON",1346,76,3089,4511
"2012","KENTUCKY","LOGAN",3469,142,6899,10510
"2012","KENTUCKY","LYON",1373,54,2412,3839
"2012","KENTUCKY","MADISON",11512,682,21128,33322
"2012","KENTUCKY","MAGOFFIN",1433,82,3391,4906
"2012","KENTUCKY","MARION",3418,100,3800,7318
"2012","KENTUCKY","MARSHALL",5022,295,10402,15719
"2012","KENTUCKY","MARTIN",574,70,3180,3824
"2012","KENTUCKY","MASON",2592,92,4197,6881
"2012","KENTUCKY","MCCRACKEN",10062,510,19979,30551
"2012","KENTUCKY","MCCREARY",1069,74,4564,5707
"2012","KENTUCKY","MCLEAN",1432,63,2705,4200
"2012","KENTUCKY","MEADE",4122,188,6606,10916
"2012","KENTUCKY","MENIFEE",1048,66,1484,2598
"2012","KENTUCKY","MERCER",2966,153,6820,9939
"2012","KENTUCKY","METCALFE",1425,83,2676,4184
"2012","KENTUCKY","MONROE",936,48,3762,4746
"2012","KENTUCKY","MONTGOMERY",3701,149,6398,10248
"2012","KENTUCKY","MORGAN",1369,82,3021,4472
"2012","KENTUCKY","MUHLENBERG",4771,206,7762,12739
"2012","KENTUCKY","NELSON",7611,249,10673,18533
"2012","KENTUCKY","NICHOLAS",948,50,1583,2581
"2012","KENTUCKY","OHIO",2987,189,6470,9646
"2012","KENTUCKY","OLDHAM",9240,465,20179,29884
"2012","KENTUCKY","OWEN",1501,85,2971,4557
"2012","KENTUCKY","OWSLEY",283,18,1279,1580
"2012","KENTUCKY","PENDLETON",1859,119,3556,5534
"2012","KENTUCKY","PERRY",2047,154,8040,10241
"2012","KENTUCKY","PIKE",5646,400,17590,23636
"2012","KENTUCKY","POWELL",1620,95,2766,4481
"2012","KENTUCKY","PULASKI",4976,313,20714,26003
"2012","KENTUCKY","ROBERTSON",340,16,579,935
"2012","KENTUCKY","ROCKCASTLE",1097,91,5028,6216
"2012","KENTUCKY","ROWAN",3438,192,4035,7665
"2012","KENTUCKY","RUSSELL",1445,118,6346,7909
"2012","KENTUCKY","SCOTT",7532,362,12679,20573
"2012","KENTUCKY","SHELBY",6634,239,11790,18663
"2012","KENTUCKY","SIMPSON",2650,88,4355,7093
"2012","KENTUCKY","SPENCER",2549,156,5726,8431
"2012","KENTUCKY","TAYLOR",3285,114,7551,10950
"2012","KENTUCKY","TODD",1403,68,3247,4718
"2012","KENTUCKY","TRIGG",2115,107,4520,6742
"2012","KENTUCKY","TRIMBLE",1355,55,2133,3543
"2012","KENTUCKY","UNION",1942,82,3955,5979
"2012","KENTUCKY","WARREN",16805,714,26384,43903
"2012","KENTUCKY","WASHINGTON",1669,55,3495,5219
"2012","KENTUCKY","WAYNE",1855,66,5289,7210
"2012","KENTUCKY","WEBSTER",1765,98,3607,5470
"2012","KENTUCKY","WHITLEY",2683,157,10232,13072
"2012","KENTUCKY","WOLFE",976,41,1542,2559
"2012","KENTUCKY","WOODFORD",4883,230,7219,12332
"2012","LOUISIANA","ACADIA",6560,344,19931,26835
"2012","LOUISIANA","ALLEN",2617,195,6495,9307
"2012","LOUISIANA","ASCENSION",16349,868,33856,51073
"2012","LOUISIANA","ASSUMPTION",4754,155,6083,10992
"2012","LOUISIANA","AVOYELLES",6077,285,10670,17032
"2012","LOUISIANA","BEAUREGARD",2828,285,11112,14225
"2012","LOUISIANA","BIENVILLE",3490,72,3641,7203
"2012","LOUISIANA","BOSSIER",12956,618,34988,48562
"2012","LOUISIANA","CADDO",58042,1264,52459,111765
"2012","LOUISIANA","CALCASIEU",28359,1517,51850,81726
"2012","LOUISIANA","CALDWELL",1016,60,3640,4716
"2012","LOUISIANA","CAMERON",408,76,3260,3744
"2012","LOUISIANA","CATAHOULA",1408,41,2744,4193
"2012","LOUISIANA","CLAIBORNE",3014,69,3649,6732
"2012","LOUISIANA","CONCORDIA",3833,97,5450,9380
"2012","LOUISIANA","DE SOTO",5553,145,7353,13051
"2012","LOUISIANA","EAST BATON ROUGE",102656,3223,92292,198171
"2012","LOUISIANA","EAST CARROLL",2478,22,1508,4008
"2012","LOUISIANA","EAST FELICIANA",4648,164,5397,10209
"2012","LOUISIANA","EVANGELINE",5330,259,10181,15770
"2012","LOUISIANA","FRANKLIN",2921,121,6294,9336
"2012","LOUISIANA","GRANT",1422,163,7082,8667
"2012","LOUISIANA","IBERIA",12132,373,20892,33397
"2012","LOUISIANA","IBERVILLE",9548,195,7271,17014
"2012","LOUISIANA","JACKSON",2305,92,5132,7529
"2012","LOUISIANA","JEFFERSON",70384,3423,102536,176343
"2012","LOUISIANA","JEFFERSON DAVIS",3484,236,10014,13734
"2012","LOUISIANA","LA SALLE",764,82,5726,6572
"2012","LOUISIANA","LAFAYETTE",31768,1882,64992,98642
"2012","LOUISIANA","LAFOURCHE",9623,860,28592,39075
"2012","LOUISIANA","LINCOLN",7956,298,10739,18993
"2012","LOUISIANA","LIVINGSTON",7451,1098,45513,54062
"2012","LOUISIANA","MADISON",3154,33,2000,5187
"2012","LOUISIANA","MOREHOUSE",5888,135,6591,12614
"2012","LOUISIANA","NATCHITOCHES",7942,239,9077,17258
"2012","LOUISIANA","ORLEANS",126722,3088,28003,157813
"2012","LOUISIANA","OUACHITA",26645,881,40948,68474
"2012","LOUISIANA","PLAQUEMINES",3599,169,6471,10239
"2012","LOUISIANA","POINTE COUPEE",5436,163,6548,12147
"2012","LOUISIANA","RAPIDES",20045,781,37193,58019
"2012","LOUISIANA","RED RIVER",2253,71,2483,4807
"2012","LOUISIANA","RICHLAND",3387,96,5846,9329
"2012","LOUISIANA","SABINE",2194,121,7738,10053
"2012","LOUISIANA","ST. BERNARD",5059,395,8501,13955
"2012","LOUISIANA","ST. CHARLES",8896,500,15937,25333
"2012","LOUISIANA","ST. HELENA",3780,85,2529,6394
"2012","LOUISIANA","ST. JAMES",7059,127,5209,12395
"2012","LOUISIANA","ST. JOHN THE BAPTIST",13179,324,7620,21123
"2012","LOUISIANA","ST. LANDRY",19668,504,21475,41647
"2012","LOUISIANA","ST. MARTIN",9422,358,15653,25433
"2012","LOUISIANA","ST. MARY",9450,305,13885,23640
"2012","LOUISIANA","ST. TAMMANY",25728,2451,84723,112902
"2012","LOUISIANA","TANGIPAHOA",17722,787,31590,50099
"2012","LOUISIANA","TENSAS",1564,18,1230,2812
"2012","LOUISIANA","TERREBONNE",12074,764,29503,42341
"2012","LOUISIANA","UNION",3075,130,7561,10766
"2012","LOUISIANA","VERMILION",5720,357,18910,24987
"2012","LOUISIANA","VERNON",3173,287,12150,15610
"2012","LOUISIANA","WASHINGTON",6466,317,11798,18581
"2012","LOUISIANA","WEBSTER",6802,214,11400,18416
"2012","LOUISIANA","WEST BATON ROUGE",5692,160,6922,12774
"2012","LOUISIANA","WEST CARROLL",853,67,3628,4548
"2012","LOUISIANA","WEST FELICIANA",2441,79,3257,5777
"2012","LOUISIANA","WINN",1919,74,4541,6534
"2012","MAINE","ANDROSCOGGIN",28989,1641,22232,52862
"2012","MAINE","AROOSTOOK",17777,887,15196,33860
"2012","MAINE","CUMBERLAND",101950,4015,57821,163786
"2012","MAINE","FRANKLIN",9367,546,6369,16282
"2012","MAINE","HANCOCK",17569,906,12324,30799
"2012","MAINE","KENNEBEC",35068,1910,26519,63497
"2012","MAINE","KNOX",13223,596,8248,22067
"2012","MAINE","LINCOLN",11315,543,8899,20757
"2012","MAINE","MAINE UOCAVA",2071,125,858,3054
"2012","MAINE","OXFORD",16330,1094,11996,29420
"2012","MAINE","PENOBSCOT",38811,1948,36547,77306
"2012","MAINE","PISCATAQUIS",4149,276,4530,8955
"2012","MAINE","SAGADAHOC",11821,544,8429,20794
"2012","MAINE","SOMERSET",12216,771,11800,24787
"2012","MAINE","WALDO",11296,707,9058,21061
"2012","MAINE","WASHINGTON",7803,483,7550,15836
"2012","MAINE","YORK",61551,2606,43900,108057
"2012","MARYLAND","ALLEGANY",9805,815,19230,29850
"2012","MARYLAND","ANNE ARUNDEL",126635,6688,126832,260155
"2012","MARYLAND","BALTIMORE",220322,9552,154908,384782
"2012","MARYLAND","BALTIMORE CITY",221478,4356,28171,254005
"2012","MARYLAND","CALVERT",20529,1037,23952,45518
"2012","MARYLAND","CAROLINE",4970,289,8098,13357
"2012","MARYLAND","CARROLL",27939,2836,56761,87536
"2012","MARYLAND","CECIL",16557,1117,24806,42480
"2012","MARYLAND","CHARLES",48774,1270,25178,75222
"2012","MARYLAND","DORCHESTER",7257,211,7976,15444
"2012","MARYLAND","FREDERICK",55146,3171,58798,117115
"2012","MARYLAND","GARRETT",3124,290,9743,13157
"2012","MARYLAND","HARFORD",49729,3314,72911,125954
"2012","MARYLAND","HOWARD",91393,3957,57758,153108
"2012","MARYLAND","KENT",4842,192,4870,9904
"2012","MARYLAND","MONTGOMERY",323400,9239,123353,455992
"2012","MARYLAND","PRINCE GEORGE'S",347938,4072,35734,387744
"2012","MARYLAND","QUEEN ANNE'S",8556,509,15823,24888
"2012","MARYLAND","SOMERSET",5240,117,5042,10399
"2012","MARYLAND","ST. MARY'S",19711,1316,26797,47824
"2012","MARYLAND","TALBOT",8808,312,11339,20459
"2012","MARYLAND","WASHINGTON",25042,1639,36074,62755
"2012","MARYLAND","WICOMICO",19635,860,21764,42259
"2012","MARYLAND","WORCESTER",11014,455,15951,27420
"2012","MASSACHUSETTS","BARNSTABLE",70822,1847,60446,133115
"2012","MASSACHUSETTS","BERKSHIRE",48843,1391,14252,64486
"2012","MASSACHUSETTS","BRISTOL",142962,4795,93752,241509
"2012","MASSACHUSETTS","DUKES",7978,198,2792,10968
"2012","MASSACHUSETTS","ESSEX",210302,5575,150480,366357
"2012","MASSACHUSETTS","FRANKLIN",27072,1342,9344,37758
"2012","MASSACHUSETTS","HAMPDEN",123619,3388,73392,200399
"2012","MASSACHUSETTS","HAMPSHIRE",57359,2782,21480,81621
"2012","MASSACHUSETTS","MIDDLESEX",471804,15045,267321,754170
"2012","MASSACHUSETTS","NANTUCKET",3830,103,2187,6120
"2012","MASSACHUSETTS","NORFOLK",202714,5416,148393,356523
"2012","MASSACHUSETTS","PLYMOUTH",131845,3600,121086,256531
"2012","MASSACHUSETTS","SUFFOLK",223896,5203,59999,289098
"2012","MASSACHUSETTS","WORCESTER",198244,7478,163390,369112
"2012","MICHIGAN","ALCONA",2472,61,3571,6104
"2012","MICHIGAN","ALGER",2212,76,2330,4618
"2012","MICHIGAN","ALLEGAN",20806,690,31123,52619
"2012","MICHIGAN","ALPENA",6549,167,7298,14014
"2012","MICHIGAN","ANTRIM",5107,171,7917,13195
"2012","MICHIGAN","ARENAC",3669,115,4057,7841
"2012","MICHIGAN","BARAGA",1574,50,1866,3490
"2012","MICHIGAN","BARRY",11491,366,16655,28512
"2012","MICHIGAN","BAY",27877,593,24911,53381
"2012","MICHIGAN","BENZIE",4685,141,5075,9901
"2012","MICHIGAN","BERRIEN",33465,823,38209,72497
"2012","MICHIGAN","BRANCH",6913,199,10035,17147
"2012","MICHIGAN","CALHOUN",29267,727,28333,58327
"2012","MICHIGAN","CASS",9591,240,12659,22490
"2012","MICHIGAN","CHARLEVOIX",5939,151,8000,14090
"2012","MICHIGAN","CHEBOYGAN",5831,194,7286,13311
"2012","MICHIGAN","CHIPPEWA",7100,186,8278,15564
"2012","MICHIGAN","CLARE",6338,178,6988,13504
"2012","MICHIGAN","CLINTON",18191,394,20650,39235
"2012","MICHIGAN","CRAWFORD",2994,76,3744,6814
"2012","MICHIGAN","DELTA",8330,186,9534,18050
"2012","MICHIGAN","DICKINSON",4952,170,7688,12810
"2012","MICHIGAN","EATON",27913,678,26197,54788
"2012","MICHIGAN","EMMET",7225,231,10253,17709
"2012","MICHIGAN","GENESEE",128978,2147,71808,202933
"2012","MICHIGAN","GLADWIN",5760,162,6661,12583
"2012","MICHIGAN","GOGEBIC",4058,74,3444,7576
"2012","MICHIGAN","GRAND TRAVERSE",20875,590,26534,47999
"2012","MICHIGAN","GRATIOT",7610,184,8241,16035
"2012","MICHIGAN","HILLSDALE",7106,267,11727,19100
"2012","MICHIGAN","HOUGHTON",6801,285,8196,15282
"2012","MICHIGAN","HURON",6518,160,8806,15484
"2012","MICHIGAN","INGHAM",80847,1757,45306,127910
"2012","MICHIGAN","IONIA",11018,428,14315,25761
"2012","MICHIGAN","IOSCO",6242,193,6909,13344
"2012","MICHIGAN","IRON",2687,77,3224,5988
"2012","MICHIGAN","ISABELLA",13038,281,10800,24119
"2012","MICHIGAN","JACKSON",32301,847,36298,69446
"2012","MICHIGAN","KALAMAZOO",69051,1465,52662,123178
"2012","MICHIGAN","KALKASKA",3272,126,4901,8299
"2012","MICHIGAN","KENT",133408,3652,155925,292985
"2012","MICHIGAN","KEWEENAW",582,36,774,1392
"2012","MICHIGAN","LAKE",2752,48,2487,5287
"2012","MICHIGAN","LAPEER",18796,585,23734,43115
"2012","MICHIGAN","LEELANAU",6576,117,7483,14176
"2012","MICHIGAN","LENAWEE",21776,597,22351,44724
"2012","MICHIGAN","LIVINGSTON",37216,1038,60083,98337
"2012","MICHIGAN","LUCE",991,25,1580,2596
"2012","MICHIGAN","MACKINAC",2652,50,3397,6099
"2012","MICHIGAN","MACOMB",208016,4157,191913,404086
"2012","MICHIGAN","MANISTEE",6473,192,5737,12402
"2012","MICHIGAN","MARQUETTE",18115,473,13606,32194
"2012","MICHIGAN","MASON",6856,168,7580,14604
"2012","MICHIGAN","MECOSTA",7515,222,9176,16913
"2012","MICHIGAN","MENOMINEE",5242,117,5564,10923
"2012","MICHIGAN","MIDLAND",17450,385,23919,41754
"2012","MICHIGAN","MISSAUKEE",2274,88,4665,7027
"2012","MICHIGAN","MONROE",36310,950,35593,72853
"2012","MICHIGAN","MONTCALM",11430,380,13621,25431
"2012","MICHIGAN","MONTMORENCY",2049,74,2928,5051
"2012","MICHIGAN","MUSKEGON",44436,843,30884,76163
"2012","MICHIGAN","NEWAYGO",8728,293,12457,21478
"2012","MICHIGAN","OAKLAND",349002,6091,296514,651607
"2012","MICHIGAN","OCEANA",5063,148,6239,11450
"2012","MICHIGAN","OGEMAW",4791,133,5437,10361
"2012","MICHIGAN","ONTONAGON",1586,47,1906,3539
"2012","MICHIGAN","OSCEOLA",3981,156,6141,10278
"2012","MICHIGAN","OSCODA",1657,77,2308,4042
"2012","MICHIGAN","OTSEGO",4681,140,7011,11832
"2012","MICHIGAN","OTTAWA",42737,1409,88166,132312
"2012","MICHIGAN","PRESQUE ISLE",3192,94,3794,7080
"2012","MICHIGAN","ROSCOMMON",6198,133,6701,13032
"2012","MICHIGAN","SAGINAW",54381,961,42720,98062
"2012","MICHIGAN","SANILAC",7212,194,10963,18369
"2012","MICHIGAN","SCHOOLCRAFT",1865,41,2142,4048
"2012","MICHIGAN","SHIAWASSEE",17197,520,15962,33679
"2012","MICHIGAN","ST. CLAIR",33983,927,39271,74181
"2012","MICHIGAN","ST. JOSEPH",10112,251,12978,23341
"2012","MICHIGAN","TUSCOLA",11425,338,14240,26003
"2012","MICHIGAN","VAN BUREN",16290,406,16141,32837
"2012","MICHIGAN","WASHTENAW",120890,2290,56412,179592
"2012","MICHIGAN","WAYNE",595846,6165,213814,815825
"2012","MICHIGAN","WEXFORD",6184,219,8450,14853
"2012","MINNESOTA","AITKIN",4412,197,4533,9142
"2012","MINNESOTA","ANOKA",88614,4421,93430,186465
"2012","MINNESOTA","BECKER",6829,349,9204,16382
"2012","MINNESOTA","BELTRAMI",11818,596,9637,22051
"2012","MINNESOTA","BENTON",8173,597,10849,19619
"2012","MINNESOTA","BIG STONE",1345,59,1385,2789
"2012","MINNESOTA","BLUE EARTH",18164,1194,14916,34274
"2012","MINNESOTA","BROWN",5630,361,7938,13929
"2012","MINNESOTA","CARLTON",11389,461,6586,18436
"2012","MINNESOTA","CARVER",20745,999,31155,52899
"2012","MINNESOTA","CASS",6858,326,8957,16141
"2012","MINNESOTA","CHIPPEWA",3083,151,2967,6201
"2012","MINNESOTA","CHISAGO",12524,690,16227,29441
"2012","MINNESOTA","CLAY",15208,758,12920,28886
"2012","MINNESOTA","CLEARWATER",1753,85,2359,4197
"2012","MINNESOTA","COOK",1993,108,1221,3322
"2012","MINNESOTA","COTTONWOOD",2433,113,3316,5862
"2012","MINNESOTA","CROW WING",14760,745,19415,34920
"2012","MINNESOTA","DAKOTA",116255,5050,109516,230821
"2012","MINNESOTA","DODGE",4487,318,5522,10327
"2012","MINNESOTA","DOUGLAS",8653,416,11884,20953
"2012","MINNESOTA","FARIBAULT",3407,202,4104,7713
"2012","MINNESOTA","FILLMORE",5713,266,4913,10892
"2012","MINNESOTA","FREEBORN",9326,411,6969,16706
"2012","MINNESOTA","GOODHUE",12212,603,12986,25801
"2012","MINNESOTA","GRANT",1647,92,1748,3487
"2012","MINNESOTA","HENNEPIN",423982,16010,240073,680065
"2012","MINNESOTA","HOUSTON",5281,214,4951,10446
"2012","MINNESOTA","HUBBARD",4676,222,6622,11520
"2012","MINNESOTA","ISANTI",8024,518,11675,20217
"2012","MINNESOTA","ITASCA",12852,566,10501,23919
"2012","MINNESOTA","JACKSON",2268,118,3044,5430
"2012","MINNESOTA","KANABEC",3593,229,4328,8150
"2012","MINNESOTA","KANDIYOHI",9805,420,11240,21465
"2012","MINNESOTA","KITTSON",1241,84,1095,2420
"2012","MINNESOTA","KOOCHICHING",3451,166,2841,6458
"2012","MINNESOTA","LAC QUI PARLE",1974,72,1938,3984
"2012","MINNESOTA","LAKE",4043,167,2610,6820
"2012","MINNESOTA","LAKE OF THE WOODS",859,69,1306,2234
"2012","MINNESOTA","LE SUEUR",6753,327,7715,14795
"2012","MINNESOTA","LINCOLN",1429,96,1595,3120
"2012","MINNESOTA","LYON",5465,329,6594,12388
"2012","MINNESOTA","MAHNOMEN",1276,35,871,2182
"2012","MINNESOTA","MARSHALL",1998,131,2569,4698
"2012","MINNESOTA","MARTIN",4054,257,6657,10968
"2012","MINNESOTA","MCLEOD",6968,516,11069,18553
"2012","MINNESOTA","MEEKER",4969,332,6913,12214
"2012","MINNESOTA","MILLE LACS",5829,311,6951,13091
"2012","MINNESOTA","MORRISON",6153,402,10159,16714
"2012","MINNESOTA","MOWER",11129,472,6938,18539
"2012","MINNESOTA","MURRAY",2160,103,2504,4767
"2012","MINNESOTA","NICOLLET",9652,491,8214,18357
"2012","MINNESOTA","NOBLES",3793,146,4581,8520
"2012","MINNESOTA","NORMAN",1730,93,1384,3207
"2012","MINNESOTA","OLMSTED",39338,2146,36832,78316
"2012","MINNESOTA","OTTER TAIL",12165,645,18860,31670
"2012","MINNESOTA","PENNINGTON",3024,188,3305,6517
"2012","MINNESOTA","PINE",6750,370,6845,13965
"2012","MINNESOTA","PIPESTONE",1725,95,2826,4646
"2012","MINNESOTA","POLK",6773,305,7615,14693
"2012","MINNESOTA","POPE",2981,123,3142,6246
"2012","MINNESOTA","RAMSEY",184938,7084,86800,278822
"2012","MINNESOTA","RED LAKE",928,69,978,1975
"2012","MINNESOTA","REDWOOD",3008,212,4570,7790
"2012","MINNESOTA","RENVILLE",3394,167,4149,7710
"2012","MINNESOTA","RICE",17054,829,14384,32267
"2012","MINNESOTA","ROCK",1946,90,2810,4846
"2012","MINNESOTA","ROSEAU",2772,171,4409,7352
"2012","MINNESOTA","SAINT LOUIS",73378,3085,39131,115594
"2012","MINNESOTA","SCOTT",29712,1612,40323,71647
"2012","MINNESOTA","SHERBURNE",17597,1064,27848,46509
"2012","MINNESOTA","SIBLEY",2916,206,4693,7815
"2012","MINNESOTA","STEARNS",33551,1911,43015,78477
"2012","MINNESOTA","STEELE",8706,515,9903,19124
"2012","MINNESOTA","STEVENS",2742,144,2766,5652
"2012","MINNESOTA","SWIFT",2751,120,2248,5119
"2012","MINNESOTA","TODD",4819,265,6719,11803
"2012","MINNESOTA","TRAVERSE",943,43,861,1847
"2012","MINNESOTA","WABASHA",5415,299,6049,11763
"2012","MINNESOTA","WADENA",2492,156,4143,6791
"2012","MINNESOTA","WASECA",4370,261,5116,9747
"2012","MINNESOTA","WASHINGTON",70203,2793,69137,142133
"2012","MINNESOTA","WATONWAN",2494,133,2517,5144
"2012","MINNESOTA","WILKIN",1258,80,1884,3222
"2012","MINNESOTA","WINONA",14980,772,11480,27232
"2012","MINNESOTA","WRIGHT",25741,1609,40466,67816
"2012","MINNESOTA","YELLOW MEDICINE",2465,143,2806,5414
"2012","MISSISSIPPI","ADAMS",9061,93,6293,15447
"2012","MISSISSIPPI","ALCORN",3511,208,11111,14830
"2012","MISSISSIPPI","AMITE",3242,50,4414,7706
"2012","MISSISSIPPI","ATTALA",3927,39,5126,9092
"2012","MISSISSIPPI","BENTON",2051,24,2041,4116
"2012","MISSISSIPPI","BOLIVAR",10582,145,4701,15428
"2012","MISSISSIPPI","CALHOUN",2586,70,4412,7068
"2012","MISSISSIPPI","CARROLL",2007,25,3960,5992
"2012","MISSISSIPPI","CHICKASAW",4378,131,3994,8503
"2012","MISSISSIPPI","CHOCTAW",1428,33,2812,4273
"2012","MISSISSIPPI","CLAIBORNE",4838,21,625,5484
"2012","MISSISSIPPI","CLARKE",3111,93,5049,8253
"2012","MISSISSIPPI","CLAY",6712,69,4291,11072
"2012","MISSISSIPPI","COAHOMA",7792,45,2712,10549
"2012","MISSISSIPPI","COPIAH",7749,92,6282,14123
"2012","MISSISSIPPI","COVINGTON",3878,65,5405,9348
"2012","MISSISSIPPI","DESOTO",21575,660,43559,65794
"2012","MISSISSIPPI","FORREST",13272,390,16574,30236
"2012","MISSISSIPPI","FRANKLIN",1726,32,2735,4493
"2012","MISSISSIPPI","GEORGE",1359,121,8376,9856
"2012","MISSISSIPPI","GREENE",1325,66,4531,5922
"2012","MISSISSIPPI","GRENADA",5288,61,5986,11335
"2012","MISSISSIPPI","HANCOCK",3917,286,12964,17167
"2012","MISSISSIPPI","HARRISON",23119,739,39470,63328
"2012","MISSISSIPPI","HINDS",76112,715,29664,106491
"2012","MISSISSIPPI","HOLMES",7812,41,1435,9288
"2012","MISSISSIPPI","HUMPHREYS",3903,16,1293,5212
"2012","MISSISSIPPI","ISSAQUENA",479,6,302,787
"2012","MISSISSIPPI","ITAWAMBA",1706,219,7393,9318
"2012","MISSISSIPPI","JACKSON",17299,609,35747,53655
"2012","MISSISSIPPI","JASPER",5097,50,4193,9340
"2012","MISSISSIPPI","JEFFERSON",3951,14,468,4433
"2012","MISSISSIPPI","JEFFERSON DAVIS",4267,90,2507,6864
"2012","MISSISSIPPI","JONES",9211,261,20687,30159
"2012","MISSISSIPPI","KEMPER",3239,24,1789,5052
"2012","MISSISSIPPI","LAFAYETTE",8091,339,11075,19505
"2012","MISSISSIPPI","LAMAR",5494,294,19101,24889
"2012","MISSISSIPPI","LAUDERDALE",13814,263,18700,32777
"2012","MISSISSIPPI","LAWRENCE",2468,38,4192,6698
"2012","MISSISSIPPI","LEAKE",4079,41,4863,8983
"2012","MISSISSIPPI","LEE",12563,328,22415,35306
"2012","MISSISSIPPI","LEFLORE",9119,67,3587,12773
"2012","MISSISSIPPI","LINCOLN",5471,104,10839,16414
"2012","MISSISSIPPI","LOWNDES",13388,252,13518,27158
"2012","MISSISSIPPI","MADISON",20722,342,28507,49571
"2012","MISSISSIPPI","MARION",4393,99,8237,12729
"2012","MISSISSIPPI","MARSHALL",9650,117,6473,16240
"2012","MISSISSIPPI","MONROE",7056,139,9723,16918
"2012","MISSISSIPPI","MONTGOMERY",2675,23,2947,5645
"2012","MISSISSIPPI","NESHOBA",3089,89,7837,11015
"2012","MISSISSIPPI","NEWTON",3319,64,6394,9777
"2012","MISSISSIPPI","NOXUBEE",4920,19,1325,6264
"2012","MISSISSIPPI","OKTIBBEHA",9095,261,8761,18117
"2012","MISSISSIPPI","PANOLA",9079,118,7629,16826
"2012","MISSISSIPPI","PEARL RIVER",4366,309,17549,22224
"2012","MISSISSIPPI","PERRY",1527,58,4137,5722
"2012","MISSISSIPPI","PIKE",9650,143,8181,17974
"2012","MISSISSIPPI","PONTOTOC",2804,159,9448,12411
"2012","MISSISSIPPI","PRENTISS",2817,141,7075,10033
"2012","MISSISSIPPI","QUITMAN",2837,26,1116,3979
"2012","MISSISSIPPI","RANKIN",14988,713,48444,64145
"2012","MISSISSIPPI","SCOTT",5031,82,6089,11202
"2012","MISSISSIPPI","SHARKEY",1782,13,737,2532
"2012","MISSISSIPPI","SIMPSON",4723,102,7424,12249
"2012","MISSISSIPPI","SMITH",1979,71,6049,8099
"2012","MISSISSIPPI","STONE",2003,109,5420,7532
"2012","MISSISSIPPI","SUNFLOWER",8199,100,2929,11228
"2012","MISSISSIPPI","TALLAHATCHIE",3959,45,2499,6503
"2012","MISSISSIPPI","TATE",4933,141,7332,12406
"2012","MISSISSIPPI","TIPPAH",2317,130,6717,9164
"2012","MISSISSIPPI","TISHOMINGO",1643,160,6133,7936
"2012","MISSISSIPPI","TUNICA",3475,24,883,4382
"2012","MISSISSIPPI","UNION",2742,125,8498,11365
"2012","MISSISSIPPI","WALTHALL",3422,78,4051,7551
"2012","MISSISSIPPI","WARREN",10786,148,10457,21391
"2012","MISSISSIPPI","WASHINGTON",13981,83,5651,19715
"2012","MISSISSIPPI","WAYNE",4148,73,6111,10332
"2012","MISSISSIPPI","WEBSTER",1190,52,3992,5234
"2012","MISSISSIPPI","WILKINSON",3412,26,1415,4853
"2012","MISSISSIPPI","WINSTON",4607,54,5168,9829
"2012","MISSISSIPPI","YALOBUSHA",3030,48,3276,6354
"2012","MISSISSIPPI","YAZOO",6603,76,4941,11620
"2012","MISSOURI","ADAIR",4219,256,5651,10126
"2012","MISSOURI","ANDREW",2649,200,5457,8306
"2012","MISSOURI","ATCHISON",756,51,1902,2709
"2012","MISSOURI","AUDRAIN",3539,227,6186,9952
"2012","MISSOURI","BARRY",3667,307,9832,13806
"2012","MISSOURI","BARTON",1230,98,4418,5746
"2012","MISSOURI","BATES",2557,194,5020,7771
"2012","MISSOURI","BENTON",2925,163,6069,9157
"2012","MISSOURI","BOLLINGER",1213,148,4095,5456
"2012","MISSOURI","BOONE",39847,2171,37404,79422
"2012","MISSOURI","BUCHANAN",15594,852,18660,35106
"2012","MISSOURI","BUTLER",4363,278,12248,16889
"2012","MISSOURI","CALDWELL",1312,134,2721,4167
"2012","MISSOURI","CALLAWAY",6071,416,11745,18232
"2012","MISSOURI","CAMDEN",6458,395,15092,21945
"2012","MISSOURI","CAPE GIRARDEAU",9728,618,25370,35716
"2012","MISSOURI","CARROLL",1154,78,3072,4304
"2012","MISSOURI","CARTER",754,67,1978,2799
"2012","MISSOURI","CASS",17044,957,30912,48913
"2012","MISSOURI","CEDAR",1537,132,4376,6045
"2012","MISSOURI","CHARITON",1339,80,2402,3821
"2012","MISSOURI","CHRISTIAN",9813,678,27473,37964
"2012","MISSOURI","CLARK",1398,97,1730,3225
"2012","MISSOURI","CLAY",47310,2088,56191,105589
"2012","MISSOURI","CLINTON",3688,242,5931,9861
"2012","MISSOURI","COLE",12005,567,24490,37062
"2012","MISSOURI","COOPER",2474,150,4887,7511
"2012","MISSOURI","CRAWFORD",2951,194,6434,9579
"2012","MISSOURI","DADE",939,62,2895,3896
"2012","MISSOURI","DALLAS",2122,165,4992,7279
"2012","MISSOURI","DAVIESS",1125,106,2290,3521
"2012","MISSOURI","DEKALB",1194,100,3056,4350
"2012","MISSOURI","DENT",1585,175,4883,6643
"2012","MISSOURI","DOUGLAS",1710,198,4649,6557
"2012","MISSOURI","DUNKLIN",3636,165,6850,10651
"2012","MISSOURI","FRANKLIN",16347,1012,29396,46755
"2012","MISSOURI","GASCONADE",2099,140,4895,7134
"2012","MISSOURI","GENTRY",937,74,1988,2999
"2012","MISSOURI","GREENE",46219,2729,76900,125848
"2012","MISSOURI","GRUNDY",1212,132,3030,4374
"2012","MISSOURI","HARRISON",984,87,2624,3695
"2012","MISSOURI","HENRY",3606,288,6229,10123
"2012","MISSOURI","HICKORY",1733,112,2835,4680
"2012","MISSOURI","HOLT",551,34,1725,2310
"2012","MISSOURI","HOWARD",1723,127,3017,4867
"2012","MISSOURI","HOWELL",4395,407,11544,16346
"2012","MISSOURI","IRON",1669,110,2252,4031
"2012","MISSOURI","JACKSON",78283,3282,93199,174764
"2012","MISSOURI","JASPER",12809,1060,31349,45218
"2012","MISSOURI","JEFFERSON",41564,2069,53978,97611
"2012","MISSOURI","JOHNSON",7667,591,12763,21021
"2012","MISSOURI","KANSAS CITY",105670,1623,29509,136802
"2012","MISSOURI","KNOX",698,54,1205,1957
"2012","MISSOURI","LACLEDE",4093,335,10934,15362
"2012","MISSOURI","LAFAYETTE",5655,337,9803,15795
"2012","MISSOURI","LAWRENCE",4017,317,11421,15755
"2012","MISSOURI","LEWIS",1508,94,2677,4279
"2012","MISSOURI","LINCOLN",7734,586,14332,22652
"2012","MISSOURI","LINN",2041,165,3344,5550
"2012","MISSOURI","LIVINGSTON",1906,142,4006,6054
"2012","MISSOURI","MACON",2309,150,4701,7160
"2012","MISSOURI","MADISON",1588,115,3227,4930
"2012","MISSOURI","MARIES",1299,74,3165,4538
"2012","MISSOURI","MARION",4031,204,7923,12158
"2012","MISSOURI","MCDONALD",1920,203,5694,7817
"2012","MISSOURI","MERCER",353,47,1255,1655
"2012","MISSOURI","MILLER",2651,269,8099,11019
"2012","MISSOURI","MISSISSIPPI",1858,65,2997,4920
"2012","MISSOURI","MONITEAU",1608,131,4704,6443
"2012","MISSOURI","MONROE",1398,95,2564,4057
"2012","MISSOURI","MONTGOMERY",1740,97,3490,5327
"2012","MISSOURI","MORGAN",2773,182,5733,8688
"2012","MISSOURI","NEW MADRID",2814,152,4284,7250
"2012","MISSOURI","NEWTON",6425,477,18181,25083
"2012","MISSOURI","NODAWAY",3172,211,5593,8976
"2012","MISSOURI","OREGON",1419,116,2886,4421
"2012","MISSOURI","OSAGE",1473,117,5329,6919
"2012","MISSOURI","OZARK",1261,112,3080,4453
"2012","MISSOURI","PEMISCOT",2671,66,3598,6335
"2012","MISSOURI","PERRY",2184,134,5669,7987
"2012","MISSOURI","PETTIS",5904,429,10842,17175
"2012","MISSOURI","PHELPS",5798,497,11895,18190
"2012","MISSOURI","PIKE",2582,162,4577,7321
"2012","MISSOURI","PLATTE",19175,759,25618,45552
"2012","MISSOURI","POLK",3580,287,9252,13119
"2012","MISSOURI","PULASKI",4199,280,9092,13571
"2012","MISSOURI","PUTNAM",587,49,1673,2309
"2012","MISSOURI","RALLS",1736,69,3231,5036
"2012","MISSOURI","RANDOLPH",3031,246,6667,9944
"2012","MISSOURI","RAY",4275,277,5815,10367
"2012","MISSOURI","REYNOLDS",1157,114,1931,3202
"2012","MISSOURI","RIPLEY",1396,124,3743,5263
"2012","MISSOURI","SALINE",3790,214,5104,9108
"2012","MISSOURI","SCHUYLER",697,68,1174,1939
"2012","MISSOURI","SCOTLAND",643,47,1246,1936
"2012","MISSOURI","SCOTT",5122,254,11623,16999
"2012","MISSOURI","SHANNON",1302,128,2262,3692
"2012","MISSOURI","SHELBY",966,78,2188,3232
"2012","MISSOURI","ST. CHARLES",71838,3068,110784,185690
"2012","MISSOURI","ST. CLAIR",1460,147,3019,4626
"2012","MISSOURI","ST. FRANCOIS",8829,505,13248,22582
"2012","MISSOURI","ST. LOUIS CITY",118780,1884,22943,143607
"2012","MISSOURI","ST. LOUIS COUNTY",297097,6837,224742,528676
"2012","MISSOURI","STE. GENEVIEVE",3813,202,4055,8070
"2012","MISSOURI","STODDARD",3153,217,9496,12866
"2012","MISSOURI","STONE",3923,274,11787,15984
"2012","MISSOURI","SULLIVAN",908,77,1610,2595
"2012","MISSOURI","TANEY",5479,434,15746,21659
"2012","MISSOURI","TEXAS",2871,275,7618,10764
"2012","MISSOURI","VERNON",2580,183,5758,8521
"2012","MISSOURI","WARREN",5219,307,9150,14676
"2012","MISSOURI","WASHINGTON",3417,207,5071,8695
"2012","MISSOURI","WAYNE",1813,117,3790,5720
"2012","MISSOURI","WEBSTER",4409,312,10708,15429
"2012","MISSOURI","WORTH",341,43,664,1048
"2012","MISSOURI","WRIGHT",1953,172,5830,7955
"2012","MONTANA","BEAVERHEAD",1371,152,3289,4812
"2012","MONTANA","BIG HORN",2882,77,1667,4626
"2012","MONTANA","BLAINE",1616,65,1178,2859
"2012","MONTANA","BROADWATER",764,95,2152,3011
"2012","MONTANA","CARBON",2146,167,3533,5846
"2012","MONTANA","CARTER",96,20,678,794
"2012","MONTANA","CASCADE",15232,987,18345,34564
"2012","MONTANA","CHOUTEAU",978,85,1758,2821
"2012","MONTANA","CUSTER",1833,159,3373,5365
"2012","MONTANA","DANIELS",237,30,740,1007
"2012","MONTANA","DAWSON",1219,175,3029,4423
"2012","MONTANA","DEER LODGE",2860,152,1448,4460
"2012","MONTANA","FALLON",237,40,1128,1405
"2012","MONTANA","FERGUS",1640,174,4257,6071
"2012","MONTANA","FLATHEAD",13892,1275,28309,43476
"2012","MONTANA","GALLATIN",21961,1563,24358,47882
"2012","MONTANA","GARFIELD",66,12,622,700
"2012","MONTANA","GLACIER",2924,113,1415,4452
"2012","MONTANA","GOLDEN VALLEY",110,18,351,479
"2012","MONTANA","GRANITE",533,65,1107,1705
"2012","MONTANA","HILL",3403,253,3164,6820
"2012","MONTANA","JEFFERSON",2272,193,4055,6520
"2012","MONTANA","JUDITH BASIN",337,24,854,1215
"2012","MONTANA","LAKE",5805,364,7135,13304
"2012","MONTANA","LEWIS AND CLARK",15620,895,16803,33318
"2012","MONTANA","LIBERTY",257,29,702,988
"2012","MONTANA","LINCOLN",2552,280,6057,8889
"2012","MONTANA","MADISON",1289,111,3130,4530
"2012","MONTANA","MCCONE",223,25,745,993
"2012","MONTANA","MEAGHER",269,33,670,972
"2012","MONTANA","MINERAL",700,101,1216,2017
"2012","MONTANA","MISSOULA",32824,1716,22652,57192
"2012","MONTANA","MUSSELSHELL",492,82,1833,2407
"2012","MONTANA","PARK",3783,276,4709,8768
"2012","MONTANA","PETROLEUM",49,9,240,298
"2012","MONTANA","PHILLIPS",471,69,1688,2228
"2012","MONTANA","PONDERA",975,71,1673,2719
"2012","MONTANA","POWDER RIVER",170,24,833,1027
"2012","MONTANA","POWELL",888,82,1806,2776
"2012","MONTANA","PRAIRIE",167,16,520,703
"2012","MONTANA","RAVALLI",7285,614,14307,22206
"2012","MONTANA","RICHLAND",1002,133,3510,4645
"2012","MONTANA","ROOSEVELT",2086,72,1514,3672
"2012","MONTANA","ROSEBUD",1422,97,2004,3523
"2012","MONTANA","SANDERS",1720,201,3980,5901
"2012","MONTANA","SHERIDAN",665,56,1207,1928
"2012","MONTANA","SILVER BOW",10857,469,5430,16756
"2012","MONTANA","STILLWATER",1248,117,3337,4702
"2012","MONTANA","SWEET GRASS",475,48,1594,2117
"2012","MONTANA","TETON",1082,86,2113,3281
"2012","MONTANA","TOOLE",582,80,1440,2102
"2012","MONTANA","TREASURE",114,22,319,455
"2012","MONTANA","VALLEY",1385,137,2337,3859
"2012","MONTANA","WHEATLAND",272,27,693,992
"2012","MONTANA","WIBAUX",98,25,421,544
"2012","MONTANA","YELLOWSTONE",26403,1904,40500,68807
"2012","NEBRASKA","ADAMS",4062,292,8316,12670
"2012","NEBRASKA","ANTELOPE",571,65,2596,3232
"2012","NEBRASKA","ARTHUR",30,5,227,262
"2012","NEBRASKA","BANNER",55,10,346,411
"2012","NEBRASKA","BLAINE",29,6,268,303
"2012","NEBRASKA","BOONE",615,53,2138,2806
"2012","NEBRASKA","BOX BUTTE",1692,144,2869,4705
"2012","NEBRASKA","BOYD",188,10,873,1071
"2012","NEBRASKA","BROWN",224,29,1302,1555
"2012","NEBRASKA","BUFFALO",5365,518,13570,19453
"2012","NEBRASKA","BURT",1291,55,2029,3375
"2012","NEBRASKA","BUTLER",1045,76,2738,3859
"2012","NEBRASKA","CASS",4367,257,7556,12180
"2012","NEBRASKA","CEDAR",958,98,3278,4334
"2012","NEBRASKA","CHASE",254,29,1584,1867
"2012","NEBRASKA","CHERRY",436,71,2557,3064
"2012","NEBRASKA","CHEYENNE",1084,116,3449,4649
"2012","NEBRASKA","CLAY",667,48,2232,2947
"2012","NEBRASKA","COLFAX",969,49,2051,3069
"2012","NEBRASKA","CUMING",1031,69,2876,3976
"2012","NEBRASKA","CUSTER",1083,119,4296,5498
"2012","NEBRASKA","DAKOTA",2922,120,3094,6136
"2012","NEBRASKA","DAWES",1132,118,2478,3728
"2012","NEBRASKA","DAWSON",2199,200,5460,7859
"2012","NEBRASKA","DEUEL",215,39,763,1017
"2012","NEBRASKA","DIXON",870,71,1745,2686
"2012","NEBRASKA","DODGE",5673,282,8995,14950
"2012","NEBRASKA","DOUGLAS",106456,4251,113220,223927
"2012","NEBRASKA","DUNDY",176,17,792,985
"2012","NEBRASKA","FILLMORE",807,65,2007,2879
"2012","NEBRASKA","FRANKLIN",384,40,1112,1536
"2012","NEBRASKA","FRONTIER",271,27,1007,1305
"2012","NEBRASKA","FURNAS",423,35,1782,2240
"2012","NEBRASKA","GAGE",3903,245,5513,9661
"2012","NEBRASKA","GARDEN",242,20,829,1091
"2012","NEBRASKA","GARFIELD",149,22,769,940
"2012","NEBRASKA","GOSPER",230,14,734,978
"2012","NEBRASKA","GRANT",30,11,322,363
"2012","NEBRASKA","GREELEY",340,25,820,1185
"2012","NEBRASKA","HALL",7161,422,12646,20229
"2012","NEBRASKA","HAMILTON",1146,125,3600,4871
"2012","NEBRASKA","HARLAN",354,29,1395,1778
"2012","NEBRASKA","HAYES",51,12,476,539
"2012","NEBRASKA","HITCHCOCK",274,43,1178,1495
"2012","NEBRASKA","HOLT",882,135,3922,4939
"2012","NEBRASKA","HOOKER",59,6,330,395
"2012","NEBRASKA","HOWARD",914,66,1890,2870
"2012","NEBRASKA","JEFFERSON",1195,85,2166,3446
"2012","NEBRASKA","JOHNSON",790,48,1225,2063
"2012","NEBRASKA","KEARNEY",773,58,2349,3180
"2012","NEBRASKA","KEITH",928,86,3044,4058
"2012","NEBRASKA","KEYA PAHA",80,11,393,484
"2012","NEBRASKA","KIMBALL",395,57,1235,1687
"2012","NEBRASKA","KNOX",1059,92,2885,4036
"2012","NEBRASKA","LANCASTER",62015,2906,62434,127355
"2012","NEBRASKA","LINCOLN",4450,477,10728,15655
"2012","NEBRASKA","LOGAN",68,7,356,431
"2012","NEBRASKA","LOUP",62,6,290,358
"2012","NEBRASKA","MADISON",3485,338,10062,13885
"2012","NEBRASKA","MCPHERSON",41,13,237,291
"2012","NEBRASKA","MERRICK",925,74,2490,3489
"2012","NEBRASKA","MORRILL",455,54,1681,2190
"2012","NEBRASKA","NANCE",481,34,1106,1621
"2012","NEBRASKA","NEMAHA",1128,74,2012,3214
"2012","NEBRASKA","NUCKOLLS",568,49,1574,2191
"2012","NEBRASKA","OTOE",2561,163,4258,6982
"2012","NEBRASKA","PAWNEE",400,42,899,1341
"2012","NEBRASKA","PERKINS",238,21,1135,1394
"2012","NEBRASKA","PHELPS",880,100,3400,4380
"2012","NEBRASKA","PIERCE",637,87,2707,3431
"2012","NEBRASKA","PLATTE",3148,264,10061,13473
"2012","NEBRASKA","POLK",528,39,1890,2457
"2012","NEBRASKA","RED WILLOW",952,93,3891,4936
"2012","NEBRASKA","RICHARDSON",1191,105,2443,3739
"2012","NEBRASKA","ROCK",103,14,672,789
"2012","NEBRASKA","SALINE",2289,112,2557,4958
"2012","NEBRASKA","SARPY",26671,1606,43213,71490
"2012","NEBRASKA","SAUNDERS",3307,235,6770,10312
"2012","NEBRASKA","SCOTTS BLUFF",4327,312,9648,14287
"2012","NEBRASKA","SEWARD",2386,184,5003,7573
"2012","NEBRASKA","SHERIDAN",390,61,2021,2472
"2012","NEBRASKA","SHERMAN",552,51,927,1530
"2012","NEBRASKA","SIOUX",101,14,624,739
"2012","NEBRASKA","STANTON",614,81,1949,2644
"2012","NEBRASKA","THAYER",728,57,1874,2659
"2012","NEBRASKA","THOMAS",42,6,360,408
"2012","NEBRASKA","THURSTON",1247,29,939,2215
"2012","NEBRASKA","VALLEY",498,40,1657,2195
"2012","NEBRASKA","WASHINGTON",3132,215,6899,10246
"2012","NEBRASKA","WAYNE",1074,115,2493,3682
"2012","NEBRASKA","WEBSTER",442,42,1258,1742
"2012","NEBRASKA","WHEELER",93,10,345,448
"2012","NEBRASKA","YORK",1373,108,4874,6355
"2012","NEVADA","CARSON CITY",10291,634,12394,23319
"2012","NEVADA","CHURCHILL",2961,243,7061,10265
"2012","NEVADA","CLARK",389936,12201,289053,691190
"2012","NEVADA","DOUGLAS",9297,502,16276,26075
"2012","NEVADA","ELKO",3511,461,12014,15986
"2012","NEVADA","ESMERALDA",92,26,317,435
"2012","NEVADA","EUREKA",107,38,663,808
"2012","NEVADA","HUMBOLDT",1737,197,3810,5744
"2012","NEVADA","LANDER",534,51,1580,2165
"2012","NEVADA","LINCOLN",400,61,1691,2152
"2012","NEVADA","LYON",7380,565,13520,21465
"2012","NEVADA","MINERAL",863,92,1080,2035
"2012","NEVADA","NYE",6320,636,10566,17522
"2012","NEVADA","PERSHING",632,85,1167,1884
"2012","NEVADA","STOREY",920,73,1321,2314
"2012","NEVADA","WASHOE",95409,3993,88453,187855
"2012","NEVADA","WHITE PINE",983,120,2601,3704
"2012","NEW HAMPSHIRE","BELKNAP",15890,425,17571,33886
"2012","NEW HAMPSHIRE","CARROLL",13977,408,14207,28592
"2012","NEW HAMPSHIRE","CHESHIRE",25380,827,15156,41363
"2012","NEW HAMPSHIRE","COOS",9095,265,6342,15702
"2012","NEW HAMPSHIRE","GRAFTON",29826,971,18208,49005
"2012","NEW HAMPSHIRE","HILLSBOROUGH",102303,3378,99991,205672
"2012","NEW HAMPSHIRE","MERRIMACK",44756,1218,34524,80498
"2012","NEW HAMPSHIRE","ROCKINGHAM",80142,2356,87921,170419
"2012","NEW HAMPSHIRE","STRAFFORD",36026,1205,26729,63960
"2012","NEW HAMPSHIRE","SULLIVAN",12166,399,9269,21834
"2012","NEW JERSEY","ATLANTIC",65600,1057,46522,113179
"2012","NEW JERSEY","BERGEN",212754,3583,169070,385407
"2012","NEW JERSEY","BURLINGTON",126377,2158,87401,215936
"2012","NEW JERSEY","CAMDEN",153682,2270,69476,225428
"2012","NEW JERSEY","CAPE MAY",21657,493,25781,47931
"2012","NEW JERSEY","CUMBERLAND",34055,579,20658,55292
"2012","NEW JERSEY","ESSEX",236618,1995,64406,303019
"2012","NEW JERSEY","GLOUCESTER",74013,1717,59456,135186
"2012","NEW JERSEY","HUDSON",153108,2027,42369,197504
"2012","NEW JERSEY","HUNTERDON",26876,931,38687,66494
"2012","NEW JERSEY","MERCER",104377,1779,47355,153511
"2012","NEW JERSEY","MIDDLESEX",190555,3450,107310,301315
"2012","NEW JERSEY","MONMOUTH",133145,3320,147513,283978
"2012","NEW JERSEY","MORRIS",100146,2299,124947,227392
"2012","NEW JERSEY","OCEAN",102300,2501,146474,251275
"2012","NEW JERSEY","PASSAIC",115926,1539,64523,181988
"2012","NEW JERSEY","SALEM",14719,448,14334,29501
"2012","NEW JERSEY","SOMERSET",74592,1727,66603,142922
"2012","NEW JERSEY","SUSSEX",26104,1204,40625,67933
"2012","NEW JERSEY","UNION",139752,1765,68314,209831
"2012","NEW JERSEY","WARREN",18745,781,25744,45270
"2012","NEW MEXICO","BERNALILLO",150739,13822,106408,270969
"2012","NEW MEXICO","CATRON",560,69,1494,2123
"2012","NEW MEXICO","CHAVES",6604,600,13088,20292
"2012","NEW MEXICO","CIBOLA",4961,284,2998,8243
"2012","NEW MEXICO","COLFAX",2828,237,2699,5764
"2012","NEW MEXICO","CURRY",4022,352,9251,13625
"2012","NEW MEXICO","DE BACA",287,29,586,902
"2012","NEW MEXICO","DONA ANA",37139,1962,27322,66423
"2012","NEW MEXICO","EDDY",6142,544,12583,19269
"2012","NEW MEXICO","GRANT",7090,454,5358,12902
"2012","NEW MEXICO","GUADALUPE",1488,90,557,2135
"2012","NEW MEXICO","HARDING",260,14,327,601
"2012","NEW MEXICO","HIDALGO",995,41,899,1935
"2012","NEW MEXICO","LEA",4080,387,12548,17015
"2012","NEW MEXICO","LINCOLN",2942,339,5961,9242
"2012","NEW MEXICO","LOS ALAMOS",5191,667,4796,10654
"2012","NEW MEXICO","LUNA",3583,247,3670,7500
"2012","NEW MEXICO","MCKINLEY",15841,542,5546,21929
"2012","NEW MEXICO","MORA",1955,61,595,2611
"2012","NEW MEXICO","OTERO",6829,732,12451,20012
"2012","NEW MEXICO","QUAY",1383,122,2202,3707
"2012","NEW MEXICO","RIO ARRIBA",11465,481,3397,15343
"2012","NEW MEXICO","ROOSEVELT",1727,199,4043,5969
"2012","NEW MEXICO","SAN JUAN",15855,1533,28849,46237
"2012","NEW MEXICO","SAN MIGUEL",8850,356,2303,11509
"2012","NEW MEXICO","SANDOVAL",27236,2456,24387,54079
"2012","NEW MEXICO","SANTA FE",50872,2873,15500,69245
"2012","NEW MEXICO","SIERRA",1964,210,2928,5102
"2012","NEW MEXICO","SOCORRO",4058,413,2722,7193
"2012","NEW MEXICO","TAOS",11978,631,2730,15339
"2012","NEW MEXICO","TORRANCE",2428,445,3529,6402
"2012","NEW MEXICO","UNION",472,51,1236,1759
"2012","NEW MEXICO","VALENCIA",13511,1392,12825,27728
"2012","NEW YORK","ALBANY",83978,11578,40210,135766
"2012","NEW YORK","ALLEGANY",5866,1710,9377,16953
"2012","NEW YORK","BRONX",334600,9614,26680,370894
"2012","NEW YORK","BROOME",39971,6886,34708,81565
"2012","NEW YORK","CATTARAUGUS",12040,3072,14655,29767
"2012","NEW YORK","CAYUGA",16105,3418,11646,31169
"2012","NEW YORK","CHAUTAUQUA",22463,6123,24266,52852
"2012","NEW YORK","CHEMUNG",16205,2667,16138,35010
"2012","NEW YORK","CHENANGO",8642,1750,8922,19314
"2012","NEW YORK","CLINTON",18072,2692,9892,30656
"2012","NEW YORK","COLUMBIA",15241,3288,10600,29129
"2012","NEW YORK","CORTLAND",9965,1800,7859,19624
"2012","NEW YORK","DELAWARE",7881,1671,9086,18638
"2012","NEW YORK","DUTCHESS",62063,13378,48264,123705
"2012","NEW YORK","ERIE",227325,37187,149683,414195
"2012","NEW YORK","ESSEX",9368,1273,6076,16717
"2012","NEW YORK","FRANKLIN",9532,1171,5231,15934
"2012","NEW YORK","FULTON",8331,1638,9830,19799
"2012","NEW YORK","GENESEE",9092,2840,12814,24746
"2012","NEW YORK","GREENE",8384,2351,9737,20472
"2012","NEW YORK","HAMILTON",1092,259,1771,3122
"2012","NEW YORK","HERKIMER",10826,2048,12166,25040
"2012","NEW YORK","JEFFERSON",16231,3042,16435,35708
"2012","NEW YORK","KINGS",580225,37352,112957,730534
"2012","NEW YORK","LEWIS",4530,863,5129,10522
"2012","NEW YORK","LIVINGSTON",11100,3029,12641,26770
"2012","NEW YORK","MADISON",13231,2852,12011,28094
"2012","NEW YORK","MONROE",185916,33463,114434,333813
"2012","NEW YORK","MONTGOMERY",8106,2034,8046,18186
"2012","NEW YORK","NASSAU",294661,35628,237862,568151
"2012","NEW YORK","NEW YORK",486172,26245,84810,597227
"2012","NEW YORK","NIAGARA",41837,9018,38158,89013
"2012","NEW YORK","ONEIDA",39031,7137,40532,86700
"2012","NEW YORK","ONONDAGA",117470,17890,69357,204717
"2012","NEW YORK","ONTARIO",22065,4869,20919,47853
"2012","NEW YORK","ORANGE",70742,11883,58003,140628
"2012","NEW YORK","ORLEANS",5505,1616,7585,14706
"2012","NEW YORK","OSWEGO",22178,4803,17610,44591
"2012","NEW YORK","OTSEGO",11530,2158,10451,24139
"2012","NEW YORK","PUTNAM",18539,4881,20925,44345
"2012","NEW YORK","QUEENS",461391,24818,108864,595073
"2012","NEW YORK","RENSSELAER",35373,7714,24903,67990
"2012","NEW YORK","RICHMOND",75557,11696,66916,154169
"2012","NEW YORK","ROCKLAND",63908,8558,51976,124442
"2012","NEW YORK","SARATOGA",50998,9597,44915,105510
"2012","NEW YORK","SCHENECTADY",35330,6651,22952,64933
"2012","NEW YORK","SCHOHARIE",5119,1591,6497,13207
"2012","NEW YORK","SCHUYLER",3444,904,3798,8146
"2012","NEW YORK","SENECA",6715,1307,5244,13266
"2012","NEW YORK","ST. LAWRENCE",20488,3160,13543,37191
"2012","NEW YORK","STEUBEN",15015,3353,20163,38531
"2012","NEW YORK","SUFFOLK",287519,55481,243258,586258
"2012","NEW YORK","SULLIVAN",14612,2456,11347,28415
"2012","NEW YORK","TIOGA",8544,1897,11160,21601
"2012","NEW YORK","TOMPKINS",24872,4607,10191,39670
"2012","NEW YORK","ULSTER",43837,8906,25572,78315
"2012","NEW YORK","WARREN",14276,2377,12925,29578
"2012","NEW YORK","WASHINGTON",10993,2309,9793,23095
"2012","NEW YORK","WAYNE",15732,4567,17248,37547
"2012","NEW YORK","WESTCHESTER",234778,22530,131139,388447
"2012","NEW YORK","WYOMING",5357,1730,9248,16335
"2012","NEW YORK","YATES",4259,914,4269,9442
"2012","NORTH CAROLINA","ALAMANCE",28875,731,38170,67776
"2012","NORTH CAROLINA","ALEXANDER",4611,332,12253,17196
"2012","NORTH CAROLINA","ALLEGHANY",1583,94,3390,5067
"2012","NORTH CAROLINA","ANSON",7019,71,4166,11256
"2012","NORTH CAROLINA","ASHE",4116,252,8242,12610
"2012","NORTH CAROLINA","AVERY",1882,111,5766,7759
"2012","NORTH CAROLINA","BEAUFORT",9435,208,13977,23620
"2012","NORTH CAROLINA","BERTIE",6695,41,3387,10123
"2012","NORTH CAROLINA","BLADEN",8062,147,7748,15957
"2012","NORTH CAROLINA","BRUNSWICK",22038,581,34743,57362
"2012","NORTH CAROLINA","BUNCOMBE",70625,2370,54701,127696
"2012","NORTH CAROLINA","BURKE",13701,576,22267,36544
"2012","NORTH CAROLINA","CABARRUS",32849,1160,49557,83566
"2012","NORTH CAROLINA","CALDWELL",10898,605,23229,34732
"2012","NORTH CAROLINA","CAMDEN",1508,87,3109,4704
"2012","NORTH CAROLINA","CARTERET",10301,441,24775,35517
"2012","NORTH CAROLINA","CASWELL",5348,97,5594,11039
"2012","NORTH CAROLINA","CATAWBA",24069,994,44538,69601
"2012","NORTH CAROLINA","CHATHAM",18361,408,16665,35434
"2012","NORTH CAROLINA","CHEROKEE",3378,211,9278,12867
"2012","NORTH CAROLINA","CHOWAN",3556,58,3891,7505
"2012","NORTH CAROLINA","CLAY",1579,90,3973,5642
"2012","NORTH CAROLINA","CLEVELAND",17062,485,25793,43340
"2012","NORTH CAROLINA","COLUMBUS",11050,252,12941,24243
"2012","NORTH CAROLINA","CRAVEN",18763,479,26928,46170
"2012","NORTH CAROLINA","CUMBERLAND",75792,1183,50666,127641
"2012","NORTH CAROLINA","CURRITUCK",3562,246,7496,11304
"2012","NORTH CAROLINA","DARE",7393,333,10248,17974
"2012","NORTH CAROLINA","DAVIDSON",20624,928,49383,70935
"2012","NORTH CAROLINA","DAVIE",5735,248,14687,20670
"2012","NORTH CAROLINA","DUPLIN",9033,143,11416,20592
"2012","NORTH CAROLINA","DURHAM",111224,1742,33769,146735
"2012","NORTH CAROLINA","EDGECOMBE",18310,116,8546,26972
"2012","NORTH CAROLINA","FORSYTH",92323,1978,79768,174069
"2012","NORTH CAROLINA","FRANKLIN",13436,350,14603,28389
"2012","NORTH CAROLINA","GASTON",33171,1174,56138,90483
"2012","NORTH CAROLINA","GATES",2786,46,2564,5396
"2012","NORTH CAROLINA","GRAHAM",1119,78,2750,3947
"2012","NORTH CAROLINA","GRANVILLE",13598,272,12405,26275
"2012","NORTH CAROLINA","GREENE",3778,47,4411,8236
"2012","NORTH CAROLINA","GUILFORD",146365,2698,104789,253852
"2012","NORTH CAROLINA","HALIFAX",17176,140,8763,26079
"2012","NORTH CAROLINA","HARNETT",17331,519,25565,43415
"2012","NORTH CAROLINA","HAYWOOD",11833,508,15633,27974
"2012","NORTH CAROLINA","HENDERSON",18642,756,32994,52392
"2012","NORTH CAROLINA","HERTFORD",7843,68,3007,10918
"2012","NORTH CAROLINA","HOKE",10076,194,6819,17089
"2012","NORTH CAROLINA","HYDE",1163,27,1193,2383
"2012","NORTH CAROLINA","IREDELL",26076,990,49299,76365
"2012","NORTH CAROLINA","JACKSON",8095,352,8254,16701
"2012","NORTH CAROLINA","JOHNSTON",27290,974,48427,76691
"2012","NORTH CAROLINA","JONES",2352,41,2837,5230
"2012","NORTH CAROLINA","LEE",10801,280,13158,24239
"2012","NORTH CAROLINA","LENOIR",13948,158,13980,28086
"2012","NORTH CAROLINA","LINCOLN",11024,484,25267,36775
"2012","NORTH CAROLINA","MACON",5712,314,10835,16861
"2012","NORTH CAROLINA","MADISON",4484,225,5404,10113
"2012","NORTH CAROLINA","MARTIN",6583,74,5995,12652
"2012","NORTH CAROLINA","MCDOWELL",6031,293,11775,18099
"2012","NORTH CAROLINA","MECKLENBURG",272262,4970,171668,448900
"2012","NORTH CAROLINA","MITCHELL",1838,121,5806,7765
"2012","NORTH CAROLINA","MONTGOMERY",4706,121,6404,11231
"2012","NORTH CAROLINA","MOORE",16505,415,29495,46415
"2012","NORTH CAROLINA","NASH",24313,337,23842,48492
"2012","NORTH CAROLINA","NEW HANOVER",48668,1575,53385,103628
"2012","NORTH CAROLINA","NORTHAMPTON",7232,41,3483,10756
"2012","NORTH CAROLINA","ONSLOW",18490,702,32243,51435
"2012","NORTH CAROLINA","ORANGE",53901,1317,21539,76757
"2012","NORTH CAROLINA","PAMLICO",2647,64,4051,6762
"2012","NORTH CAROLINA","PASQUOTANK",10282,192,7633,18107
"2012","NORTH CAROLINA","PENDER",9632,278,14617,24527
"2012","NORTH CAROLINA","PERQUIMANS",2759,71,3822,6652
"2012","NORTH CAROLINA","PERSON",8418,192,10496,19106
"2012","NORTH CAROLINA","PITT",41843,799,36214,78856
"2012","NORTH CAROLINA","POLK",4013,140,6236,10389
"2012","NORTH CAROLINA","RANDOLPH",14773,782,45160,60715
"2012","NORTH CAROLINA","RICHMOND",9904,181,9332,19417
"2012","NORTH CAROLINA","ROBESON",24988,448,17510,42946
"2012","NORTH CAROLINA","ROCKINGHAM",16351,442,25227,42020
"2012","NORTH CAROLINA","ROWAN",22650,887,38775,62312
"2012","NORTH CAROLINA","RUTHERFORD",9374,374,18954,28702
"2012","NORTH CAROLINA","SAMPSON",11566,186,14422,26174
"2012","NORTH CAROLINA","SCOTLAND",8215,110,5831,14156
"2012","NORTH CAROLINA","STANLY",8431,382,19904,28717
"2012","NORTH CAROLINA","STOKES",6018,364,15237,21619
"2012","NORTH CAROLINA","SURRY",9112,435,19923,29470
"2012","NORTH CAROLINA","SWAIN",2618,134,2976,5728
"2012","NORTH CAROLINA","TRANSYLVANIA",6826,303,9634,16763
"2012","NORTH CAROLINA","TYRRELL",837,16,930,1783
"2012","NORTH CAROLINA","UNION",32473,1148,61107,94728
"2012","NORTH CAROLINA","VANCE",13323,102,7429,20854
"2012","NORTH CAROLINA","WAKE",267262,7569,211596,486427
"2012","NORTH CAROLINA","WARREN",6978,44,3140,10162
"2012","NORTH CAROLINA","WASHINGTON",3833,44,2622,6499
"2012","NORTH CAROLINA","WATAUGA",13002,811,13861,27674
"2012","NORTH CAROLINA","WAYNE",23314,397,27641,51352
"2012","NORTH CAROLINA","WILKES",8148,482,20515,29145
"2012","NORTH CAROLINA","WILSON",20875,280,17954,39109
"2012","NORTH CAROLINA","YADKIN",3957,278,12578,16813
"2012","NORTH CAROLINA","YANCEY",3981,192,5278,9451
"2012","NORTH DAKOTA","ADAMS",328,40,918,1286
"2012","NORTH DAKOTA","BARNES",2394,164,2964,5522
"2012","NORTH DAKOTA","BENSON",1235,54,868,2157
"2012","NORTH DAKOTA","BILLINGS",89,17,472,578
"2012","NORTH DAKOTA","BOTTINEAU",1183,92,2280,3555
"2012","NORTH DAKOTA","BOWMAN",414,43,1280,1737
"2012","NORTH DAKOTA","BURKE",230,24,769,1023
"2012","NORTH DAKOTA","BURLEIGH",14122,1314,27951,43387
"2012","NORTH DAKOTA","CASS",34712,2288,36855,73855
"2012","NORTH DAKOTA","CAVALIER",818,56,1195,2069
"2012","NORTH DAKOTA","DICKEY",853,72,1610,2535
"2012","NORTH DAKOTA","DIVIDE",385,44,733,1162
"2012","NORTH DAKOTA","DUNN",508,20,1506,2034
"2012","NORTH DAKOTA","EDDY",486,37,634,1157
"2012","NORTH DAKOTA","EMMONS",383,66,1435,1884
"2012","NORTH DAKOTA","FOSTER",607,45,1030,1682
"2012","NORTH DAKOTA","GOLDEN VALLEY",162,24,742,928
"2012","NORTH DAKOTA","GRAND FORKS",14032,937,15060,30029
"2012","NORTH DAKOTA","GRANT",334,54,1025,1413
"2012","NORTH DAKOTA","GRIGGS",536,36,771,1343
"2012","NORTH DAKOTA","HETTINGER",313,49,1000,1362
"2012","NORTH DAKOTA","KIDDER",393,65,870,1328
"2012","NORTH DAKOTA","LAMOURE",740,77,1377,2194
"2012","NORTH DAKOTA","LOGAN",232,31,810,1073
"2012","NORTH DAKOTA","MCHENRY",943,91,1678,2712
"2012","NORTH DAKOTA","MCINTOSH",459,36,1035,1530
"2012","NORTH DAKOTA","MCKENZIE",927,66,2458,3451
"2012","NORTH DAKOTA","MCLEAN",1670,127,3141,4938
"2012","NORTH DAKOTA","MERCER",1166,137,3152,4455
"2012","NORTH DAKOTA","MORTON",4469,464,8680,13613
"2012","NORTH DAKOTA","MOUNTRAIL",1403,92,1962,3457
"2012","NORTH DAKOTA","NELSON",767,46,865,1678
"2012","NORTH DAKOTA","OLIVER",281,39,693,1013
"2012","NORTH DAKOTA","PEMBINA",1253,103,1899,3255
"2012","NORTH DAKOTA","PIERCE",660,53,1465,2178
"2012","NORTH DAKOTA","RAMSEY",2164,170,2665,4999
"2012","NORTH DAKOTA","RANSOM",1343,73,1009,2425
"2012","NORTH DAKOTA","RENVILLE",398,29,851,1278
"2012","NORTH DAKOTA","RICHLAND",3198,186,4229,7613
"2012","NORTH DAKOTA","ROLETTE",3353,107,1092,4552
"2012","NORTH DAKOTA","SARGENT",1075,53,879,2007
"2012","NORTH DAKOTA","SHERIDAN",163,17,642,822
"2012","NORTH DAKOTA","SIOUX",900,19,225,1144
"2012","NORTH DAKOTA","SLOPE",83,13,341,437
"2012","NORTH DAKOTA","STARK",2812,300,8521,11633
"2012","NORTH DAKOTA","STEELE",518,26,498,1042
"2012","NORTH DAKOTA","STUTSMAN",3585,288,5685,9558
"2012","NORTH DAKOTA","TOWNER",516,43,623,1182
"2012","NORTH DAKOTA","TRAILL",1811,114,1996,3921
"2012","NORTH DAKOTA","WALSH",2124,159,2813,5096
"2012","NORTH DAKOTA","WARD",8441,792,16230,25463
"2012","NORTH DAKOTA","WELLS",673,52,1654,2379
"2012","NORTH DAKOTA","WILLIAMS",2322,302,7184,9808
"2012","OHIO","ADAMS",3976,248,6865,11089
"2012","OHIO","ALLEN",17913,820,29502,48235
"2012","OHIO","ASHLAND",8281,530,15519,24330
"2012","OHIO","ASHTABULA",23803,963,18298,43064
"2012","OHIO","ATHENS",18307,788,8543,27638
"2012","OHIO","AUGLAIZE",5831,405,17169,23405
"2012","OHIO","BELMONT",14156,650,16758,31564
"2012","OHIO","BROWN",7107,369,11916,19392
"2012","OHIO","BUTLER",62388,2627,105176,170191
"2012","OHIO","CARROLL",5543,404,7315,13262
"2012","OHIO","CHAMPAIGN",7044,332,11045,18421
"2012","OHIO","CLARK",31298,1030,31816,64144
"2012","OHIO","CLERMONT",30458,1607,64208,96273
"2012","OHIO","CLINTON",5791,344,12009,18144
"2012","OHIO","COLUMBIANA",19821,979,25251,46051
"2012","OHIO","COSHOCTON",6940,409,8390,15739
"2012","OHIO","CRAWFORD",7507,444,11852,19803
"2012","OHIO","CUYAHOGA",447232,6398,190651,644281
"2012","OHIO","DARKE",6826,467,18108,25401
"2012","OHIO","DEFIANCE",7732,380,10176,18288
"2012","OHIO","DELAWARE",37292,1275,60194,98761
"2012","OHIO","ERIE",21793,660,16952,39405
"2012","OHIO","FAIRFIELD",29890,1144,41034,72068
"2012","OHIO","FAYETTE",4249,151,6620,11020
"2012","OHIO","FRANKLIN",346336,8660,215987,570983
"2012","OHIO","FULTON",9073,457,11738,21268
"2012","OHIO","GALLIA",4557,288,7750,12595
"2012","OHIO","GEAUGA",19659,749,30589,50997
"2012","OHIO","GREENE",32256,1415,49819,83490
"2012","OHIO","GUERNSEY",7450,371,8993,16814
"2012","OHIO","HAMILTON",219927,5641,193326,418894
"2012","OHIO","HANCOCK",12564,687,22443,35694
"2012","OHIO","HARDIN",4619,341,7489,12449
"2012","OHIO","HARRISON",2950,172,4019,7141
"2012","OHIO","HENRY",5658,321,8257,14236
"2012","OHIO","HIGHLAND",6049,380,11410,17839
"2012","OHIO","HOCKING",6157,286,6285,12728
"2012","OHIO","HOLMES",2608,226,8702,11536
"2012","OHIO","HURON",11006,597,13060,24663
"2012","OHIO","JACKSON",5166,311,7904,13381
"2012","OHIO","JEFFERSON",15385,650,17034,33069
"2012","OHIO","KNOX",10470,652,17266,28388
"2012","OHIO","LAKE",57680,1980,58744,118404
"2012","OHIO","LAWRENCE",10744,438,14651,25833
"2012","OHIO","LICKING",34201,1686,45503,81390
"2012","OHIO","LOGAN",7062,442,13633,21137
"2012","OHIO","LORAIN",81464,2384,59405,143253
"2012","OHIO","LUCAS",136616,3662,69940,210218
"2012","OHIO","MADISON",6845,330,10342,17517
"2012","OHIO","MAHONING",77059,1610,42641,121310
"2012","OHIO","MARION",12504,583,14265,27352
"2012","OHIO","MEDINA",38785,1580,50418,90783
"2012","OHIO","MEIGS",4027,296,5895,10218
"2012","OHIO","MERCER",4745,355,16561,21661
"2012","OHIO","MIAMI",16383,947,34606,51936
"2012","OHIO","MONROE",3035,199,3548,6782
"2012","OHIO","MONTGOMERY",137139,4298,124841,266278
"2012","OHIO","MORGAN",2814,136,3179,6129
"2012","OHIO","MORROW",5933,386,9865,16184
"2012","OHIO","MUSKINGUM",17001,820,19264,37085
"2012","OHIO","NOBLE",2131,178,3563,5872
"2012","OHIO","OTTAWA",11503,415,10538,22456
"2012","OHIO","PAULDING",3538,236,5354,9128
"2012","OHIO","PERRY",7033,324,7627,14984
"2012","OHIO","PICKAWAY",9684,402,14037,24123
"2012","OHIO","PIKE",5684,212,5685,11581
"2012","OHIO","PORTAGE",39453,1544,35242,76239
"2012","OHIO","PREBLE",6211,423,13535,20169
"2012","OHIO","PUTNAM",4318,333,13721,18372
"2012","OHIO","RICHLAND",22687,1161,33867,57715
"2012","OHIO","ROSS",14569,506,15008,30083
"2012","OHIO","SANDUSKY",14541,698,13755,28994
"2012","OHIO","SCIOTO",15077,592,15492,31161
"2012","OHIO","SENECA",11353,666,13243,25262
"2012","OHIO","SHELBY",6343,381,17142,23866
"2012","OHIO","STARK",89432,3464,88581,181477
"2012","OHIO","SUMMIT",153037,3674,111000,267711
"2012","OHIO","TRUMBULL",61672,1768,38279,101719
"2012","OHIO","TUSCARAWAS",18407,964,22242,41613
"2012","OHIO","UNION",8805,473,16289,25567
"2012","OHIO","VAN WERT",4029,252,9585,13866
"2012","OHIO","VINTON",2436,175,2856,5467
"2012","OHIO","WARREN",32909,1534,76561,111004
"2012","OHIO","WASHINGTON",11651,564,17284,29499
"2012","OHIO","WAYNE",19808,1005,30251,51064
"2012","OHIO","WILLIAMS",7266,393,10047,17706
"2012","OHIO","WOOD",32802,1442,29704,63948
"2012","OHIO","WYANDOT",4137,255,6180,10572
"2012","OKLAHOMA","ADAIR",2127,0,4381,6508
"2012","OKLAHOMA","ALFALFA",322,0,1761,2083
"2012","OKLAHOMA","ATOKA",1243,0,3538,4781
"2012","OKLAHOMA","BEAVER",244,0,2062,2306
"2012","OKLAHOMA","BECKHAM",1417,0,5508,6925
"2012","OKLAHOMA","BLAINE",992,0,2824,3816
"2012","OKLAHOMA","BRYAN",3681,0,9520,13201
"2012","OKLAHOMA","CADDO",3164,0,5687,8851
"2012","OKLAHOMA","CANADIAN",10537,0,35625,46162
"2012","OKLAHOMA","CARTER",4908,0,12214,17122
"2012","OKLAHOMA","CHEROKEE",6144,0,8162,14306
"2012","OKLAHOMA","CHOCTAW",1494,0,3572,5066
"2012","OKLAHOMA","CIMARRON",115,0,1082,1197
"2012","OKLAHOMA","CLEVELAND",34771,0,59116,93887
"2012","OKLAHOMA","COAL",649,0,1710,2359
"2012","OKLAHOMA","COMANCHE",12521,0,17664,30185
"2012","OKLAHOMA","COTTON",657,0,1796,2453
"2012","OKLAHOMA","CRAIG",1747,0,3559,5306
"2012","OKLAHOMA","CREEK",7128,0,18986,26114
"2012","OKLAHOMA","CUSTER",2359,0,7446,9805
"2012","OKLAHOMA","DELAWARE",4196,0,10080,14276
"2012","OKLAHOMA","DEWEY",301,0,1792,2093
"2012","OKLAHOMA","ELLIS",226,0,1575,1801
"2012","OKLAHOMA","GARFIELD",4733,0,15177,19910
"2012","OKLAHOMA","GARVIN",2559,0,6925,9484
"2012","OKLAHOMA","GRADY",4786,0,14833,19619
"2012","OKLAHOMA","GRANT",393,0,1675,2068
"2012","OKLAHOMA","GREER",488,0,1344,1832
"2012","OKLAHOMA","HARMON",264,0,659,923
"2012","OKLAHOMA","HARPER",173,0,1261,1434
"2012","OKLAHOMA","HASKELL",1175,0,3069,4244
"2012","OKLAHOMA","HUGHES",1370,0,2838,4208
"2012","OKLAHOMA","JACKSON",1954,0,5965,7919
"2012","OKLAHOMA","JEFFERSON",605,0,1634,2239
"2012","OKLAHOMA","JOHNSTON",1137,0,2649,3786
"2012","OKLAHOMA","KAY",4627,0,11499,16126
"2012","OKLAHOMA","KINGFISHER",898,0,4870,5768
"2012","OKLAHOMA","KIOWA",1106,0,2316,3422
"2012","OKLAHOMA","LATIMER",1170,0,2628,3798
"2012","OKLAHOMA","LE FLORE",4662,0,11177,15839
"2012","OKLAHOMA","LINCOLN",3273,0,9553,12826
"2012","OKLAHOMA","LOGAN",4724,0,12314,17038
"2012","OKLAHOMA","LOVE",1034,0,2436,3470
"2012","OKLAHOMA","MAJOR",446,0,2700,3146
"2012","OKLAHOMA","MARSHALL",1396,0,3744,5140
"2012","OKLAHOMA","MAYES",4823,0,9637,14460
"2012","OKLAHOMA","MCCLAIN",3194,0,11112,14306
"2012","OKLAHOMA","MCCURTAIN",2440,0,7635,10075
"2012","OKLAHOMA","MCINTOSH",2779,0,4509,7288
"2012","OKLAHOMA","MURRAY",1540,0,3606,5146
"2012","OKLAHOMA","MUSKOGEE",9952,0,13404,23356
"2012","OKLAHOMA","NOBLE",1143,0,3488,4631
"2012","OKLAHOMA","NOWATA",1244,0,2832,4076
"2012","OKLAHOMA","OKFUSKEE",1256,0,2335,3591
"2012","OKLAHOMA","OKLAHOMA",106982,0,149728,256710
"2012","OKLAHOMA","OKMULGEE",5432,0,7731,13163
"2012","OKLAHOMA","OSAGE",6704,0,11242,17946
"2012","OKLAHOMA","OTTAWA",3509,0,6466,9975
"2012","OKLAHOMA","PAWNEE",1813,0,4232,6045
"2012","OKLAHOMA","PAYNE",9198,0,16481,25679
"2012","OKLAHOMA","PITTSBURG",4831,0,10841,15672
"2012","OKLAHOMA","PONTOTOC",3947,0,8945,12892
"2012","OKLAHOMA","POTTAWATOMIE",7188,0,16250,23438
"2012","OKLAHOMA","PUSHMATAHA",1043,0,3087,4130
"2012","OKLAHOMA","ROGER MILLS",272,0,1402,1674
"2012","OKLAHOMA","ROGERS",9148,0,27553,36701
"2012","OKLAHOMA","SEMINOLE",2600,0,4856,7456
"2012","OKLAHOMA","SEQUOYAH",4193,0,9578,13771
"2012","OKLAHOMA","STEPHENS",3939,0,12908,16847
"2012","OKLAHOMA","TEXAS",862,0,4930,5792
"2012","OKLAHOMA","TILLMAN",906,0,1815,2721
"2012","OKLAHOMA","TULSA",82744,0,145062,227806
"2012","OKLAHOMA","WAGONER",7791,0,20900,28691
"2012","OKLAHOMA","WASHINGTON",5532,0,15668,21200
"2012","OKLAHOMA","WASHITA",822,0,3494,4316
"2012","OKLAHOMA","WOODS",671,0,2727,3398
"2012","OKLAHOMA","WOODWARD",1133,0,5945,7078
"2012","OREGON","BAKER",2369,377,5702,8448
"2012","OREGON","BENTON",27776,2035,14991,44802
"2012","OREGON","CLACKAMAS",95493,5247,88592,189332
"2012","OREGON","CLATSOP",9861,708,7249,17818
"2012","OREGON","COLUMBIA",12004,1099,10772,23875
"2012","OREGON","COOS",12845,1168,14673,28686
"2012","OREGON","CROOK",3104,336,6790,10230
"2012","OREGON","CURRY",4625,455,6598,11678
"2012","OREGON","DESCHUTES",36961,2476,42463,81900
"2012","OREGON","DOUGLAS",17145,1882,30776,49803
"2012","OREGON","GILLIAM",371,51,639,1061
"2012","OREGON","GRANT",853,132,2926,3911
"2012","OREGON","HARNEY",832,144,2607,3583
"2012","OREGON","HOOD RIVER",6058,351,3429,9838
"2012","OREGON","JACKSON",44468,3639,49020,97127
"2012","OREGON","JEFFERSON",3301,232,4642,8175
"2012","OREGON","JOSEPHINE",14953,1612,23673,40238
"2012","OREGON","KLAMATH",8302,952,18898,28152
"2012","OREGON","LAKE",770,132,2808,3710
"2012","OREGON","LANE",102652,6689,62509,171850
"2012","OREGON","LINCOLN",13401,897,8686,22984
"2012","OREGON","LINN",20378,2104,28944,51426
"2012","OREGON","MALHEUR",2759,346,6851,9956
"2012","OREGON","MARION",56376,3810,60190,120376
"2012","OREGON","MORROW",1202,148,2532,3882
"2012","OREGON","MULTNOMAH",274887,14533,75302,364722
"2012","OREGON","POLK",16292,1146,17819,35257
"2012","OREGON","SHERMAN",319,29,678,1026
"2012","OREGON","TILLAMOOK",6293,542,5684,12519
"2012","OREGON","UMATILLA",8584,886,15499,24969
"2012","OREGON","UNION",3973,461,7636,12070
"2012","OREGON","WALLOWA",1253,148,2804,4205
"2012","OREGON","WASCO",5211,433,5229,10873
"2012","OREGON","WASHINGTON",135291,7758,93974,237023
"2012","OREGON","WHEELER",266,47,545,858
"2012","OREGON","YAMHILL",19260,1602,22045,42907
"2012","PENNSYLVANIA","ADAMS",15091,599,26767,42457
"2012","PENNSYLVANIA","ALLEGHENY",352687,7355,262039,622081
"2012","PENNSYLVANIA","ARMSTRONG",9045,415,20142,29602
"2012","PENNSYLVANIA","BEAVER",37055,1075,42344,80474
"2012","PENNSYLVANIA","BEDFORD",4788,207,16702,21697
"2012","PENNSYLVANIA","BERKS",83011,2607,84702,170320
"2012","PENNSYLVANIA","BLAIR",16276,646,33319,50241
"2012","PENNSYLVANIA","BRADFORD",8624,392,14410,23426
"2012","PENNSYLVANIA","BUCKS",160521,3916,156579,321016
"2012","PENNSYLVANIA","BUTLER",28550,1134,59761,89445
"2012","PENNSYLVANIA","CAMBRIA",24249,1114,35163,60526
"2012","PENNSYLVANIA","CAMERON",724,28,1359,2111
"2012","PENNSYLVANIA","CARBON",11580,497,13504,25581
"2012","PENNSYLVANIA","CENTRE",34176,1449,34001,69626
"2012","PENNSYLVANIA","CHESTER",124311,2822,124840,251973
"2012","PENNSYLVANIA","CLARION",5056,302,10828,16186
"2012","PENNSYLVANIA","CLEARFIELD",11121,499,20347,31967
"2012","PENNSYLVANIA","CLINTON",5734,228,7303,13265
"2012","PENNSYLVANIA","COLUMBIA",10937,450,14236,25623
"2012","PENNSYLVANIA","CRAWFORD",13883,604,20901,35388
"2012","PENNSYLVANIA","CUMBERLAND",44367,1638,64809,110814
"2012","PENNSYLVANIA","DAUPHIN",64965,1593,57450,124008
"2012","PENNSYLVANIA","DELAWARE",171792,2919,110853,285564
"2012","PENNSYLVANIA","ELK",5463,196,7579,13238
"2012","PENNSYLVANIA","ERIE",68036,1558,49025,118619
"2012","PENNSYLVANIA","FAYETTE",21971,516,26018,48505
"2012","PENNSYLVANIA","FOREST",896,33,1383,2312
"2012","PENNSYLVANIA","FRANKLIN",18995,823,43260,63078
"2012","PENNSYLVANIA","FULTON",1310,71,4814,6195
"2012","PENNSYLVANIA","GREENE",5852,184,8428,14464
"2012","PENNSYLVANIA","HUNTINGDON",5409,251,11979,17639
"2012","PENNSYLVANIA","INDIANA",14473,591,21257,36321
"2012","PENNSYLVANIA","JEFFERSON",4787,262,13048,18097
"2012","PENNSYLVANIA","JUNIATA",2547,126,6862,9535
"2012","PENNSYLVANIA","LACKAWANNA",61838,1092,35085,98015
"2012","PENNSYLVANIA","LANCASTER",88481,3286,130669,222436
"2012","PENNSYLVANIA","LAWRENCE",17513,476,21047,39036
"2012","PENNSYLVANIA","LEBANON",19900,808,35872,56580
"2012","PENNSYLVANIA","LEHIGH",78283,1845,66874,147002
"2012","PENNSYLVANIA","LUZERNE",64307,1807,58325,124439
"2012","PENNSYLVANIA","LYCOMING",15203,632,30658,46493
"2012","PENNSYLVANIA","MCKEAN",5297,266,9545,15108
"2012","PENNSYLVANIA","MERCER",24232,706,25925,50863
"2012","PENNSYLVANIA","MIFFLIN",4273,159,11939,16371
"2012","PENNSYLVANIA","MONROE",35221,829,26867,62917
"2012","PENNSYLVANIA","MONTGOMERY",233356,4463,174381,412200
"2012","PENNSYLVANIA","MONTOUR",3053,126,4652,7831
"2012","PENNSYLVANIA","NORTHAMPTON",67606,1683,61446,130735
"2012","PENNSYLVANIA","NORTHUMBERLAND",13072,622,19518,33212
"2012","PENNSYLVANIA","PERRY",5685,323,13120,19128
"2012","PENNSYLVANIA","PHILADELPHIA",588806,5054,96467,690327
"2012","PENNSYLVANIA","PIKE",10210,283,12786,23279
"2012","PENNSYLVANIA","POTTER",1897,114,5231,7242
"2012","PENNSYLVANIA","SCHUYLKILL",24546,903,32278,57727
"2012","PENNSYLVANIA","SNYDER",4687,242,10073,15002
"2012","PENNSYLVANIA","SOMERSET",9436,522,23984,33942
"2012","PENNSYLVANIA","SULLIVAN",1034,47,1868,2949
"2012","PENNSYLVANIA","SUSQUEHANNA",6935,309,10800,18044
"2012","PENNSYLVANIA","TIOGA",5357,305,11342,17004
"2012","PENNSYLVANIA","UNION",6109,263,9896,16268
"2012","PENNSYLVANIA","VENANGO",7945,407,13815,22167
"2012","PENNSYLVANIA","WARREN",6995,294,10010,17299
"2012","PENNSYLVANIA","WASHINGTON",40345,1175,53230,94750
"2012","PENNSYLVANIA","WAYNE",8396,315,12896,21607
"2012","PENNSYLVANIA","WESTMORELAND",63722,1918,103932,169572
"2012","PENNSYLVANIA","WYOMING",5061,224,6587,11872
"2012","PENNSYLVANIA","YORK",73191,2734,113304,189229
"2012","RHODE ISLAND","BRISTOL",14974,471,9231,24676
"2012","RHODE ISLAND","FEDERAL PRECINCT",268,12,53,333
"2012","RHODE ISLAND","KENT",45564,1792,31567,78923
"2012","RHODE ISLAND","NEWPORT",23463,787,15202,39452
"2012","RHODE ISLAND","PROVIDENCE",159520,4484,75785,239789
"2012","RHODE ISLAND","WASHINGTON",35888,1625,25366,62879
"2012","SOUTH CAROLINA","ABBEVILLE",4543,147,5981,10671
"2012","SOUTH CAROLINA","AIKEN",25322,999,44042,70363
"2012","SOUTH CAROLINA","ALLENDALE",3297,28,838,4163
"2012","SOUTH CAROLINA","ANDERSON",22405,1098,48709,72212
"2012","SOUTH CAROLINA","BAMBERG",4624,64,2194,6882
"2012","SOUTH CAROLINA","BARNWELL",5188,76,4659,9923
"2012","SOUTH CAROLINA","BEAUFORT",29848,762,42687,73297
"2012","SOUTH CAROLINA","BERKELEY",28542,1178,38475,68195
"2012","SOUTH CAROLINA","CALHOUN",4045,82,3707,7834
"2012","SOUTH CAROLINA","CHARLESTON",81487,2591,77629,161707
"2012","SOUTH CAROLINA","CHEROKEE",7231,228,13314,20773
"2012","SOUTH CAROLINA","CHESTER",7891,149,6367,14407
"2012","SOUTH CAROLINA","CHESTERFIELD",7958,146,8490,16594
"2012","SOUTH CAROLINA","CLARENDON",9091,130,7071,16292
"2012","SOUTH CAROLINA","COLLETON",8475,168,8443,17086
"2012","SOUTH CAROLINA","DARLINGTON",15457,259,14434,30150
"2012","SOUTH CAROLINA","DILLON",7523,85,5427,13035
"2012","SOUTH CAROLINA","DORCHESTER",23445,879,32531,56855
"2012","SOUTH CAROLINA","EDGEFIELD",4967,107,6512,11586
"2012","SOUTH CAROLINA","FAIRFIELD",7777,119,3999,11895
"2012","SOUTH CAROLINA","FLORENCE",28614,547,28961,58122
"2012","SOUTH CAROLINA","GEORGETOWN",14163,276,16526,30965
"2012","SOUTH CAROLINA","GREENVILLE",68070,3434,121685,193189
"2012","SOUTH CAROLINA","GREENWOOD",11972,352,16348,28672
"2012","SOUTH CAROLINA","HAMPTON",5834,60,3312,9206
"2012","SOUTH CAROLINA","HORRY",38885,1381,72127,112393
"2012","SOUTH CAROLINA","JASPER",5757,95,4169,10021
"2012","SOUTH CAROLINA","KERSHAW",11259,363,16324,27946
"2012","SOUTH CAROLINA","LANCASTER",13419,392,19333,33144
"2012","SOUTH CAROLINA","LAURENS",10318,352,14746,25416
"2012","SOUTH CAROLINA","LEE",5977,98,2832,8907
"2012","SOUTH CAROLINA","LEXINGTON",34148,1813,76662,112623
"2012","SOUTH CAROLINA","MARION",9688,134,5164,14986
"2012","SOUTH CAROLINA","MARLBORO",6100,77,3676,9853
"2012","SOUTH CAROLINA","MCCORMICK",2653,40,2467,5160
"2012","SOUTH CAROLINA","NEWBERRY",6913,178,9260,16351
"2012","SOUTH CAROLINA","OCONEE",8550,505,21611,30666
"2012","SOUTH CAROLINA","ORANGEBURG",30720,299,12022,43041
"2012","SOUTH CAROLINA","PICKENS",11156,919,33474,45549
"2012","SOUTH CAROLINA","RICHLAND",103989,2060,53105,159154
"2012","SOUTH CAROLINA","SALUDA",3328,101,5135,8564
"2012","SOUTH CAROLINA","SPARTANBURG",41461,1476,66969,109906
"2012","SOUTH CAROLINA","SUMTER",27589,446,19274,47309
"2012","SOUTH CAROLINA","UNION",5796,161,6584,12541
"2012","SOUTH CAROLINA","WILLIAMSBURG",11335,145,4824,16304
"2012","SOUTH CAROLINA","YORK",39131,1533,59546,100210
"2012","SOUTH DAKOTA","AURORA",556,40,804,1400
"2012","SOUTH DAKOTA","BEADLE",2881,152,4230,7263
"2012","SOUTH DAKOTA","BENNETT",548,29,626,1203
"2012","SOUTH DAKOTA","BON HOMME",1167,77,1830,3074
"2012","SOUTH DAKOTA","BROOKINGS",5827,353,6220,12400
"2012","SOUTH DAKOTA","BROWN",7250,497,8321,16068
"2012","SOUTH DAKOTA","BRULE",824,56,1499,2379
"2012","SOUTH DAKOTA","BUFFALO",472,3,166,641
"2012","SOUTH DAKOTA","BUTTE",1002,133,3073,4208
"2012","SOUTH DAKOTA","CAMPBELL",153,18,616,787
"2012","SOUTH DAKOTA","CHARLES MIX",1483,51,2230,3764
"2012","SOUTH DAKOTA","CLARK",713,41,1067,1821
"2012","SOUTH DAKOTA","CLAY",2955,132,2147,5234
"2012","SOUTH DAKOTA","CODINGTON",4588,240,6696,11524
"2012","SOUTH DAKOTA","CORSON",648,37,515,1200
"2012","SOUTH DAKOTA","CUSTER",1335,123,3062,4520
"2012","SOUTH DAKOTA","DAVISON",3042,172,4757,7971
"2012","SOUTH DAKOTA","DAY",1497,56,1320,2873
"2012","SOUTH DAKOTA","DEUEL",941,55,1175,2171
"2012","SOUTH DAKOTA","DEWEY",1207,25,663,1895
"2012","SOUTH DAKOTA","DOUGLAS",332,24,1334,1690
"2012","SOUTH DAKOTA","EDMUNDS",622,50,1264,1936
"2012","SOUTH DAKOTA","FALL RIVER",1140,118,2258,3516
"2012","SOUTH DAKOTA","FAULK",331,31,765,1127
"2012","SOUTH DAKOTA","GRANT",1493,79,2034,3606
"2012","SOUTH DAKOTA","GREGORY",599,45,1507,2151
"2012","SOUTH DAKOTA","HAAKON",138,14,940,1092
"2012","SOUTH DAKOTA","HAMLIN",921,69,1803,2793
"2012","SOUTH DAKOTA","HAND",575,31,1242,1848
"2012","SOUTH DAKOTA","HANSON",760,29,1627,2416
"2012","SOUTH DAKOTA","HARDING",82,19,638,739
"2012","SOUTH DAKOTA","HUGHES",2786,150,5219,8155
"2012","SOUTH DAKOTA","HUTCHINSON",923,51,2451,3425
"2012","SOUTH DAKOTA","HYDE",189,13,531,733
"2012","SOUTH DAKOTA","JACKSON",426,19,661,1106
"2012","SOUTH DAKOTA","JERAULD",452,16,538,1006
"2012","SOUTH DAKOTA","JONES",108,11,490,609
"2012","SOUTH DAKOTA","KINGSBURY",1092,65,1451,2608
"2012","SOUTH DAKOTA","LAKE",2724,142,3419,6285
"2012","SOUTH DAKOTA","LAWRENCE",3973,361,7025,11359
"2012","SOUTH DAKOTA","LINCOLN",7982,359,13611,21952
"2012","SOUTH DAKOTA","LYMAN",605,31,933,1569
"2012","SOUTH DAKOTA","MARSHALL",1061,37,889,1987
"2012","SOUTH DAKOTA","MCCOOK",905,53,1655,2613
"2012","SOUTH DAKOTA","MCPHERSON",272,22,921,1215
"2012","SOUTH DAKOTA","MEADE",2928,323,7566,10817
"2012","SOUTH DAKOTA","MELLETTE",375,13,381,769
"2012","SOUTH DAKOTA","MINER",479,25,636,1140
"2012","SOUTH DAKOTA","MINNEHAHA",34674,1567,40342,76583
"2012","SOUTH DAKOTA","MOODY",1429,69,1535,3033
"2012","SOUTH DAKOTA","PENNINGTON",15125,1107,28232,44464
"2012","SOUTH DAKOTA","PERKINS",319,66,1205,1590
"2012","SOUTH DAKOTA","POTTER",339,13,1029,1381
"2012","SOUTH DAKOTA","ROBERTS",2302,71,1883,4256
"2012","SOUTH DAKOTA","SANBORN",389,38,688,1115
"2012","SOUTH DAKOTA","SHANNON",2937,20,188,3145
"2012","SOUTH DAKOTA","SPINK",1300,71,1670,3041
"2012","SOUTH DAKOTA","STANLEY",435,42,1063,1540
"2012","SOUTH DAKOTA","SULLY",186,19,613,818
"2012","SOUTH DAKOTA","TODD",1976,23,498,2497
"2012","SOUTH DAKOTA","TRIPP",737,49,1905,2691
"2012","SOUTH DAKOTA","TURNER",1411,84,2715,4210
"2012","SOUTH DAKOTA","UNION",2782,116,4698,7596
"2012","SOUTH DAKOTA","WALWORTH",671,60,1731,2462
"2012","SOUTH DAKOTA","YANKTON",4226,253,5495,9974
"2012","SOUTH DAKOTA","ZIEBACH",439,8,314,761
"2012","TENNESSEE","ANDERSON",10122,569,18968,29659
"2012","TENNESSEE","BEDFORD",4211,200,10034,14445
"2012","TENNESSEE","BENTON",2258,118,3850,6226
"2012","TENNESSEE","BLEDSOE",1267,70,3022,4359
"2012","TENNESSEE","BLOUNT",12934,859,35441,49234
"2012","TENNESSEE","BRADLEY",8037,504,27422,35963
"2012","TENNESSEE","CAMPBELL",3328,169,8604,12101
"2012","TENNESSEE","CANNON",1564,100,3309,4973
"2012","TENNESSEE","CARROLL",3475,151,7225,10851
"2012","TENNESSEE","CARTER",4789,325,15503,20617
"2012","TENNESSEE","CHEATHAM",4659,255,10268,15182
"2012","TENNESSEE","CHESTER",1624,102,4684,6410
"2012","TENNESSEE","CLAIBORNE",2433,128,7617,10178
"2012","TENNESSEE","CLAY",1037,36,1747,2820
"2012","TENNESSEE","COCKE",2804,191,8459,11454
"2012","TENNESSEE","COFFEE",5870,366,13023,19259
"2012","TENNESSEE","CROCKETT",1669,46,3783,5498
"2012","TENNESSEE","CUMBERLAND",6261,333,18653,25247
"2012","TENNESSEE","DAVIDSON",143120,4131,97622,244873
"2012","TENNESSEE","DECATUR",1303,74,2874,4251
"2012","TENNESSEE","DEKALB",2174,105,4143,6422
"2012","TENNESSEE","DICKSON",6233,306,11296,17835
"2012","TENNESSEE","DYER",3757,122,9921,13800
"2012","TENNESSEE","FAYETTE",6688,197,12689,19574
"2012","TENNESSEE","FENTRESS",1561,91,5243,6895
"2012","TENNESSEE","FRANKLIN",5603,254,10262,16119
"2012","TENNESSEE","GIBSON",6564,220,12883,19667
"2012","TENNESSEE","GILES",3760,124,6915,10799
"2012","TENNESSEE","GRAINGER",1668,114,5470,7252
"2012","TENNESSEE","GREENE",6225,417,17245,23887
"2012","TENNESSEE","GRUNDY",1643,78,2516,4237
"2012","TENNESSEE","HAMBLEN",5234,276,14522,20032
"2012","TENNESSEE","HAMILTON",58836,2412,79933,141181
"2012","TENNESSEE","HANCOCK",475,44,1527,2046
"2012","TENNESSEE","HARDEMAN",5482,92,4865,10439
"2012","TENNESSEE","HARDIN",2467,142,7886,10495
"2012","TENNESSEE","HAWKINS",5088,327,14382,19797
"2012","TENNESSEE","HAYWOOD",4569,40,2960,7569
"2012","TENNESSEE","HENDERSON",2517,117,7421,10055
"2012","TENNESSEE","HENRY",4339,207,8193,12739
"2012","TENNESSEE","HICKMAN",2698,146,4758,7602
"2012","TENNESSEE","HOUSTON",1400,48,1579,3027
"2012","TENNESSEE","HUMPHREYS",2905,125,3833,6863
"2012","TENNESSEE","JACKSON",1739,62,2383,4184
"2012","TENNESSEE","JEFFERSON",4232,289,13038,17559
"2012","TENNESSEE","JOHNSON",1483,100,4611,6194
"2012","TENNESSEE","KNOX",59399,3401,109707,172507
"2012","TENNESSEE","LAKE",884,40,1163,2087
"2012","TENNESSEE","LAUDERDALE",4011,62,4616,8689
"2012","TENNESSEE","LAWRENCE",4237,212,10770,15219
"2012","TENNESSEE","LEWIS",1447,130,3117,4694
"2012","TENNESSEE","LINCOLN",3290,175,9803,13268
"2012","TENNESSEE","LOUDON",5058,308,16707,22073
"2012","TENNESSEE","MACON",1552,93,5260,6905
"2012","TENNESSEE","MADISON",18367,342,21993,40702
"2012","TENNESSEE","MARION",3953,184,6272,10409
"2012","TENNESSEE","MARSHALL",3725,184,6832,10741
"2012","TENNESSEE","MAURY",11825,473,20708,33006
"2012","TENNESSEE","MCMINN",4609,258,12967,17834
"2012","TENNESSEE","MCNAIRY",2645,142,7015,9802
"2012","TENNESSEE","MEIGS",1163,67,2734,3964
"2012","TENNESSEE","MONROE",4372,235,11731,16338
"2012","TENNESSEE","MONTGOMERY",24499,840,30245,55584
"2012","TENNESSEE","MOORE",705,41,2053,2799
"2012","TENNESSEE","MORGAN",1725,110,4669,6504
"2012","TENNESSEE","OBION",3321,162,8814,12297
"2012","TENNESSEE","OVERTON",2805,84,4775,7664
"2012","TENNESSEE","PERRY",992,51,1578,2621
"2012","TENNESSEE","PICKETT",712,29,1712,2453
"2012","TENNESSEE","POLK",1856,95,4108,6059
"2012","TENNESSEE","PUTNAM",7802,444,17254,25500
"2012","TENNESSEE","RHEA",2628,160,7802,10590
"2012","TENNESSEE","ROANE",6018,348,14724,21090
"2012","TENNESSEE","ROBERTSON",8290,356,17643,26289
"2012","TENNESSEE","RUTHERFORD",36414,1588,60846,98848
"2012","TENNESSEE","SCOTT",1452,99,5117,6668
"2012","TENNESSEE","SEQUATCHIE",1489,112,3541,5142
"2012","TENNESSEE","SEVIER",7418,462,25984,33864
"2012","TENNESSEE","SHELBY",232443,3017,135649,371109
"2012","TENNESSEE","SMITH",2470,122,4495,7087
"2012","TENNESSEE","STEWART",2069,83,2963,5115
"2012","TENNESSEE","SULLIVAN",15321,1004,43562,59887
"2012","TENNESSEE","SUMNER",18579,784,46003,65366
"2012","TENNESSEE","TIPTON",7133,276,16672,24081
"2012","TENNESSEE","TROUSDALE",1240,53,1612,2905
"2012","TENNESSEE","UNICOI",1913,141,5032,7086
"2012","TENNESSEE","UNION",1478,68,4282,5828
"2012","TENNESSEE","VAN BUREN",875,39,1386,2300
"2012","TENNESSEE","WARREN",4752,253,8010,13015
"2012","TENNESSEE","WASHINGTON",14325,899,32808,48032
"2012","TENNESSEE","WAYNE",1163,70,4253,5486
"2012","TENNESSEE","WEAKLEY",3548,184,8605,12337
"2012","TENNESSEE","WHITE",2795,148,6197,9140
"2012","TENNESSEE","WILLIAMSON",25142,1233,69850,96225
"2012","TENNESSEE","WILSON",14695,695,36109,51499
"2012","TEXAS","ANDERSON",3813,137,12262,16212
"2012","TEXAS","ANDREWS",795,48,3639,4482
"2012","TEXAS","ANGELINA",7834,269,20303,28406
"2012","TEXAS","ARANSAS",2704,114,6830,9648
"2012","TEXAS","ARCHER",525,39,3600,4164
"2012","TEXAS","ARMSTRONG",98,9,828,935
"2012","TEXAS","ATASCOSA",5133,127,7461,12721
"2012","TEXAS","AUSTIN",2252,132,9265,11649
"2012","TEXAS","BAILEY",466,11,1339,1816
"2012","TEXAS","BANDERA",1864,158,7426,9448
"2012","TEXAS","BASTROP",9864,584,14033,24481
"2012","TEXAS","BAYLOR",267,28,1297,1592
"2012","TEXAS","BEE",3452,71,4356,7879
"2012","TEXAS","BELL",35512,1120,49574,86206
"2012","TEXAS","BEXAR",264856,7208,241617,513681
"2012","TEXAS","BLANCO",1220,115,3638,4973
"2012","TEXAS","BORDEN",32,7,324,363
"2012","TEXAS","BOSQUE",1367,104,5885,7356
"2012","TEXAS","BOWIE",10196,339,24869,35404
"2012","TEXAS","BRAZORIA",34421,1456,70862,106739
"2012","TEXAS","BRAZOS",17477,1276,37209,55962
"2012","TEXAS","BREWSTER",1765,126,1976,3867
"2012","TEXAS","BRISCOE",117,7,578,702
"2012","TEXAS","BROOKS",1886,10,507,2403
"2012","TEXAS","BROWN",1904,148,11895,13947
"2012","TEXAS","BURLESON",1705,80,4671,6456
"2012","TEXAS","BURNET",3674,279,12843,16796
"2012","TEXAS","CALDWELL",4791,256,6021,11068
"2012","TEXAS","CALHOUN",2410,94,4144,6648
"2012","TEXAS","CALLAHAN",751,68,4378,5197
"2012","TEXAS","CAMERON",49975,821,26099,76895
"2012","TEXAS","CAMP",1428,26,2881,4335
"2012","TEXAS","CARSON",292,35,2451,2778
"2012","TEXAS","CASS",2924,101,8763,11788
"2012","TEXAS","CASTRO",630,19,1470,2119
"2012","TEXAS","CHAMBERS",2790,158,11787,14735
"2012","TEXAS","CHEROKEE",3875,157,12094,16126
"2012","TEXAS","CHILDRESS",320,11,1665,1996
"2012","TEXAS","CLAY",740,51,4266,5057
"2012","TEXAS","COCHRAN",256,12,649,917
"2012","TEXAS","COKE",179,11,1218,1408
"2012","TEXAS","COLEMAN",442,38,3012,3492
"2012","TEXAS","COLLIN",101415,4518,196888,302821
"2012","TEXAS","COLLINGSWORTH",177,11,962,1150
"2012","TEXAS","COLORADO",2029,62,6026,8117
"2012","TEXAS","COMAL",11450,761,39318,51529
"2012","TEXAS","COMANCHE",890,72,3944,4906
"2012","TEXAS","CONCHO",194,14,793,1001
"2012","TEXAS","COOKE",2246,154,11951,14351
"2012","TEXAS","CORYELL",5158,226,11220,16604
"2012","TEXAS","COTTLE",180,6,555,741
"2012","TEXAS","CRANE",275,23,985,1283
"2012","TEXAS","CROCKETT",480,20,957,1457
"2012","TEXAS","CROSBY",639,16,1132,1787
"2012","TEXAS","CULBERSON",568,16,295,879
"2012","TEXAS","DALLAM",253,33,1248,1534
"2012","TEXAS","DALLAS",405571,8733,295813,710117
"2012","TEXAS","DAWSON",1019,32,2591,3642
"2012","TEXAS","DEAF SMITH",1239,28,3042,4309
"2012","TEXAS","DELTA",454,40,1524,2018
"2012","TEXAS","DENTON",80978,4224,157579,242781
"2012","TEXAS","DEWITT",1467,49,5122,6638
"2012","TEXAS","DICKENS",216,10,793,1019
"2012","TEXAS","DIMMIT",2141,14,762,2917
"2012","TEXAS","DONLEY",226,22,1287,1535
"2012","TEXAS","DUVAL",3331,33,980,4344
"2012","TEXAS","EASTLAND",970,81,5444,6495
"2012","TEXAS","ECTOR",8118,385,24010,32513
"2012","TEXAS","EDWARDS",232,10,642,884
"2012","TEXAS","EL PASO",112952,2310,57150,172412
"2012","TEXAS","ELLIS",13881,696,39574,54151
"2012","TEXAS","ERATH",1965,179,10329,12473
"2012","TEXAS","FALLS",2033,45,3356,5434
"2012","TEXAS","FANNIN",2486,157,8161,10804
"2012","TEXAS","FAYETTE",2315,130,8106,10551
"2012","TEXAS","FISHER",512,23,1094,1629
"2012","TEXAS","FLOYD",551,11,1523,2085
"2012","TEXAS","FOARD",140,7,348,495
"2012","TEXAS","FORT BEND",101144,2219,116126,219489
"2012","TEXAS","FRANKLIN",751,60,3446,4257
"2012","TEXAS","FREESTONE",1850,74,5646,7570
"2012","TEXAS","FRIO",2376,33,1559,3968
"2012","TEXAS","GAINES",535,47,3484,4066
"2012","TEXAS","GALVESTON",39511,1508,69059,110078
"2012","TEXAS","GARZA",279,18,1263,1560
"2012","TEXAS","GILLESPIE",2055,189,10306,12550
"2012","TEXAS","GLASSCOCK",44,8,526,578
"2012","TEXAS","GOLIAD",1127,37,2294,3458
"2012","TEXAS","GONZALES",1777,64,4216,6057
"2012","TEXAS","GRAY",886,60,6443,7389
"2012","TEXAS","GRAYSON",10670,658,30936,42264
"2012","TEXAS","GREGG",12398,367,28742,41507
"2012","TEXAS","GRIMES",2339,121,6141,8601
"2012","TEXAS","GUADALUPE",15744,653,33117,49514
"2012","TEXAS","HALE",2243,121,6490,8854
"2012","TEXAS","HALL",265,12,832,1109
"2012","TEXAS","HAMILTON",591,43,2918,3552
"2012","TEXAS","HANSFORD",159,15,1788,1962
"2012","TEXAS","HARDEMAN",302,17,1176,1495
"2012","TEXAS","HARDIN",3359,192,17746,21297
"2012","TEXAS","HARRIS",587044,15468,586073,1188585
"2012","TEXAS","HARRISON",8456,202,17512,26170
"2012","TEXAS","HARTLEY",184,21,1708,1913
"2012","TEXAS","HASKELL",553,36,1424,2013
"2012","TEXAS","HAYS",25537,1813,31661,59011
"2012","TEXAS","HEMPHILL",192,19,1298,1509
"2012","TEXAS","HENDERSON",6106,290,21231,27627
"2012","TEXAS","HIDALGO",97969,1325,39865,139159
"2012","TEXAS","HILL",2752,161,9132,12045
"2012","TEXAS","HOCKLEY",1486,102,5546,7134
"2012","TEXAS","HOOD",3843,283,18409,22535
"2012","TEXAS","HOPKINS",2777,140,9836,12753
"2012","TEXAS","HOUSTON",2265,69,5880,8214
"2012","TEXAS","HOWARD",2110,132,6453,8695
"2012","TEXAS","HUDSPETH",379,13,471,863
"2012","TEXAS","HUNT",6671,367,21011,28049
"2012","TEXAS","HUTCHINSON",1045,79,6804,7928
"2012","TEXAS","IRION",112,8,668,788
"2012","TEXAS","JACK",303,25,2580,2908
"2012","TEXAS","JACKSON",1070,49,3906,5025
"2012","TEXAS","JASPER",3423,137,9957,13517
"2012","TEXAS","JEFF DAVIS",440,33,719,1192
"2012","TEXAS","JEFFERSON",44668,717,43242,88627
"2012","TEXAS","JIM HOGG",1301,10,356,1667
"2012","TEXAS","JIM WELLS",6492,76,4598,11166
"2012","TEXAS","JOHNSON",10496,681,37661,48838
"2012","TEXAS","JONES",1226,79,4262,5567
"2012","TEXAS","KARNES",1325,35,2825,4185
"2012","TEXAS","KAUFMAN",9472,352,24846,34670
"2012","TEXAS","KENDALL",3043,232,14508,17783
"2012","TEXAS","KENEDY",82,1,84,167
"2012","TEXAS","KENT",66,4,335,405
"2012","TEXAS","KERR",4338,267,17274,21879
"2012","TEXAS","KIMBLE",217,8,1667,1892
"2012","TEXAS","KING",5,1,139,145
"2012","TEXAS","KINNEY",522,23,880,1425
"2012","TEXAS","KLEBERG",4754,95,4058,8907
"2012","TEXAS","KNOX",332,18,1160,1510
"2012","TEXAS","LA SALLE",965,12,669,1646
"2012","TEXAS","LAMAR",4181,190,12826,17197
"2012","TEXAS","LAMB",998,35,3058,4091
"2012","TEXAS","LAMPASAS",1479,104,5621,7204
"2012","TEXAS","LAVACA",1428,70,6796,8294
"2012","TEXAS","LEE",1632,82,4507,6221
"2012","TEXAS","LEON",1062,69,5814,6945
"2012","TEXAS","LIBERTY",5202,221,17323,22746
"2012","TEXAS","LIMESTONE",2208,67,5288,7563
"2012","TEXAS","LIPSCOMB",119,5,1044,1168
"2012","TEXAS","LIVE OAK",919,40,3154,4113
"2012","TEXAS","LLANO",1822,126,7610,9558
"2012","TEXAS","LOVING",9,1,54,64
"2012","TEXAS","LUBBOCK",26271,1444,63469,91184
"2012","TEXAS","LYNN",506,14,1439,1959
"2012","TEXAS","MADISON",967,33,3028,4028
"2012","TEXAS","MARION",1495,54,2733,4282
"2012","TEXAS","MARTIN",248,8,1368,1624
"2012","TEXAS","MASON",380,23,1565,1968
"2012","TEXAS","MATAGORDA",3980,113,8040,12133
"2012","TEXAS","MAVERICK",8303,89,2171,10563
"2012","TEXAS","MCCULLOCH",537,37,2419,2993
"2012","TEXAS","MCLENNAN",25694,944,47903,74541
"2012","TEXAS","MCMULLEN",67,5,431,503
"2012","TEXAS","MEDINA",4784,186,11079,16049
"2012","TEXAS","MENARD",171,13,665,849
"2012","TEXAS","MIDLAND",8286,622,35689,44597
"2012","TEXAS","MILAM",2636,113,5481,8230
"2012","TEXAS","MILLS",279,40,1882,2201
"2012","TEXAS","MITCHELL",538,22,1756,2316
"2012","TEXAS","MONTAGUE",1116,86,6549,7751
"2012","TEXAS","MONTGOMERY",32920,2224,137969,173113
"2012","TEXAS","MOORE",964,53,3968,4985
"2012","TEXAS","MORRIS",1858,49,3232,5139
"2012","TEXAS","MOTLEY",55,7,538,600
"2012","TEXAS","NACOGDOCHES",6465,263,13925,20653
"2012","TEXAS","NAVARRO",4350,167,10847,15364
"2012","TEXAS","NEWTON",1677,80,4112,5869
"2012","TEXAS","NOLAN",1216,77,3282,4575
"2012","TEXAS","NUECES",45772,1366,48966,96104
"2012","TEXAS","OCHILTREE",253,21,2719,2993
"2012","TEXAS","OLDHAM",71,8,790,869
"2012","TEXAS","ORANGE",6800,352,23366,30518
"2012","TEXAS","PALO PINTO",1811,133,7393,9337
"2012","TEXAS","PANOLA",2211,69,7950,10230
"2012","TEXAS","PARKER",7853,598,39243,47694
"2012","TEXAS","PARMER",529,14,2011,2554
"2012","TEXAS","PECOS",1591,47,2512,4150
"2012","TEXAS","POLK",4859,204,14071,19134
"2012","TEXAS","POTTER",7126,406,18918,26450
"2012","TEXAS","PRESIDIO",1282,31,504,1817
"2012","TEXAS","RAINS",761,47,3279,4087
"2012","TEXAS","RANDALL",7574,675,41447,49696
"2012","TEXAS","REAGAN",158,9,676,843
"2012","TEXAS","REAL",277,22,1236,1535
"2012","TEXAS","RED RIVER",1482,43,3549,5074
"2012","TEXAS","REEVES",1655,34,1188,2877
"2012","TEXAS","REFUGIO",998,16,1663,2677
"2012","TEXAS","ROBERTS",33,7,468,508
"2012","TEXAS","ROBERTSON",2798,70,4419,7287
"2012","TEXAS","ROCKWALL",8120,445,27113,35678
"2012","TEXAS","RUNNELS",519,45,3104,3668
"2012","TEXAS","RUSK",4451,171,13924,18546
"2012","TEXAS","SABINE",807,44,3727,4578
"2012","TEXAS","SAN AUGUSTINE",1193,28,2469,3690
"2012","TEXAS","SAN JACINTO",2410,99,7107,9616
"2012","TEXAS","SAN PATRICIO",7856,217,12005,20078
"2012","TEXAS","SAN SABA",323,31,1905,2259
"2012","TEXAS","SCHLEICHER",221,9,787,1017
"2012","TEXAS","SCURRY",838,65,4124,5027
"2012","TEXAS","SHACKELFORD",131,14,1218,1363
"2012","TEXAS","SHELBY",2322,83,6879,9284
"2012","TEXAS","SHERMAN",121,9,908,1038
"2012","TEXAS","SMITH",21456,814,57331,79601
"2012","TEXAS","SOMERVELL",613,54,2871,3538
"2012","TEXAS","STARR",10260,76,1547,11883
"2012","TEXAS","STEPHENS",475,45,2892,3412
"2012","TEXAS","STERLING",31,4,459,494
"2012","TEXAS","STONEWALL",160,8,507,675
"2012","TEXAS","SUTTON",369,10,1110,1489
"2012","TEXAS","SWISHER",579,36,1655,2270
"2012","TEXAS","TARRANT",253071,8899,348920,610890
"2012","TEXAS","TAYLOR",9750,609,32904,43263
"2012","TEXAS","TERRELL",184,13,358,555
"2012","TEXAS","TERRY",1059,48,2602,3709
"2012","TEXAS","THROCKMORTON",109,4,700,813
"2012","TEXAS","TITUS",2648,122,6084,8854
"2012","TEXAS","TOM GREEN",9294,548,26878,36720
"2012","TEXAS","TRAVIS",232788,14117,140152,387057
"2012","TEXAS","TRINITY",1614,84,4537,6235
"2012","TEXAS","TYLER",1668,76,5910,7654
"2012","TEXAS","UPSHUR",2971,152,12015,15138
"2012","TEXAS","UPTON",333,14,953,1300
"2012","TEXAS","UVALDE",3825,81,4529,8435
"2012","TEXAS","VAL VERDE",6285,161,5635,12081
"2012","TEXAS","VAN ZANDT",3084,222,15794,19100
"2012","TEXAS","VICTORIA",8802,359,19692,28853
"2012","TEXAS","WALKER",6252,293,12140,18685
"2012","TEXAS","WALLER",6514,144,9244,15902
"2012","TEXAS","WARD",841,38,2366,3245
"2012","TEXAS","WASHINGTON",3381,159,10857,14397
"2012","TEXAS","WEBB",37597,435,11078,49110
"2012","TEXAS","WHARTON",4235,102,9750,14087
"2012","TEXAS","WHEELER",232,18,1878,2128
"2012","TEXAS","WICHITA",10525,681,29812,41018
"2012","TEXAS","WILBARGER",971,53,2956,3980
"2012","TEXAS","WILLACY",3600,48,1416,5064
"2012","TEXAS","WILLIAMSON",61875,4390,97006,163271
"2012","TEXAS","WILSON",4821,166,12218,17205
"2012","TEXAS","WINKLER",398,16,1311,1725
"2012","TEXAS","WISE",3221,317,17207,20745
"2012","TEXAS","WOOD",3056,174,14351,17581
"2012","TEXAS","YOAKUM",409,21,1698,2128
"2012","TEXAS","YOUNG",992,99,6225,7316
"2012","TEXAS","ZAPATA",2527,19,997,3543
"2012","TEXAS","ZAVALA",3042,37,574,3653
"2012","UTAH","BEAVER",346,40,2174,2560
"2012","UTAH","BOX ELDER",1984,323,17101,19408
"2012","UTAH","CACHE",6244,1010,35039,42293
"2012","UTAH","CARBON",2275,202,5090,7567
"2012","UTAH","DAGGETT",94,20,406,520
"2012","UTAH","DAVIS",21889,2319,96861,121069
"2012","UTAH","DUCHESNE",581,100,5698,6379
"2012","UTAH","EMERY",569,103,3777,4449
"2012","UTAH","GARFIELD",308,42,1832,2182
"2012","UTAH","GRAND",1727,227,1996,3950
"2012","UTAH","IRON",2148,353,14200,16701
"2012","UTAH","JUAB",451,73,3448,3972
"2012","UTAH","KANE",744,105,2522,3371
"2012","UTAH","MILLARD",431,117,4478,5026
"2012","UTAH","MORGAN",403,80,4114,4597
"2012","UTAH","PIUTE",74,11,697,782
"2012","UTAH","RICH",83,9,915,1007
"2012","UTAH","SALT LAKE",146147,11841,223811,381799
"2012","UTAH","SAN JUAN",2139,94,3074,5307
"2012","UTAH","SANPETE",980,161,8406,9547
"2012","UTAH","SEVIER",738,124,7207,8069
"2012","UTAH","SUMMIT",8072,532,8884,17488
"2012","UTAH","TOOELE",4524,469,14268,19261
"2012","UTAH","UINTAH",997,165,10421,11583
"2012","UTAH","UTAH",17281,3482,156950,177713
"2012","UTAH","WASATCH",2191,178,7220,9589
"2012","UTAH","WASHINGTON",8337,977,44698,54012
"2012","UTAH","WAYNE",215,23,1089,1327
"2012","UTAH","WEBER",19841,1847,54224,75912
"2012","VERMONT","ADDISON",12257,450,5203,17910
"2012","VERMONT","BENNINGTON",11514,392,5687,17593
"2012","VERMONT","CALEDONIA",8192,381,5088,13661
"2012","VERMONT","CHITTENDEN",53626,1883,21571,77080
"2012","VERMONT","ESSEX",1539,95,1164,2798
"2012","VERMONT","FRANKLIN",12057,426,7405,19888
"2012","VERMONT","GRAND ISLE",2531,73,1471,4075
"2012","VERMONT","LAMOILLE",8371,275,3342,11988
"2012","VERMONT","ORANGE",9076,389,4588,14053
"2012","VERMONT","ORLEANS",7117,269,4306,11692
"2012","VERMONT","RUTLAND",17088,686,10835,28609
"2012","VERMONT","WASHINGTON",20351,863,8093,29307
"2012","VERMONT","WINDHAM",16026,564,5347,21937
"2012","VERMONT","WINDSOR",19494,607,8598,28699
"2012","VIRGINIA","ACCOMACK",7655,183,8213,16051
"2012","VIRGINIA","ALBEMARLE",29757,853,23297,53907
"2012","VIRGINIA","ALEXANDRIA",52199,963,20249,73411
"2012","VIRGINIA","ALLEGHANY",3403,175,3595,7173
"2012","VIRGINIA","AMELIA",2490,94,4331,6915
"2012","VIRGINIA","AMHERST",5900,194,8876,14970
"2012","VIRGINIA","APPOMATTOX",2453,142,5340,7935
"2012","VIRGINIA","ARLINGTON",81269,1865,34474,117608
"2012","VIRGINIA","AUGUSTA",9451,597,23624,33672
"2012","VIRGINIA","BATH",894,55,1274,2223
"2012","VIRGINIA","BEDFORD",11434,590,28206,40230
"2012","VIRGINIA","BLAND",735,69,2144,2948
"2012","VIRGINIA","BOTETOURT",5452,310,12479,18241
"2012","VIRGINIA","BRISTOL",2492,115,4780,7387
"2012","VIRGINIA","BRUNSWICK",4994,75,2968,8037
"2012","VIRGINIA","BUCHANAN",3094,116,6436,9646
"2012","VIRGINIA","BUCKINGHAM",3750,138,3569,7457
"2012","VIRGINIA","BUENA VISTA",919,43,1564,2526
"2012","VIRGINIA","CAMPBELL",7595,406,17695,25696
"2012","VIRGINIA","CAROLINE",7276,225,6151,13652
"2012","VIRGINIA","CARROLL",3685,497,8736,12918
"2012","VIRGINIA","CHARLES CITY",2772,64,1396,4232
"2012","VIRGINIA","CHARLOTTE",2503,84,3311,5898
"2012","VIRGINIA","CHARLOTTESVILLE",16510,443,4844,21797
"2012","VIRGINIA","CHESAPEAKE",55052,1473,53900,110425
"2012","VIRGINIA","CHESTERFIELD",77694,2360,90934,170988
"2012","VIRGINIA","CLARKE",3239,227,4296,7762
"2012","VIRGINIA","COLONIAL HEIGHTS",2544,139,5941,8624
"2012","VIRGINIA","COVINGTON",1319,36,975,2330
"2012","VIRGINIA","CRAIG",830,80,1757,2667
"2012","VIRGINIA","CULPEPER",8285,346,11580,20211
"2012","VIRGINIA","CUMBERLAND",2422,88,2538,5048
"2012","VIRGINIA","DANVILLE",12218,223,7763,20204
"2012","VIRGINIA","DICKENSON",2473,157,4274,6904
"2012","VIRGINIA","DINWIDDIE",6550,164,6875,13589
"2012","VIRGINIA","EMPORIA",1793,17,886,2696
"2012","VIRGINIA","ESSEX",3016,57,2602,5675
"2012","VIRGINIA","FAIRFAX",321924,7444,211548,540916
"2012","VIRGINIA","FALLS CHURCH",5015,114,2147,7276
"2012","VIRGINIA","FAUQUIER",13965,556,21034,35555
"2012","VIRGINIA","FLOYD",2732,239,4673,7644
"2012","VIRGINIA","FLUVANNA",5893,178,6678,12749
"2012","VIRGINIA","FRANKLIN",11923,930,18214,31067
"2012","VIRGINIA","FREDERICK",12690,846,22858,36394
"2012","VIRGINIA","FREDERICKSBURG",7131,246,4060,11437
"2012","VIRGINIA","GALAX",900,45,1332,2277
"2012","VIRGINIA","GILES",2730,168,4660,7558
"2012","VIRGINIA","GLOUCESTER",6764,382,12137,19283
"2012","VIRGINIA","GOOCHLAND",4676,191,8448,13315
"2012","VIRGINIA","GRAYSON",2068,252,4801,7121
"2012","VIRGINIA","GREENE",3290,164,5569,9023
"2012","VIRGINIA","GREENSVILLE",3135,25,1766,4926
"2012","VIRGINIA","HALIFAX",7766,232,8694,16692
"2012","VIRGINIA","HAMPTON",46966,884,18640,66490
"2012","VIRGINIA","HANOVER",18294,824,39940,59058
"2012","VIRGINIA","HARRISONBURG",8654,374,6565,15593
"2012","VIRGINIA","HENRICO",89594,2198,70449,162241
"2012","VIRGINIA","HENRY",10317,662,13984,24963
"2012","VIRGINIA","HIGHLAND",459,30,924,1413
"2012","VIRGINIA","HOPEWELL",5179,113,3739,9031
"2012","VIRGINIA","ISLE OF WIGHT",8761,264,11802,20827
"2012","VIRGINIA","JAMES CITY",17879,518,22843,41240
"2012","VIRGINIA","KING AND QUEEN",1745,45,1865,3655
"2012","VIRGINIA","KING GEORGE",4477,244,6604,11325
"2012","VIRGINIA","KING WILLIAM",3344,113,5466,8923
"2012","VIRGINIA","LANCASTER",3149,59,3753,6961
"2012","VIRGINIA","LEE",2583,168,6847,9598
"2012","VIRGINIA","LEXINGTON",1486,55,1146,2687
"2012","VIRGINIA","LOUDOUN",82479,2289,75292,160060
"2012","VIRGINIA","LOUISA",6953,284,9215,16452
"2012","VIRGINIA","LUNENBURG",2684,81,2969,5734
"2012","VIRGINIA","LYNCHBURG",15948,694,19806,36448
"2012","VIRGINIA","MADISON",2639,106,3869,6614
"2012","VIRGINIA","MANASSAS",8478,259,6463,15200
"2012","VIRGINIA","MANASSAS PARK",2879,78,1699,4656
"2012","VIRGINIA","MARTINSVILLE",3855,117,2312,6284
"2012","VIRGINIA","MATHEWS",1807,79,3488,5374
"2012","VIRGINIA","MECKLENBURG",6921,183,7973,15077
"2012","VIRGINIA","MIDDLESEX",2370,91,3619,6080
"2012","VIRGINIA","MONTGOMERY",19903,1100,20006,41009
"2012","VIRGINIA","NELSON",4171,132,3947,8250
"2012","VIRGINIA","NEW KENT",3555,152,7246,10953
"2012","VIRGINIA","NEWPORT NEWS",51100,1114,27230,79444
"2012","VIRGINIA","NORFOLK",62687,1209,23147,87043
"2012","VIRGINIA","NORTHAMPTON",3741,74,2676,6491
"2012","VIRGINIA","NORTHUMBERLAND",3191,57,4310,7558
"2012","VIRGINIA","NORTON",566,31,895,1492
"2012","VIRGINIA","NOTTOWAY",3344,93,3409,6846
"2012","VIRGINIA","ORANGE",6870,240,9244,16354
"2012","VIRGINIA","PAGE",3724,160,6344,10228
"2012","VIRGINIA","PATRICK",2417,220,5622,8259
"2012","VIRGINIA","PETERSBURG",14283,98,1527,15908
"2012","VIRGINIA","PITTSYLVANIA",10858,560,19263,30681
"2012","VIRGINIA","POQUOSON",1679,115,5312,7106
"2012","VIRGINIA","PORTSMOUTH",32501,563,12858,45922
"2012","VIRGINIA","POWHATAN",4088,237,11200,15525
"2012","VIRGINIA","PRINCE EDWARD",5132,155,3952,9239
"2012","VIRGINIA","PRINCE GEORGE",6991,176,8879,16046
"2012","VIRGINIA","PRINCE WILLIAM",103331,2406,74458,180195
"2012","VIRGINIA","PULASKI",5292,468,8920,14680
"2012","VIRGINIA","RADFORD",2732,147,2520,5399
"2012","VIRGINIA","RAPPAHANNOCK",1980,66,2311,4357
"2012","VIRGINIA","RICHMOND",77495,1634,22210,101339
"2012","VIRGINIA","ROANOKE",42845,1912,46615,91372
"2012","VIRGINIA","ROCKBRIDGE",4088,191,5898,10177
"2012","VIRGINIA","ROCKINGHAM",10065,615,24186,34866
"2012","VIRGINIA","RUSSELL",3718,190,8180,12088
"2012","VIRGINIA","SALEM",4760,259,7299,12318
"2012","VIRGINIA","SCOTT",2395,158,7439,9992
"2012","VIRGINIA","SHENANDOAH",6469,366,12538,19373
"2012","VIRGINIA","SMYTH",4171,227,8379,12777
"2012","VIRGINIA","SOUTHAMPTON",4437,94,4733,9264
"2012","VIRGINIA","SPOTSYLVANIA",25165,965,31844,57974
"2012","VIRGINIA","STAFFORD",27182,921,32480,60583
"2012","VIRGINIA","STAUNTON",5728,210,5272,11210
"2012","VIRGINIA","SUFFOLK",24267,479,17820,42566
"2012","VIRGINIA","SURRY",2576,61,1671,4308
"2012","VIRGINIA","SUSSEX",3358,61,2021,5440
"2012","VIRGINIA","TAZEWELL",3661,228,13843,17732
"2012","VIRGINIA","VIRGINIA BEACH",94299,3051,99291,196641
"2012","VIRGINIA","WARREN",6452,377,9869,16698
"2012","VIRGINIA","WASHINGTON",7076,415,18141,25632
"2012","VIRGINIA","WAYNESBORO",3840,161,4790,8791
"2012","VIRGINIA","WESTMORELAND",4295,94,3731,8120
"2012","VIRGINIA","WILLIAMSBURG",4903,163,2682,7748
"2012","VIRGINIA","WINCHESTER",5094,256,4946,10296
"2012","VIRGINIA","WISE",3760,182,11076,15018
"2012","VIRGINIA","WYTHE",3783,251,8324,12358
"2012","VIRGINIA","YORK",13183,566,20204,33953
"2012","WASHINGTON","ADAMS",1540,82,3171,4793
"2012","WASHINGTON","ASOTIN",4003,244,5654,9901
"2012","WASHINGTON","BENTON",28145,1953,49461,79559
"2012","WASHINGTON","CHELAN",13112,736,18402,32250
"2012","WASHINGTON","CLALLAM",18580,1049,18437,38066
"2012","WASHINGTON","CLARK",93382,4472,92951,190805
"2012","WASHINGTON","COLUMBIA",645,46,1568,2259
"2012","WASHINGTON","COWLITZ",22726,1148,20746,44620
"2012","WASHINGTON","DOUGLAS",5166,351,9425,14942
"2012","WASHINGTON","FERRY",1294,151,1995,3440
"2012","WASHINGTON","FRANKLIN",8398,497,13748,22643
"2012","WASHINGTON","GARFIELD",336,29,913,1278
"2012","WASHINGTON","GRANT",8950,756,17852,27558
"2012","WASHINGTON","GRAYS HARBOR",15960,810,11914,28684
"2012","WASHINGTON","ISLAND",21478,1016,19605,42099
"2012","WASHINGTON","JEFFERSON",12739,685,6405,19829
"2012","WASHINGTON","KING",668004,23450,275700,967154
"2012","WASHINGTON","KITSAP",67277,3244,52846,123367
"2012","WASHINGTON","KITTITAS",7949,440,9782,18171
"2012","WASHINGTON","KLICKITAT",4598,360,5316,10274
"2012","WASHINGTON","LEWIS",12664,928,20452,34044
"2012","WASHINGTON","LINCOLN",1673,136,4063,5872
"2012","WASHINGTON","MASON",14764,710,12761,28235
"2012","WASHINGTON","OKANOGAN",7108,517,9221,16846
"2012","WASHINGTON","PACIFIC",5711,314,4499,10524
"2012","WASHINGTON","PEND OREILLE",2508,208,3952,6668
"2012","WASHINGTON","PIERCE",186430,8013,148467,342910
"2012","WASHINGTON","SAN JUAN",7125,358,3111,10594
"2012","WASHINGTON","SKAGIT",28688,1510,25071,55269
"2012","WASHINGTON","SKAMANIA",2628,151,2687,5466
"2012","WASHINGTON","SNOHOMISH",188516,8285,133016,329817
"2012","WASHINGTON","SPOKANE",102295,6250,115285,223830
"2012","WASHINGTON","STEVENS",7762,708,13691,22161
"2012","WASHINGTON","THURSTON",74037,3739,49287,127063
"2012","WASHINGTON","WAHKIAKUM",1094,81,1119,2294
"2012","WASHINGTON","WALLA WALLA",9768,692,14648,25108
"2012","WASHINGTON","WHATCOM",57089,3237,42703,103029
"2012","WASHINGTON","WHITMAN",8037,577,8507,17121
"2012","WASHINGTON","YAKIMA",33217,1517,42239,76973
"2012","WEST VIRGINIA","BARBOUR",1768,169,3824,5761
"2012","WEST VIRGINIA","BERKELEY",14275,741,22156,37172
"2012","WEST VIRGINIA","BOONE",2790,243,5467,8500
"2012","WEST VIRGINIA","BRAXTON",1998,81,2725,4804
"2012","WEST VIRGINIA","BROOKE",4005,229,5060,9294
"2012","WEST VIRGINIA","CABELL",13568,591,17985,32144
"2012","WEST VIRGINIA","CALHOUN",818,70,1319,2207
"2012","WEST VIRGINIA","CLAY",931,110,1971,3012
"2012","WEST VIRGINIA","DODDRIDGE",575,64,2130,2769
"2012","WEST VIRGINIA","FAYETTE",5419,301,8350,14070
"2012","WEST VIRGINIA","GILMER",840,74,1595,2509
"2012","WEST VIRGINIA","GRANT",718,85,3783,4586
"2012","WEST VIRGINIA","GREENBRIER",4710,323,7930,12963
"2012","WEST VIRGINIA","HAMPSHIRE",2299,164,5523,7986
"2012","WEST VIRGINIA","HANCOCK",4627,265,7226,12118
"2012","WEST VIRGINIA","HARDY",1482,150,3536,5168
"2012","WEST VIRGINIA","HARRISON",9732,539,15876,26147
"2012","WEST VIRGINIA","JACKSON",3854,282,7408,11544
"2012","WEST VIRGINIA","JEFFERSON",10398,482,11258,22138
"2012","WEST VIRGINIA","KANAWHA",32480,1233,41364,75077
"2012","WEST VIRGINIA","LEWIS",1736,176,4375,6287
"2012","WEST VIRGINIA","LINCOLN",2227,208,4383,6818
"2012","WEST VIRGINIA","LOGAN",3469,255,8222,11946
"2012","WEST VIRGINIA","MARION",8959,529,12054,21542
"2012","WEST VIRGINIA","MARSHALL",4484,297,8135,12916
"2012","WEST VIRGINIA","MASON",3778,270,5741,9789
"2012","WEST VIRGINIA","MCDOWELL",2109,120,3959,6188
"2012","WEST VIRGINIA","MERCER",5432,394,15450,21276
"2012","WEST VIRGINIA","MINERAL",2885,261,7833,10979
"2012","WEST VIRGINIA","MINGO",2428,211,6191,8830
"2012","WEST VIRGINIA","MONONGALIA",13826,818,16831,31475
"2012","WEST VIRGINIA","MONROE",1455,141,3616,5212
"2012","WEST VIRGINIA","MORGAN",2363,168,4513,7044
"2012","WEST VIRGINIA","NICHOLAS",2664,223,5898,8785
"2012","WEST VIRGINIA","OHIO",6786,357,10768,17911
"2012","WEST VIRGINIA","PENDLETON",1074,70,2095,3239
"2012","WEST VIRGINIA","PLEASANTS",955,60,1825,2840
"2012","WEST VIRGINIA","POCAHONTAS",1303,91,2182,3576
"2012","WEST VIRGINIA","PRESTON",2931,335,7889,11155
"2012","WEST VIRGINIA","PUTNAM",7256,385,16032,23673
"2012","WEST VIRGINIA","RALEIGH",7739,476,20614,28829
"2012","WEST VIRGINIA","RANDOLPH",3342,254,6160,9756
"2012","WEST VIRGINIA","RITCHIE",768,99,2921,3788
"2012","WEST VIRGINIA","ROANE",1939,126,2982,5047
"2012","WEST VIRGINIA","SUMMERS",1621,133,2981,4735
"2012","WEST VIRGINIA","TAYLOR",1941,127,3840,5908
"2012","WEST VIRGINIA","TUCKER",880,82,2176,3138
"2012","WEST VIRGINIA","TYLER",890,75,2314,3279
"2012","WEST VIRGINIA","UPSHUR",2158,176,5939,8273
"2012","WEST VIRGINIA","WAYNE",4931,336,8688,13955
"2012","WEST VIRGINIA","WEBSTER",947,98,1710,2755
"2012","WEST VIRGINIA","WETZEL",2217,166,3473,5856
"2012","WEST VIRGINIA","WIRT",676,68,1427,2171
"2012","WEST VIRGINIA","WOOD",11230,564,22183,33977
"2012","WEST VIRGINIA","WYOMING",1583,171,5769,7523
"2012","WISCONSIN","ADAMS",5542,101,4644,10287
"2012","WISCONSIN","ASHLAND",5399,153,2820,8372
"2012","WISCONSIN","BARRON",10890,359,11443,22692
"2012","WISCONSIN","BAYFIELD",6033,152,3603,9788
"2012","WISCONSIN","BROWN",62526,1566,64836,128928
"2012","WISCONSIN","BUFFALO",3570,105,3364,7039
"2012","WISCONSIN","BURNETT",3986,141,4550,8677
"2012","WISCONSIN","CALUMET",11489,392,14539,26420
"2012","WISCONSIN","CHIPPEWA",15237,373,15322,30932
"2012","WISCONSIN","CLARK",6172,217,7412,13801
"2012","WISCONSIN","COLUMBIA",17175,345,13026,30546
"2012","WISCONSIN","CRAWFORD",4629,121,3067,7817
"2012","WISCONSIN","DANE",216071,4466,83644,304181
"2012","WISCONSIN","DODGE",18762,515,25211,44488
"2012","WISCONSIN","DOOR",9357,193,8121,17671
"2012","WISCONSIN","DOUGLAS",14863,326,7705,22894
"2012","WISCONSIN","DUNN",11316,452,10224,21992
"2012","WISCONSIN","EAU CLAIRE",30666,884,23256,54806
"2012","WISCONSIN","FLORENCE",953,27,1645,2625
"2012","WISCONSIN","FOND DU LAC",22379,668,30355,53402
"2012","WISCONSIN","FOREST",2425,51,2172,4648
"2012","WISCONSIN","GRANT",13594,399,10255,24248
"2012","WISCONSIN","GREEN",11206,259,7857,19322
"2012","WISCONSIN","GREEN LAKE",3793,100,5782,9675
"2012","WISCONSIN","IOWA",8105,142,4287,12534
"2012","WISCONSIN","IRON",1784,58,1790,3632
"2012","WISCONSIN","JACKSON",5298,115,3900,9313
"2012","WISCONSIN","JEFFERSON",20158,606,23517,44281
"2012","WISCONSIN","JUNEAU",6242,174,5411,11827
"2012","WISCONSIN","KENOSHA",44867,1053,34977,80897
"2012","WISCONSIN","KEWAUNEE",5153,137,5747,11037
"2012","WISCONSIN","LA CROSSE",36693,1018,25751,63462
"2012","WISCONSIN","LAFAYETTE",4536,102,3314,7952
"2012","WISCONSIN","LANGLADE",4573,130,5816,10519
"2012","WISCONSIN","LINCOLN",7563,198,7455,15216
"2012","WISCONSIN","MANITOWOC",20403,610,21604,42617
"2012","WISCONSIN","MARATHON",32363,882,36617,69862
"2012","WISCONSIN","MARINETTE",9882,276,10619,20777
"2012","WISCONSIN","MARQUETTE",4014,99,3992,8105
"2012","WISCONSIN","MENOMINEE",1191,7,179,1377
"2012","WISCONSIN","MILWAUKEE",332438,5214,154924,492576
"2012","WISCONSIN","MONROE",9515,295,9675,19485
"2012","WISCONSIN","OCONTO",8865,253,10741,19859
"2012","WISCONSIN","ONEIDA",10452,283,10917,21652
"2012","WISCONSIN","OUTAGAMIE",45659,1565,47372,94596
"2012","WISCONSIN","OZAUKEE",19159,581,36077,55817
"2012","WISCONSIN","PEPIN",1876,29,1794,3699
"2012","WISCONSIN","PIERCE",10235,388,10397,21020
"2012","WISCONSIN","POLK",10073,406,12094,22573
"2012","WISCONSIN","PORTAGE",22075,647,16615,39337
"2012","WISCONSIN","PRICE",3887,130,3884,7901
"2012","WISCONSIN","RACINE",53008,1009,49347,103364
"2012","WISCONSIN","RICHLAND",4969,113,3573,8655
"2012","WISCONSIN","ROCK",49219,954,30517,80690
"2012","WISCONSIN","RUSK",3397,118,3676,7191
"2012","WISCONSIN","SAUK",18736,353,12838,31927
"2012","WISCONSIN","SAWYER",4486,97,4442,9025
"2012","WISCONSIN","SHAWANO",9000,257,11022,20279
"2012","WISCONSIN","SHEBOYGAN",27918,661,34072,62651
"2012","WISCONSIN","ST. CROIX",19910,812,25503,46225
"2012","WISCONSIN","TAYLOR",3763,148,5601,9512
"2012","WISCONSIN","TREMPEALEAU",7605,169,5707,13481
"2012","WISCONSIN","VERNON",8044,283,5942,14269
"2012","WISCONSIN","VILAS",5951,142,7749,13842
"2012","WISCONSIN","WALWORTH",22552,745,29006,52303
"2012","WISCONSIN","WASHBURN",4447,141,4699,9287
"2012","WISCONSIN","WASHINGTON",23166,811,54765,78742
"2012","WISCONSIN","WAUKESHA",78779,2279,162798,243856
"2012","WISCONSIN","WAUPACA",11578,260,17002,28840
"2012","WISCONSIN","WAUSHARA",5335,151,6562,12048
"2012","WISCONSIN","WINNEBAGO",45449,1602,42122,89173
"2012","WISCONSIN","WOOD",18581,615,19704,38900
"2012","WYOMING","ALBANY",7458,976,7866,16300
"2012","WYOMING","BIG HORN",868,171,4285,5324
"2012","WYOMING","CAMPBELL",2163,455,14953,17571
"2012","WYOMING","CARBON",2110,251,4148,6509
"2012","WYOMING","CONVERSE",1089,211,5043,6343
"2012","WYOMING","CROOK",426,150,3109,3685
"2012","WYOMING","FREMONT",5333,531,11075,16939
"2012","WYOMING","GOSHEN",1458,170,4178,5806
"2012","WYOMING","HOT SPRINGS",523,97,1895,2515
"2012","WYOMING","JOHNSON",749,147,3363,4259
"2012","WYOMING","LARAMIE",14295,1306,23904,39505
"2012","WYOMING","LINCOLN",1287,187,7144,8618
"2012","WYOMING","NATRONA",8961,1280,22132,32373
"2012","WYOMING","NIOBRARA",200,54,1022,1276
"2012","WYOMING","PARK",2927,447,11234,14608
"2012","WYOMING","PLATTE",1223,172,3136,4531
"2012","WYOMING","SHERIDAN",3618,437,10267,14322
"2012","WYOMING","SUBLETTE",767,137,3472,4376
"2012","WYOMING","SWEETWATER",4774,693,11428,16895
"2012","WYOMING","TETON",6213,393,4858,11464
"2012","WYOMING","UINTA",1628,296,6615,8539
"2012","WYOMING","WASHAKIE",794,136,3014,3944
"2012","WYOMING","WESTON",422,116,2821,3359
"2016","ALABAMA","AUTAUGA",5936,865,18172,24973
"2016","ALABAMA","BALDWIN",18458,3874,72883,95215
"2016","ALABAMA","BARBOUR",4871,144,5454,10469
"2016","ALABAMA","BIBB",1874,207,6738,8819
"2016","ALABAMA","BLOUNT",2156,573,22859,25588
"2016","ALABAMA","BULLOCK",3530,40,1140,4710
"2016","ALABAMA","BUTLER",3726,105,4901,8732
"2016","ALABAMA","CALHOUN",13242,1757,32865,47864
"2016","ALABAMA","CHAMBERS",5784,273,7843,13900
"2016","ALABAMA","CHEROKEE",1547,233,8953,10733
"2016","ALABAMA","CHILTON",2911,377,15081,18369
"2016","ALABAMA","CHOCTAW",3109,77,4106,7292
"2016","ALABAMA","CLARKE",5749,142,7140,13031
"2016","ALABAMA","CLAY",1237,142,5245,6624
"2016","ALABAMA","CLEBURNE",684,145,5764,6593
"2016","ALABAMA","COFFEE",4221,671,15875,20767
"2016","ALABAMA","COLBERT",7312,857,16746,24915
"2016","ALABAMA","CONECUH",3080,85,3420,6585
"2016","ALABAMA","COOSA",1782,89,3381,5252
"2016","ALABAMA","COVINGTON",2387,286,13267,15940
"2016","ALABAMA","CRENSHAW",1664,90,4513,6267
"2016","ALABAMA","CULLMAN",3798,1086,32989,37873
"2016","ALABAMA","DALE",4413,528,13808,18749
"2016","ALABAMA","DALLAS",12836,167,5789,18792
"2016","ALABAMA","DEKALB",3622,799,21405,25826
"2016","ALABAMA","ELMORE",8443,1183,27634,37260
"2016","ALABAMA","ESCAMBIA",4605,305,9935,14845
"2016","ALABAMA","ETOWAH",10442,1369,32353,44164
"2016","ALABAMA","FAYETTE",1362,175,6712,8249
"2016","ALABAMA","FRANKLIN",2197,377,9466,12040
"2016","ALABAMA","GENEVA",1525,239,9994,11758
"2016","ALABAMA","GREENE",4013,29,838,4880
"2016","ALABAMA","HALE",4775,92,3173,8040
"2016","ALABAMA","HENRY",2292,148,5632,8072
"2016","ALABAMA","HOUSTON",10664,1247,30728,42639
"2016","ALABAMA","JACKSON",3673,639,16672,20984
"2016","ALABAMA","JEFFERSON",156873,12550,134768,304191
"2016","ALABAMA","LAMAR",1036,107,5823,6966
"2016","ALABAMA","LAUDERDALE",9952,1674,27899,39525
"2016","ALABAMA","LAWRENCE",3627,369,10833,14829
"2016","ALABAMA","LEE",21230,3344,34617,59191
"2016","ALABAMA","LIMESTONE",9468,1759,29067,40294
"2016","ALABAMA","LOWNDES",4883,50,1751,6684
"2016","ALABAMA","MACON",7566,143,1431,9140
"2016","ALABAMA","MADISON",62822,11047,89520,163389
"2016","ALABAMA","MARENGO",5615,146,5233,10994
"2016","ALABAMA","MARION",1432,278,11274,12984
"2016","ALABAMA","MARSHALL",4917,1166,29233,35316
"2016","ALABAMA","MOBILE",72186,5435,95116,172737
"2016","ALABAMA","MONROE",4332,144,5795,10271
"2016","ALABAMA","MONTGOMERY",58916,2959,34003,95878
"2016","ALABAMA","MORGAN",11254,1904,37486,50644
"2016","ALABAMA","PERRY",3824,47,1407,5278
"2016","ALABAMA","PICKENS",3972,114,5456,9542
"2016","ALABAMA","PIKE",5056,419,7693,13168
"2016","ALABAMA","RANDOLPH",2291,191,7705,10187
"2016","ALABAMA","RUSSELL",9579,467,9210,19256
"2016","ALABAMA","SHELBY",22977,5257,73020,101254
"2016","ALABAMA","ST. CLAIR",5589,1160,31651,38400
"2016","ALABAMA","SUMTER",4746,84,1581,6411
"2016","ALABAMA","TALLADEGA",12121,672,20614,33407
"2016","ALABAMA","TALLAPOOSA",5519,373,13594,19486
"2016","ALABAMA","TUSCALOOSA",31762,3215,47723,82700
"2016","ALABAMA","WALKER",4497,709,24266,29472
"2016","ALABAMA","WASHINGTON",2374,117,6042,8533
"2016","ALABAMA","WILCOX",4339,42,1737,6118
"2016","ALABAMA","WINSTON",872,213,9228,10313
"2016","ALASKA","DISTRICT 1",2573,885,3180,6638
"2016","ALASKA","DISTRICT 10",1808,977,6255,9040
"2016","ALASKA","DISTRICT 11",2142,1103,6444,9689
"2016","ALASKA","DISTRICT 12",1928,986,6629,9543
"2016","ALASKA","DISTRICT 13",1684,821,4028,6533
"2016","ALASKA","DISTRICT 14",3043,1399,5978,10420
"2016","ALASKA","DISTRICT 15",1828,629,2525,4982
"2016","ALASKA","DISTRICT 16",3294,939,3203,7436
"2016","ALASKA","DISTRICT 17",3290,880,2618,6788
"2016","ALASKA","DISTRICT 18",3909,809,2684,7402
"2016","ALASKA","DISTRICT 19",2669,487,1636,4792
"2016","ALASKA","DISTRICT 2",1585,719,3188,5492
"2016","ALASKA","DISTRICT 20",4151,802,2187,7140
"2016","ALASKA","DISTRICT 21",4224,944,3479,8647
"2016","ALASKA","DISTRICT 22",3270,899,4203,8372
"2016","ALASKA","DISTRICT 23",2894,784,3246,6924
"2016","ALASKA","DISTRICT 24",3578,793,4709,9080
"2016","ALASKA","DISTRICT 25",3378,933,3816,8127
"2016","ALASKA","DISTRICT 26",3374,983,4548,8905
"2016","ALASKA","DISTRICT 27",3729,969,4085,8783
"2016","ALASKA","DISTRICT 28",4749,1255,5423,11427
"2016","ALASKA","DISTRICT 29",2101,946,6347,9394
"2016","ALASKA","DISTRICT 3",1241,969,5403,7613
"2016","ALASKA","DISTRICT 30",1816,940,6194,8950
"2016","ALASKA","DISTRICT 31",3466,1099,5617,10182
"2016","ALASKA","DISTRICT 32",2701,1007,3764,7472
"2016","ALASKA","DISTRICT 33",5978,1224,2732,9934
"2016","ALASKA","DISTRICT 34",4220,1256,3955,9431
"2016","ALASKA","DISTRICT 35",3749,1188,4105,9042
"2016","ALASKA","DISTRICT 36",2693,1111,4460,8264
"2016","ALASKA","DISTRICT 37",2421,703,1938,5062
"2016","ALASKA","DISTRICT 38",2758,1194,1143,5095
"2016","ALASKA","DISTRICT 39",3142,1092,1405,5639
"2016","ALASKA","DISTRICT 4",4162,1289,4070,9521
"2016","ALASKA","DISTRICT 40",2338,895,1377,4610
"2016","ALASKA","DISTRICT 5",3187,1036,3683,7906
"2016","ALASKA","DISTRICT 6",2536,995,4929,8460
"2016","ALASKA","DISTRICT 7",1510,849,5935,8294
"2016","ALASKA","DISTRICT 8",1218,729,6126,8073
"2016","ALASKA","DISTRICT 9",1843,1011,6100,8954
"2016","ALASKA","DISTRICT 99",274,28,40,342
"2016","ARIZONA","APACHE",17083,2338,8240,27661
"2016","ARIZONA","COCHISE",17450,4473,28092,50015
"2016","ARIZONA","COCONINO",32404,6272,21108,59784
"2016","ARIZONA","GILA",7003,1127,14182,22312
"2016","ARIZONA","GRAHAM",3301,808,8025,12134
"2016","ARIZONA","GREENLEE",1092,286,1892,3270
"2016","ARIZONA","LA PAZ",1575,373,4003,5951
"2016","ARIZONA","MARICOPA",702907,117566,747361,1567834
"2016","ARIZONA","MOHAVE",17455,4206,58282,79943
"2016","ARIZONA","NAVAJO",16459,3258,20577,40294
"2016","ARIZONA","PIMA",224661,29551,167428,421640
"2016","ARIZONA","PINAL",47892,8835,72819,129546
"2016","ARIZONA","SANTA CRUZ",11690,846,3897,16433
"2016","ARIZONA","YAVAPAI",35590,7530,71330,114450
"2016","ARIZONA","YUMA",24605,3240,25165,53010
"2016","ARKANSAS","ARKANSAS",1939,447,3826,6212
"2016","ARKANSAS","ASHLEY",2408,337,5338,8083
"2016","ARKANSAS","BAXTER",4169,915,14682,19766
"2016","ARKANSAS","BENTON",28005,7948,60871,96824
"2016","ARKANSAS","BOONE",2926,950,12235,16111
"2016","ARKANSAS","BRADLEY",1317,172,2164,3653
"2016","ARKANSAS","CALHOUN",639,74,1556,2269
"2016","ARKANSAS","CARROLL",3342,630,6786,10758
"2016","ARKANSAS","CHICOT",2350,110,1716,4176
"2016","ARKANSAS","CLARK",3620,502,4404,8526
"2016","ARKANSAS","CLAY",1199,220,3781,5200
"2016","ARKANSAS","CLEBURNE",2101,526,9458,12085
"2016","ARKANSAS","CLEVELAND",723,169,2462,3354
"2016","ARKANSAS","COLUMBIA",3140,291,5456,8887
"2016","ARKANSAS","CONWAY",2656,422,4849,7927
"2016","ARKANSAS","CRAIGHEAD",10538,2143,22892,35573
"2016","ARKANSAS","CRAWFORD",4488,1276,16686,22450
"2016","ARKANSAS","CRITTENDEN",8410,578,6964,15952
"2016","ARKANSAS","CROSS",1999,291,4584,6874
"2016","ARKANSAS","DALLAS",1165,97,1509,2771
"2016","ARKANSAS","DESHA",2228,110,1919,4257
"2016","ARKANSAS","DREW",2365,262,3968,6595
"2016","ARKANSAS","FAULKNER",14629,3552,29346,47527
"2016","ARKANSAS","FRANKLIN",1376,355,5039,6770
"2016","ARKANSAS","FULTON",1067,234,3471,4772
"2016","ARKANSAS","GARLAND",12311,2407,26087,40805
"2016","ARKANSAS","GRANT",1373,347,5725,7445
"2016","ARKANSAS","GREENE",3071,809,10720,14600
"2016","ARKANSAS","HEMPSTEAD",2377,271,4401,7049
"2016","ARKANSAS","HOT SPRING",3149,623,8172,11944
"2016","ARKANSAS","HOWARD",1351,166,3157,4674
"2016","ARKANSAS","INDEPENDENCE",2881,797,9936,13614
"2016","ARKANSAS","IZARD",1113,293,4042,5448
"2016","ARKANSAS","JACKSON",1583,306,3267,5156
"2016","ARKANSAS","JEFFERSON",15772,872,9250,25894
"2016","ARKANSAS","JOHNSON",2427,594,6091,9112
"2016","ARKANSAS","LAFAYETTE",1032,70,1758,2860
"2016","ARKANSAS","LAWRENCE",1263,358,4064,5685
"2016","ARKANSAS","LEE",1735,62,1229,3026
"2016","ARKANSAS","LINCOLN",1252,119,2455,3826
"2016","ARKANSAS","LITTLE RIVER",1397,225,3605,5227
"2016","ARKANSAS","LOGAN",1715,460,5746,7921
"2016","ARKANSAS","LONOKE",5664,1478,19958,27100
"2016","ARKANSAS","MADISON",1588,325,4928,6841
"2016","ARKANSAS","MARION",1434,337,5336,7107
"2016","ARKANSAS","MILLER",4273,524,11294,16091
"2016","ARKANSAS","MISSISSIPPI",5670,473,7061,13204
"2016","ARKANSAS","MONROE",1312,83,1489,2884
"2016","ARKANSAS","MONTGOMERY",748,168,2643,3559
"2016","ARKANSAS","NEVADA",1157,89,2000,3246
"2016","ARKANSAS","NEWTON",699,179,2875,3753
"2016","ARKANSAS","OUACHITA",4321,263,5351,9935
"2016","ARKANSAS","PERRY",1049,249,3008,4306
"2016","ARKANSAS","PHILLIPS",4310,197,2446,6953
"2016","ARKANSAS","PIKE",685,146,3150,3981
"2016","ARKANSAS","POINSETT",1880,340,5502,7722
"2016","ARKANSAS","POLK",1212,401,6618,8231
"2016","ARKANSAS","POPE",5000,1313,16256,22569
"2016","ARKANSAS","PRAIRIE",814,125,2505,3444
"2016","ARKANSAS","PULASKI",89574,8945,61257,159776
"2016","ARKANSAS","RANDOLPH",1425,445,4509,6379
"2016","ARKANSAS","SALINE",13256,2981,35863,52100
"2016","ARKANSAS","SCOTT",602,177,2731,3510
"2016","ARKANSAS","SEARCY",601,172,2955,3728
"2016","ARKANSAS","SEBASTIAN",12300,3210,29127,44637
"2016","ARKANSAS","SEVIER",1075,205,3282,4562
"2016","ARKANSAS","SHARP",1472,370,5407,7249
"2016","ARKANSAS","ST. FRANCIS",4031,204,3195,7430
"2016","ARKANSAS","STONE",1203,302,4113,5618
"2016","ARKANSAS","UNION",5855,583,10456,16894
"2016","ARKANSAS","VAN BUREN",1549,408,5382,7339
"2016","ARKANSAS","WASHINGTON",33366,7019,41476,81861
"2016","ARKANSAS","WHITE",5170,972,21077,27219
"2016","ARKANSAS","WOODRUFF",1118,106,1347,2571
"2016","ARKANSAS","YELL",1480,351,4608,6439
"2016","CALIFORNIA","ALAMEDA",514842,43502,95922,654266
"2016","CALIFORNIA","ALPINE",334,51,217,602
"2016","CALIFORNIA","AMADOR",6004,1245,10485,17734
"2016","CALIFORNIA","BUTTE",41567,8853,45144,95564
"2016","CALIFORNIA","CALAVERAS",7944,1681,13511,23136
"2016","CALIFORNIA","COLUSA",2661,420,3551,6632
"2016","CALIFORNIA","CONTRA COSTA",319287,30932,115956,466175
"2016","CALIFORNIA","DEL NORTE",3485,939,5134,9558
"2016","CALIFORNIA","EL DORADO",36404,7940,49247,93591
"2016","CALIFORNIA","FRESNO",141341,16929,124049,282319
"2016","CALIFORNIA","GLENN",3065,617,5788,9470
"2016","CALIFORNIA","HUMBOLDT",33200,7673,18373,59246
"2016","CALIFORNIA","IMPERIAL",32667,2720,12704,48091
"2016","CALIFORNIA","INYO",3155,683,4248,8086
"2016","CALIFORNIA","KERN",98689,15890,129584,244163
"2016","CALIFORNIA","KINGS",13617,2205,18093,33915
"2016","CALIFORNIA","LAKE",11496,2401,10599,24496
"2016","CALIFORNIA","LASSEN",2224,726,7574,10524
"2016","CALIFORNIA","LOS ANGELES",2464364,200201,769743,3434308
"2016","CALIFORNIA","MADERA",17029,2726,23357,43112
"2016","CALIFORNIA","MARIN",108707,8795,21771,139273
"2016","CALIFORNIA","MARIPOSA",3122,570,5185,8877
"2016","CALIFORNIA","MENDOCINO",22079,4510,10888,37477
"2016","CALIFORNIA","MERCED",37317,4747,28725,70789
"2016","CALIFORNIA","MODOC",877,215,2696,3788
"2016","CALIFORNIA","MONO",2773,392,2111,5276
"2016","CALIFORNIA","MONTEREY",89088,9425,34895,133408
"2016","CALIFORNIA","NAPA",39199,4762,17411,61372
"2016","CALIFORNIA","NEVADA",26053,5517,23365,54935
"2016","CALIFORNIA","ORANGE",609961,80412,507148,1197521
"2016","CALIFORNIA","PLACER",73509,14192,95138,182839
"2016","CALIFORNIA","PLUMAS",3459,797,5420,9676
"2016","CALIFORNIA","RIVERSIDE",373695,44453,333243,751391
"2016","CALIFORNIA","SACRAMENTO",326023,43518,189789,559330
"2016","CALIFORNIA","SAN BENITO",12521,1562,7841,21924
"2016","CALIFORNIA","SAN BERNARDINO",340833,41910,271240,653983
"2016","CALIFORNIA","SAN DIEGO",735476,93158,477766,1306400
"2016","CALIFORNIA","SAN FRANCISCO",345084,23020,37688,405792
"2016","CALIFORNIA","SAN JOAQUIN",121124,14106,88936,224166
"2016","CALIFORNIA","SAN LUIS OBISPO",67107,11738,56164,135009
"2016","CALIFORNIA","SAN MATEO",237882,18573,57929,314384
"2016","CALIFORNIA","SANTA BARBARA",107142,13279,56365,176786
"2016","CALIFORNIA","SANTA CLARA",511684,47199,144826,703709
"2016","CALIFORNIA","SANTA CRUZ",95249,11134,22438,128821
"2016","CALIFORNIA","SHASTA",22301,5974,51778,80053
"2016","CALIFORNIA","SIERRA",601,181,1048,1830
"2016","CALIFORNIA","SISKIYOU",7234,1917,11341,20492
"2016","CALIFORNIA","SOLANO",102360,11833,51920,166113
"2016","CALIFORNIA","SONOMA",160435,19410,51408,231253
"2016","CALIFORNIA","STANISLAUS",81647,12005,78494,172146
"2016","CALIFORNIA","SUTTER",13076,2271,18176,33523
"2016","CALIFORNIA","TEHAMA",6809,1605,15494,23908
"2016","CALIFORNIA","TRINITY",2214,660,2812,5686
"2016","CALIFORNIA","TULARE",47585,6450,58299,112334
"2016","CALIFORNIA","TUOLUMNE",9123,1855,14551,25529
"2016","CALIFORNIA","VENTURA",194402,25001,132323,351726
"2016","CALIFORNIA","YOLO",54752,6599,20739,82090
"2016","CALIFORNIA","YUBA",7910,1918,13170,22998
"2016","COLORADO","ADAMS",96558,17025,80082,193665
"2016","COLORADO","ALAMOSA",3189,704,3046,6939
"2016","COLORADO","ARAPAHOE",159885,26108,117053,303046
"2016","COLORADO","ARCHULETA",2500,575,4264,7339
"2016","COLORADO","BACA",283,117,1753,2153
"2016","COLORADO","BENT",590,149,1188,1927
"2016","COLORADO","BOULDER",132334,14412,41396,188142
"2016","COLORADO","BROOMFIELD",19731,3591,14367,37689
"2016","COLORADO","CHAFFEE",4888,971,5391,11250
"2016","COLORADO","CHEYENNE",132,45,925,1102
"2016","COLORADO","CLEAR CREEK",2729,562,2575,5866
"2016","COLORADO","CONEJOS",1771,337,1914,4022
"2016","COLORADO","COSTILLA",1125,135,588,1848
"2016","COLORADO","CROWLEY",339,109,1079,1527
"2016","COLORADO","CUSTER",797,208,2061,3066
"2016","COLORADO","DELTA",4087,1048,11655,16790
"2016","COLORADO","DENVER",244551,24611,62690,331852
"2016","COLORADO","DOLORES",242,69,944,1255
"2016","COLORADO","DOUGLAS",68657,16269,102573,187499
"2016","COLORADO","EAGLE",14099,2134,8990,25223
"2016","COLORADO","EL PASO",108010,31729,179228,318967
"2016","COLORADO","ELBERT",3134,1139,11705,15978
"2016","COLORADO","FREMONT",5297,1554,15122,21973
"2016","COLORADO","GARFIELD",11271,2067,13132,26470
"2016","COLORADO","GILPIN",1634,376,1566,3576
"2016","COLORADO","GRAND",3358,736,4494,8588
"2016","COLORADO","GUNNISON",5128,995,3289,9412
"2016","COLORADO","HINSDALE",197,53,339,589
"2016","COLORADO","HUERFANO",1633,267,1883,3783
"2016","COLORADO","JACKSON",171,61,629,861
"2016","COLORADO","JEFFERSON",160776,29929,138177,328882
"2016","COLORADO","KIOWA",91,36,728,855
"2016","COLORADO","KIT CARSON",536,199,2967,3702
"2016","COLORADO","LA PLATA",15525,3038,12587,31150
"2016","COLORADO","LAKE",1616,313,1270,3199
"2016","COLORADO","LARIMER",93113,19437,83430,195980
"2016","COLORADO","LAS ANIMAS",2650,433,3710,6793
"2016","COLORADO","LINCOLN",409,135,1892,2436
"2016","COLORADO","LOGAN",1851,589,7282,9722
"2016","COLORADO","MESA",21729,6145,49779,77653
"2016","COLORADO","MINERAL",237,71,344,652
"2016","COLORADO","MOFFAT",874,346,5305,6525
"2016","COLORADO","MONTEZUMA",3973,1032,7853,12858
"2016","COLORADO","MONTROSE",5466,1338,14382,21186
"2016","COLORADO","MORGAN",3151,664,8145,11960
"2016","COLORADO","OTERO",2943,581,4928,8452
"2016","COLORADO","OURAY",1697,262,1351,3310
"2016","COLORADO","PARK",3421,861,6135,10417
"2016","COLORADO","PHILLIPS",436,105,1791,2332
"2016","COLORADO","PITKIN",7333,640,2550,10523
"2016","COLORADO","PROWERS",1186,299,3531,5016
"2016","COLORADO","PUEBLO",35875,6506,36265,78646
"2016","COLORADO","RIO BLANCO",436,223,2791,3450
"2016","COLORADO","RIO GRANDE",2001,448,3085,5534
"2016","COLORADO","ROUTT",7600,1156,5230,13986
"2016","COLORADO","SAGUACHE",1417,271,1147,2835
"2016","COLORADO","SAN JUAN",265,26,215,506
"2016","COLORADO","SAN MIGUEL",2975,321,1033,4329
"2016","COLORADO","SEDGWICK",267,82,1015,1364
"2016","COLORADO","SUMMIT",9557,1517,5100,16174
"2016","COLORADO","TELLER",3603,1096,9745,14444
"2016","COLORADO","WASHINGTON",296,138,2299,2733
"2016","COLORADO","WELD",46519,12258,76651,135428
"2016","COLORADO","YUMA",726,215,3850,4791
"2016","CONNECTICUT","FAIRFIELD",243852,17280,160077,421209
"2016","CONNECTICUT","HARTFORD",240403,18288,148173,406864
"2016","CONNECTICUT","LITCHFIELD",39775,4616,53051,97442
"2016","CONNECTICUT","MIDDLESEX",45357,4400,38867,88624
"2016","CONNECTICUT","NEW HAVEN",205609,14349,159048,379006
"2016","CONNECTICUT","NEW LONDON",62278,7192,54058,123528
"2016","CONNECTICUT","STATEWIDE WRITEIN",0,2616,0,2616
"2016","CONNECTICUT","TOLLAND",38506,4724,34194,77424
"2016","CONNECTICUT","WINDHAM",21792,3284,25747,50823
"2016","DELAWARE","KENT",33351,4256,36991,74598
"2016","DELAWARE","NEW CASTLE",162919,13947,85525,262391
"2016","DELAWARE","SUSSEX",39333,4064,62611,106008
"2016","DISTRICT OF COLUMBIA","DISTRICT OF COLUMBIA",282830,15715,12723,311268
"2016","FLORIDA","ALACHUA",75820,5917,46834,128571
"2016","FLORIDA","BAKER",2112,228,10294,12634
"2016","FLORIDA","BAY",21797,3462,62194,87453
"2016","FLORIDA","BRADFORD",2924,261,8913,12098
"2016","FLORIDA","BREVARD",119679,13225,181848,314752
"2016","FLORIDA","BROWARD",553320,17680,260951,831951
"2016","FLORIDA","CALHOUN",1241,185,4655,6081
"2016","FLORIDA","CHARLOTTE",33445,2711,60218,96374
"2016","FLORIDA","CITRUS",22789,2455,54456,79700
"2016","FLORIDA","CLAY",27822,3698,74963,106483
"2016","FLORIDA","COLLIER",61085,4281,105423,170789
"2016","FLORIDA","COLUMBIA",7601,738,20368,28707
"2016","FLORIDA","DESOTO",3781,259,6778,10818
"2016","FLORIDA","DIXIE",1270,110,5822,7202
"2016","FLORIDA","DUVAL",205704,15319,211672,432695
"2016","FLORIDA","ESCAMBIA",57461,6200,88808,152469
"2016","FLORIDA","FLAGLER",22026,1627,33850,57503
"2016","FLORIDA","FRANKLIN",1744,146,4125,6015
"2016","FLORIDA","GADSDEN",15020,365,6728,22113
"2016","FLORIDA","GILCHRIST",1458,222,6740,8420
"2016","FLORIDA","GLADES",1271,86,2996,4353
"2016","FLORIDA","GULF",1720,244,5329,7293
"2016","FLORIDA","HAMILTON",1904,113,3443,5460
"2016","FLORIDA","HARDEE",2149,192,5242,7583
"2016","FLORIDA","HENDRY",4615,305,6195,11115
"2016","FLORIDA","HERNANDO",31795,3031,58970,93796
"2016","FLORIDA","HIGHLANDS",14937,1184,29565,45686
"2016","FLORIDA","HILLSBOROUGH",307896,22894,266870,597660
"2016","FLORIDA","HOLMES",853,178,7483,8514
"2016","FLORIDA","INDIAN RIVER",29043,2346,48620,80009
"2016","FLORIDA","JACKSON",6397,387,14257,21041
"2016","FLORIDA","JEFFERSON",3541,174,3930,7645
"2016","FLORIDA","LAFAYETTE",518,65,2809,3392
"2016","FLORIDA","LAKE",62838,5436,102188,170462
"2016","FLORIDA","LEE",124908,9961,191551,326420
"2016","FLORIDA","LEON",92068,6243,53821,152132
"2016","FLORIDA","LEVY",5101,519,13775,19395
"2016","FLORIDA","LIBERTY",651,102,2543,3296
"2016","FLORIDA","MADISON",3526,128,4851,8505
"2016","FLORIDA","MANATEE",71224,5790,101944,178958
"2016","FLORIDA","MARION",62041,4826,107833,174700
"2016","FLORIDA","MARTIN",30185,2403,53204,85792
"2016","FLORIDA","MIAMI-DADE",624146,22059,333999,980204
"2016","FLORIDA","MONROE",18971,1603,21904,42478
"2016","FLORIDA","NASSAU",10869,1472,34266,46607
"2016","FLORIDA","OKALOOSA",23780,5182,71893,100855
"2016","FLORIDA","OKEECHOBEE",3959,338,9356,13653
"2016","FLORIDA","ORANGE",329894,21165,195216,546275
"2016","FLORIDA","OSCEOLA",85458,4447,50301,140206
"2016","FLORIDA","PALM BEACH",374673,15257,272402,662332
"2016","FLORIDA","PASCO",90142,8896,142101,241139
"2016","FLORIDA","PINELLAS",233701,19501,239201,492403
"2016","FLORIDA","POLK",117433,9451,157430,284314
"2016","FLORIDA","PUTNAM",10094,885,22138,33117
"2016","FLORIDA","SANTA ROSA",18464,3942,65339,87745
"2016","FLORIDA","SARASOTA",97870,6755,124438,229063
"2016","FLORIDA","SEMINOLE",105914,9539,109443,224896
"2016","FLORIDA","ST. JOHNS",43099,4731,88684,136514
"2016","FLORIDA","ST. LUCIE",66881,3677,70289,140847
"2016","FLORIDA","SUMTER",22638,1297,52730,76665
"2016","FLORIDA","SUWANNEE",3964,443,14287,18694
"2016","FLORIDA","TAYLOR",2152,208,6930,9290
"2016","FLORIDA","UNION",1014,112,4568,5694
"2016","FLORIDA","VOLUSIA",109091,8771,143007,260869
"2016","FLORIDA","WAKULLA",4348,491,10512,15351
"2016","FLORIDA","WALTON",6876,1005,25756,33637
"2016","FLORIDA","WASHINGTON",2264,255,8637,11156
"2016","GEORGIA","APPLING",1434,84,5494,7012
"2016","GEORGIA","ATKINSON",697,35,1878,2610
"2016","GEORGIA","BACON",608,48,3364,4020
"2016","GEORGIA","BAKER",650,15,775,1440
"2016","GEORGIA","BALDWIN",7970,449,7697,16116
"2016","GEORGIA","BANKS",684,157,6134,6975
"2016","GEORGIA","BARROW",6580,1372,21108,29060
"2016","GEORGIA","BARTOW",8212,1427,29911,39550
"2016","GEORGIA","BEN HILL",2101,96,3739,5936
"2016","GEORGIA","BERRIEN",1047,121,5422,6590
"2016","GEORGIA","BIBB",36787,1766,24043,62596
"2016","GEORGIA","BLECKLEY",1101,154,3719,4974
"2016","GEORGIA","BRANTLEY",619,115,5567,6301
"2016","GEORGIA","BROOKS",2528,107,3701,6336
"2016","GEORGIA","BRYAN",4014,630,10529,15173
"2016","GEORGIA","BULLOCH",9261,958,15097,25316
"2016","GEORGIA","BURKE",4731,129,4491,9351
"2016","GEORGIA","BUTTS",2566,231,6717,9514
"2016","GEORGIA","CALHOUN",1179,16,830,2025
"2016","GEORGIA","CAMDEN",5930,661,12310,18901
"2016","GEORGIA","CANDLER",1026,73,2664,3763
"2016","GEORGIA","CARROLL",12464,1628,30029,44121
"2016","GEORGIA","CATOOSA",4771,1110,20876,26757
"2016","GEORGIA","CHARLTON",1004,61,2951,4016
"2016","GEORGIA","CHATHAM",62290,4164,45688,112142
"2016","GEORGIA","CHATTAHOOCHEE",594,45,751,1390
"2016","GEORGIA","CHATTOOGA",1613,177,6462,8252
"2016","GEORGIA","CHEROKEE",25231,6163,80649,112043
"2016","GEORGIA","CLARKE",29603,2656,12717,44976
"2016","GEORGIA","CLAY",697,10,566,1273
"2016","GEORGIA","CLAYTON",78220,1994,12645,92859
"2016","GEORGIA","CLINCH",686,42,1727,2455
"2016","GEORGIA","COBB",160121,17786,152912,330819
"2016","GEORGIA","COFFEE",4094,233,9588,13915
"2016","GEORGIA","COLQUITT",3463,263,9898,13624
"2016","GEORGIA","COLUMBIA",18887,2771,43085,64743
"2016","GEORGIA","COOK",1753,128,4176,6057
"2016","GEORGIA","COWETA",16583,2629,42533,61745
"2016","GEORGIA","CRAWFORD",1421,120,3635,5176
"2016","GEORGIA","CRISP",2837,126,4549,7512
"2016","GEORGIA","DADE",965,226,5051,6242
"2016","GEORGIA","DAWSON",1448,417,9900,11765
"2016","GEORGIA","DECATUR",4124,142,6020,10286
"2016","GEORGIA","DEKALB",251370,11919,51468,314757
"2016","GEORGIA","DODGE",1839,149,5021,7009
"2016","GEORGIA","DOOLY",1872,36,1951,3859
"2016","GEORGIA","DOUGHERTY",23311,544,10232,34087
"2016","GEORGIA","DOUGLAS",31005,1916,24817,57738
"2016","GEORGIA","EARLY",2168,65,2552,4785
"2016","GEORGIA","ECHOLS",156,19,1007,1182
"2016","GEORGIA","EFFINGHAM",4853,731,17874,23458
"2016","GEORGIA","ELBERT",2539,156,5292,7987
"2016","GEORGIA","EMANUEL",2435,90,5335,7860
"2016","GEORGIA","EVANS",1130,79,2404,3613
"2016","GEORGIA","FANNIN",1923,257,9632,11812
"2016","GEORGIA","FAYETTE",23284,2581,35048,60913
"2016","GEORGIA","FLOYD",9159,1335,24114,34608
"2016","GEORGIA","FORSYTH",23462,4908,69851,98221
"2016","GEORGIA","FRANKLIN",1243,205,7054,8502
"2016","GEORGIA","FULTON",297051,16557,117783,431391
"2016","GEORGIA","GILMER",1965,331,10477,12773
"2016","GEORGIA","GLASCOCK",138,17,1235,1390
"2016","GEORGIA","GLYNN",11775,976,21512,34263
"2016","GEORGIA","GORDON",3181,587,15191,18959
"2016","GEORGIA","GRADY",3013,147,6053,9213
"2016","GEORGIA","GREENE",3199,163,5490,8852
"2016","GEORGIA","GWINNETT",166153,15189,146989,328331
"2016","GEORGIA","HABERSHAM",2483,570,13190,16243
"2016","GEORGIA","HALL",16180,2781,51733,70694
"2016","GEORGIA","HANCOCK",2701,36,843,3580
"2016","GEORGIA","HARALSON",1475,297,9585,11357
"2016","GEORGIA","HARRIS",4086,480,11936,16502
"2016","GEORGIA","HART",2585,246,7286,10117
"2016","GEORGIA","HEARD",743,110,3370,4223
"2016","GEORGIA","HENRY",50057,2985,45724,98766
"2016","GEORGIA","HOUSTON",22553,2096,35430,60079
"2016","GEORGIA","IRWIN",891,63,2716,3670
"2016","GEORGIA","JACKSON",4491,915,21784,27190
"2016","GEORGIA","JASPER",1544,141,4360,6045
"2016","GEORGIA","JEFF DAVIS",901,91,4104,5096
"2016","GEORGIA","JEFFERSON",3821,84,3063,6968
"2016","GEORGIA","JENKINS",1123,38,1895,3056
"2016","GEORGIA","JOHNSON",1136,31,2519,3686
"2016","GEORGIA","JONES",3961,285,8305,12551
"2016","GEORGIA","LAMAR",2270,152,5190,7612
"2016","GEORGIA","LANIER",806,81,1984,2871
"2016","GEORGIA","LAURENS",6752,367,12411,19530
"2016","GEORGIA","LEE",3170,327,10646,14143
"2016","GEORGIA","LIBERTY",9556,453,6134,16143
"2016","GEORGIA","LINCOLN",1273,70,2759,4102
"2016","GEORGIA","LONG",1360,131,2626,4117
"2016","GEORGIA","LOWNDES",15064,1106,21635,37805
"2016","GEORGIA","LUMPKIN",2220,586,9619,12425
"2016","GEORGIA","MACON",2705,42,1540,4287
"2016","GEORGIA","MADISON",2425,372,9201,11998
"2016","GEORGIA","MARION",1213,56,1921,3190
"2016","GEORGIA","MCDUFFIE",3699,137,5432,9268
"2016","GEORGIA","MCINTOSH",2303,113,3487,5903
"2016","GEORGIA","MERIWETHER",3804,191,5222,9217
"2016","GEORGIA","MILLER",623,30,1891,2544
"2016","GEORGIA","MITCHELL",3493,108,4279,7880
"2016","GEORGIA","MONROE",3571,284,8832,12687
"2016","GEORGIA","MONTGOMERY",847,59,2670,3576
"2016","GEORGIA","MORGAN",2663,253,6559,9475
"2016","GEORGIA","MURRAY",1800,317,10341,12458
"2016","GEORGIA","MUSCOGEE",39851,2205,26976,69032
"2016","GEORGIA","NEWTON",21943,1131,20913,43987
"2016","GEORGIA","OCONEE",5581,1143,13425,20149
"2016","GEORGIA","OGLETHORPE",1831,218,4625,6674
"2016","GEORGIA","PAULDING",18025,2203,44662,64890
"2016","GEORGIA","PEACH",5100,239,5413,10752
"2016","GEORGIA","PICKENS",1979,408,11651,14038
"2016","GEORGIA","PIERCE",903,106,6302,7311
"2016","GEORGIA","PIKE",1240,207,7278,8725
"2016","GEORGIA","POLK",2867,334,11014,14215
"2016","GEORGIA","PULASKI",1104,64,2437,3605
"2016","GEORGIA","PUTNAM",2758,186,6544,9488
"2016","GEORGIA","QUITMAN",461,8,575,1044
"2016","GEORGIA","RABUN",1444,261,6287,7992
"2016","GEORGIA","RANDOLPH",1598,30,1271,2899
"2016","GEORGIA","RICHMOND",48814,2240,24461,75515
"2016","GEORGIA","ROCKDALE",23255,1136,13478,37869
"2016","GEORGIA","SCHLEY",401,36,1472,1909
"2016","GEORGIA","SCREVEN",2300,110,3305,5715
"2016","GEORGIA","SEMINOLE",1189,54,2345,3588
"2016","GEORGIA","SPALDING",9357,701,15646,25704
"2016","GEORGIA","STEPHENS",1837,292,7686,9815
"2016","GEORGIA","STEWART",1222,31,805,2058
"2016","GEORGIA","SUMTER",5520,178,5276,10974
"2016","GEORGIA","TALBOT",2002,48,1196,3246
"2016","GEORGIA","TALIAFERRO",545,3,349,897
"2016","GEORGIA","TATTNALL",1681,126,5096,6903
"2016","GEORGIA","TAYLOR",1296,48,2064,3408
"2016","GEORGIA","TELFAIR",1313,33,2450,3796
"2016","GEORGIA","TERRELL",2267,48,1874,4189
"2016","GEORGIA","THOMAS",7142,432,11228,18802
"2016","GEORGIA","TIFT",4347,288,9584,14219
"2016","GEORGIA","TOOMBS",2338,185,6615,9138
"2016","GEORGIA","TOWNS",1210,171,5383,6764
"2016","GEORGIA","TREUTLEN",862,32,1809,2703
"2016","GEORGIA","TROUP",9713,648,15750,26111
"2016","GEORGIA","TURNER",1246,57,2095,3398
"2016","GEORGIA","TWIGGS",1971,53,2035,4059
"2016","GEORGIA","UNION",1963,248,9852,12063
"2016","GEORGIA","UPSON",3475,167,7292,10934
"2016","GEORGIA","WALKER",4215,791,18950,23956
"2016","GEORGIA","WALTON",8292,1281,31125,40698
"2016","GEORGIA","WARE",3440,231,8513,12184
"2016","GEORGIA","WARREN",1314,29,991,2334
"2016","GEORGIA","WASHINGTON",4200,112,4149,8461
"2016","GEORGIA","WAYNE",2041,219,8153,10413
"2016","GEORGIA","WEBSTER",473,13,630,1116
"2016","GEORGIA","WHEELER",646,35,1421,2102
"2016","GEORGIA","WHITE",1674,388,9761,11823
"2016","GEORGIA","WHITFIELD",7937,1184,21537,30658
"2016","GEORGIA","WILCOX",852,28,2096,2976
"2016","GEORGIA","WILKES",1848,66,2572,4486
"2016","GEORGIA","WILKINSON",1894,60,2333,4287
"2016","GEORGIA","WORTH",2020,123,6152,8295
"2016","HAWAII","HAWAII",41259,6107,17501,64867
"2016","HAWAII","HONOLULU",175696,19768,90326,285790
"2016","HAWAII","KAUAI",16456,2305,7574,26335
"2016","HAWAII","MAUI",33480,5019,13446,51945
"2016","IDAHO","ADA",75677,26240,93752,195669
"2016","IDAHO","ADAMS",415,212,1556,2183
"2016","IDAHO","BANNOCK",10342,5894,17180,33416
"2016","IDAHO","BEAR LAKE",255,470,2203,2928
"2016","IDAHO","BENEWAH",770,312,3103,4185
"2016","IDAHO","BINGHAM",2924,2794,10907,16625
"2016","IDAHO","BLAINE",6416,968,3340,10724
"2016","IDAHO","BOISE",777,364,2673,3814
"2016","IDAHO","BONNER",5819,1781,13343,20943
"2016","IDAHO","BONNEVILLE",8930,8592,26699,44221
"2016","IDAHO","BOUNDARY",933,441,3789,5163
"2016","IDAHO","BUTTE",160,156,914,1230
"2016","IDAHO","CAMAS",110,70,410,590
"2016","IDAHO","CANYON",16883,8680,47222,72785
"2016","IDAHO","CARIBOU",271,489,2275,3035
"2016","IDAHO","CASSIA",1036,1193,5949,8178
"2016","IDAHO","CLARK",44,36,203,283
"2016","IDAHO","CLEARWATER",704,245,2852,3801
"2016","IDAHO","CUSTER",427,210,1777,2414
"2016","IDAHO","ELMORE",1814,892,5816,8522
"2016","IDAHO","FRANKLIN",385,1213,3901,5499
"2016","IDAHO","FREMONT",651,974,4090,5715
"2016","IDAHO","GEM",1229,745,5980,7954
"2016","IDAHO","GOODING",930,518,3743,5191
"2016","IDAHO","IDAHO",1196,596,6441,8233
"2016","IDAHO","JEFFERSON",976,2063,8436,11475
"2016","IDAHO","JEROME",1329,778,4644,6751
"2016","IDAHO","KOOTENAI",16264,5597,44449,66310
"2016","IDAHO","LATAH",8093,2815,7265,18173
"2016","IDAHO","LEMHI",733,352,3011,4096
"2016","IDAHO","LEWIS",270,118,1202,1590
"2016","IDAHO","LINCOLN",360,204,1184,1748
"2016","IDAHO","MADISON",1201,5546,8941,15688
"2016","IDAHO","MINIDOKA",1167,817,4887,6871
"2016","IDAHO","NEZ PERCE",4828,1674,10699,17201
"2016","IDAHO","ONEIDA",184,353,1531,2068
"2016","IDAHO","OWYHEE",591,282,3052,3925
"2016","IDAHO","PAYETTE",1507,708,6489,8704
"2016","IDAHO","POWER",699,393,1666,2758
"2016","IDAHO","SHOSHONE",1384,439,3297,5120
"2016","IDAHO","TETON",2159,650,2167,4976
"2016","IDAHO","TWIN FALLS",6233,3813,19828,29874
"2016","IDAHO","VALLEY",1913,530,2906,5349
"2016","IDAHO","WASHINGTON",776,396,3283,4455
"2016","ILLINOIS","ADAMS",7676,1485,22790,31951
"2016","ILLINOIS","ALEXANDER",1262,88,1496,2846
"2016","ILLINOIS","BOND",2068,574,4888,7530
"2016","ILLINOIS","BOONE",8986,1733,12282,23001
"2016","ILLINOIS","BROWN",476,107,1796,2379
"2016","ILLINOIS","BUREAU",6029,1261,9281,16571
"2016","ILLINOIS","CALHOUN",739,111,1721,2571
"2016","ILLINOIS","CARROLL",2447,564,4434,7445
"2016","ILLINOIS","CASS",1621,287,3216,5124
"2016","ILLINOIS","CHAMPAIGN",50137,8123,33368,91628
"2016","ILLINOIS","CHRISTIAN",3992,924,10543,15459
"2016","ILLINOIS","CLARK",1877,429,5622,7928
"2016","ILLINOIS","CLAY",1020,309,5021,6350
"2016","ILLINOIS","CLINTON",3945,1062,12412,17419
"2016","ILLINOIS","COLES",7309,1551,13003,21863
"2016","ILLINOIS","COOK",1611946,93382,453287,2158615
"2016","ILLINOIS","CRAWFORD",1992,459,6277,8728
"2016","ILLINOIS","CUMBERLAND",1031,330,4206,5567
"2016","ILLINOIS","DE WITT",1910,556,5077,7543
"2016","ILLINOIS","DEKALB",20466,4043,19091,43600
"2016","ILLINOIS","DOUGLAS",1949,522,5698,8169
"2016","ILLINOIS","DUPAGE",228622,33732,166415,428769
"2016","ILLINOIS","EDGAR",1793,435,5645,7873
"2016","ILLINOIS","EDWARDS",434,135,2778,3347
"2016","ILLINOIS","EFFINGHAM",3083,891,13635,17609
"2016","ILLINOIS","FAYETTE",1819,394,7372,9585
"2016","ILLINOIS","FORD",1414,502,4480,6396
"2016","ILLINOIS","FRANKLIN",4727,868,13116,18711
"2016","ILLINOIS","FULTON",6133,1172,8492,15797
"2016","ILLINOIS","GALLATIN",657,108,1942,2707
"2016","ILLINOIS","GREENE",1205,235,4145,5585
"2016","ILLINOIS","GRUNDY",8065,1718,13454,23237
"2016","ILLINOIS","HAMILTON",802,158,3206,4166
"2016","ILLINOIS","HANCOCK",2139,552,6430,9121
"2016","ILLINOIS","HARDIN",420,75,1653,2148
"2016","ILLINOIS","HENDERSON",1155,208,2155,3518
"2016","ILLINOIS","HENRY",8871,1787,13985,24643
"2016","ILLINOIS","IROQUOIS",2504,810,9750,13064
"2016","ILLINOIS","JACKSON",11634,2140,10843,24617
"2016","ILLINOIS","JASPER",924,237,3975,5136
"2016","ILLINOIS","JEFFERSON",4425,879,11695,16999
"2016","ILLINOIS","JERSEY",2679,564,7748,10991
"2016","ILLINOIS","JO DAVIESS",4462,751,6121,11334
"2016","ILLINOIS","JOHNSON",1142,298,4649,6089
"2016","ILLINOIS","KANE",103665,12915,82734,199314
"2016","ILLINOIS","KANKAKEE",18971,3205,25129,47305
"2016","ILLINOIS","KENDALL",24884,3602,24961,53447
"2016","ILLINOIS","KNOX",10083,1423,10737,22243
"2016","ILLINOIS","LAKE",171095,22658,109767,303520
"2016","ILLINOIS","LASALLE",19543,3511,26689,49743
"2016","ILLINOIS","LAWRENCE",1290,283,4521,6094
"2016","ILLINOIS","LEE",5528,1349,8612,15489
"2016","ILLINOIS","LIVINGSTON",4023,1038,10208,15269
"2016","ILLINOIS","LOGAN",3313,907,8181,12401
"2016","ILLINOIS","MACON",18343,2851,26866,48060
"2016","ILLINOIS","MACOUPIN",6689,1349,14322,22360
"2016","ILLINOIS","MADISON",50587,9102,70490,130179
"2016","ILLINOIS","MARION",4369,846,11859,17074
"2016","ILLINOIS","MARSHALL",1789,410,3785,5984
"2016","ILLINOIS","MASON",2014,414,4058,6486
"2016","ILLINOIS","MASSAC",1558,279,4846,6683
"2016","ILLINOIS","MCDONOUGH",5288,1009,6795,13092
"2016","ILLINOIS","MCHENRY",60803,9335,71612,141750
"2016","ILLINOIS","MCLEAN",36196,6402,37237,79835
"2016","ILLINOIS","MENARD",1817,467,4231,6515
"2016","ILLINOIS","MERCER",3071,647,4807,8525
"2016","ILLINOIS","MONROE",5535,1190,12629,19354
"2016","ILLINOIS","MONTGOMERY",3504,844,8630,12978
"2016","ILLINOIS","MORGAN",4696,1028,9076,14800
"2016","ILLINOIS","MOULTRIE",1481,347,4455,6283
"2016","ILLINOIS","OGLE",8050,1791,14352,24193
"2016","ILLINOIS","PEORIA",38060,4810,35633,78503
"2016","ILLINOIS","PERRY",2462,536,6855,9853
"2016","ILLINOIS","PIATT",2645,729,5634,9008
"2016","ILLINOIS","PIKE",1413,363,5754,7530
"2016","ILLINOIS","POPE",375,89,1678,2142
"2016","ILLINOIS","PULASKI",962,98,1675,2735
"2016","ILLINOIS","PUTNAM",1147,197,1767,3111
"2016","ILLINOIS","RANDOLPH",3439,732,10023,14194
"2016","ILLINOIS","RICHLAND",1584,361,5739,7684
"2016","ILLINOIS","ROCK ISLAND",32298,4698,26998,63994
"2016","ILLINOIS","SALINE",2572,536,8276,11384
"2016","ILLINOIS","SANGAMON",40907,7522,49944,98373
"2016","ILLINOIS","SCHUYLER",1075,229,2524,3828
"2016","ILLINOIS","SCOTT",535,107,1966,2608
"2016","ILLINOIS","SHELBY",2288,493,8229,11010
"2016","ILLINOIS","ST. CLAIR",60756,5967,53857,120580
"2016","ILLINOIS","STARK",751,214,1778,2743
"2016","ILLINOIS","STEPHENSON",7768,1492,11083,20343
"2016","ILLINOIS","TAZEWELL",20685,5008,38707,64400
"2016","ILLINOIS","UNION",2402,345,5790,8537
"2016","ILLINOIS","VERMILION",10039,1444,19087,30570
"2016","ILLINOIS","WABASH",1151,266,4047,5464
"2016","ILLINOIS","WARREN",2987,545,4275,7807
"2016","ILLINOIS","WASHINGTON",1448,408,5571,7427
"2016","ILLINOIS","WAYNE",1048,246,6967,8261
"2016","ILLINOIS","WHITE",1412,283,5640,7335
"2016","ILLINOIS","WHITESIDE",11035,1932,12615,25582
"2016","ILLINOIS","WILL",151927,16257,132720,300904
"2016","ILLINOIS","WILLIAMSON",8581,1701,21570,31852
"2016","ILLINOIS","WINNEBAGO",55713,7039,55624,118376
"2016","ILLINOIS","WOODFORD",5092,1565,13207,19864
"2016","INDIANA","ADAMS",2805,637,9648,13090
"2016","INDIANA","ALLEN",55382,7825,83930,147137
"2016","INDIANA","BARTHOLOMEW",9841,2009,20640,32490
"2016","INDIANA","BENTON",860,227,2579,3666
"2016","INDIANA","BLACKFORD",1243,246,3350,4839
"2016","INDIANA","BOONE",10181,2343,19654,32178
"2016","INDIANA","BROWN",2518,411,5016,7945
"2016","INDIANA","CARROLL",1892,478,6273,8643
"2016","INDIANA","CASS",3759,749,9701,14209
"2016","INDIANA","CLARK",18808,2304,30035,51147
"2016","INDIANA","CLAY",2306,445,8531,11282
"2016","INDIANA","CLINTON",2819,586,8531,11936
"2016","INDIANA","CRAWFORD",1323,255,3015,4593
"2016","INDIANA","DAVIESS",1800,423,8545,10768
"2016","INDIANA","DEARBORN",4883,991,18113,23987
"2016","INDIANA","DECATUR",2121,516,8490,11127
"2016","INDIANA","DEKALB",3942,906,12054,16902
"2016","INDIANA","DELAWARE",18153,2707,24263,45123
"2016","INDIANA","DUBOIS",5389,1230,13365,19984
"2016","INDIANA","ELKHART",20740,3023,41867,65630
"2016","INDIANA","FAYETTE",2252,439,6839,9530
"2016","INDIANA","FLOYD",13945,2048,21432,37425
"2016","INDIANA","FOUNTAIN",1476,354,5662,7492
"2016","INDIANA","FRANKLIN",1969,375,8669,11013
"2016","INDIANA","FULTON",1960,404,6010,8374
"2016","INDIANA","GIBSON",3721,682,11081,15484
"2016","INDIANA","GRANT",7010,1294,17008,25312
"2016","INDIANA","GREENE",2929,595,10277,13801
"2016","INDIANA","HAMILTON",57263,9589,87404,154256
"2016","INDIANA","HANCOCK",8904,2203,25074,36181
"2016","INDIANA","HARRISON",4783,832,12943,18558
"2016","INDIANA","HENDRICKS",22600,4622,48337,75559
"2016","INDIANA","HENRY",5124,1136,13895,20155
"2016","INDIANA","HOWARD",11215,1953,23675,36843
"2016","INDIANA","HUNTINGTON",3506,888,11649,16043
"2016","INDIANA","JACKSON",3843,871,12859,17573
"2016","INDIANA","JASPER",3329,667,9382,13378
"2016","INDIANA","JAY",1889,400,5697,7986
"2016","INDIANA","JEFFERSON",4326,672,8546,13544
"2016","INDIANA","JENNINGS",2364,562,8224,11150
"2016","INDIANA","JOHNSON",17318,3726,45456,66500
"2016","INDIANA","KNOX",3772,667,11077,15516
"2016","INDIANA","KOSCIUSKO",6313,1836,23935,32084
"2016","INDIANA","LAGRANGE",2080,461,7025,9566
"2016","INDIANA","LAKE",116935,8645,75625,201205
"2016","INDIANA","LAPORTE",19798,2718,22687,45203
"2016","INDIANA","LAWRENCE",4210,907,14035,19152
"2016","INDIANA","MADISON",18595,2938,32376,53909
"2016","INDIANA","MARION",212899,19113,130360,362372
"2016","INDIANA","MARSHALL",4798,996,12288,18082
"2016","INDIANA","MARTIN",881,231,3697,4809
"2016","INDIANA","MIAMI",2766,741,9975,13482
"2016","INDIANA","MONROE",34216,3646,20592,58454
"2016","INDIANA","MONTGOMERY",3362,735,11059,15156
"2016","INDIANA","MORGAN",6040,1566,23674,31280
"2016","INDIANA","NEWTON",1404,314,4077,5795
"2016","INDIANA","NOBLE",3904,788,12198,16890
"2016","INDIANA","OHIO",686,117,2118,2921
"2016","INDIANA","ORANGE",2048,341,5803,8192
"2016","INDIANA","OWEN",1946,458,6153,8557
"2016","INDIANA","PARKE",1441,278,4863,6582
"2016","INDIANA","PERRY",3062,437,4556,8055
"2016","INDIANA","PIKE",1297,282,4398,5977
"2016","INDIANA","PORTER",33676,4682,38832,77190
"2016","INDIANA","POSEY",3521,542,8404,12467
"2016","INDIANA","PULASKI",1327,278,3854,5459
"2016","INDIANA","PUTNAM",3356,722,10637,14715
"2016","INDIANA","RANDOLPH",2446,495,7517,10458
"2016","INDIANA","RIPLEY",2471,533,9806,12810
"2016","INDIANA","RUSH",1525,397,5292,7214
"2016","INDIANA","SCOTT",2642,385,6074,9101
"2016","INDIANA","SHELBY",4247,1029,12718,17994
"2016","INDIANA","SPENCER",2861,546,6572,9979
"2016","INDIANA","ST. JOSEPH",52252,5787,52021,110060
"2016","INDIANA","STARKE",2489,370,6367,9226
"2016","INDIANA","STEUBEN",3744,689,10133,14566
"2016","INDIANA","SULLIVAN",2113,308,6138,8559
"2016","INDIANA","SWITZERLAND",930,211,2558,3699
"2016","INDIANA","TIPPECANOE",27282,4465,30768,62515
"2016","INDIANA","TIPTON",1587,334,5589,7510
"2016","INDIANA","UNION",715,131,2445,3291
"2016","INDIANA","VANDERBURGH",28530,3481,40496,72507
"2016","INDIANA","VERMILLION",2081,345,4513,6939
"2016","INDIANA","VIGO",15931,1950,21937,39818
"2016","INDIANA","WABASH",3018,629,9821,13468
"2016","INDIANA","WARREN",839,193,2898,3930
"2016","INDIANA","WARRICK",9086,1390,19113,29589
"2016","INDIANA","WASHINGTON",2636,537,8209,11382
"2016","INDIANA","WAYNE",8322,1229,16028,25579
"2016","INDIANA","WELLS",2586,594,10005,13185
"2016","INDIANA","WHITE",2590,570,6893,10053
"2016","INDIANA","WHITLEY",3379,886,11358,15623
"2016","IOWA","ADAIR",1133,217,2461,3811
"2016","IOWA","ADAMS",565,146,1395,2106
"2016","IOWA","ALLAMAKEE",2421,409,4093,6923
"2016","IOWA","APPANOOSE",1814,289,4033,6136
"2016","IOWA","AUDUBON",1080,196,2136,3412
"2016","IOWA","BENTON",4678,934,8232,13844
"2016","IOWA","BLACK HAWK",32233,4696,27476,64405
"2016","IOWA","BOONE",5541,1171,7484,14196
"2016","IOWA","BREMER",5356,974,7208,13538
"2016","IOWA","BUCHANAN",3970,772,5510,10252
"2016","IOWA","BUENA VISTA",2856,519,4903,8278
"2016","IOWA","BUTLER",2157,435,4921,7513
"2016","IOWA","CALHOUN",1398,293,3468,5159
"2016","IOWA","CARROLL",3309,597,6638,10544
"2016","IOWA","CASS",1951,413,4761,7125
"2016","IOWA","CEDAR",3599,647,5295,9541
"2016","IOWA","CERRO GORDO",9862,1482,11621,22965
"2016","IOWA","CHEROKEE",1679,387,4192,6258
"2016","IOWA","CHICKASAW",2266,427,3742,6435
"2016","IOWA","CLARKE",1465,276,2713,4454
"2016","IOWA","CLAY",2249,491,5877,8617
"2016","IOWA","CLAYTON",3237,575,5317,9129
"2016","IOWA","CLINTON",10095,1696,11276,23067
"2016","IOWA","CRAWFORD",1991,327,4617,6935
"2016","IOWA","DALLAS",15701,3212,19339,38252
"2016","IOWA","DAVIS",977,182,2723,3882
"2016","IOWA","DECATUR",1201,237,2296,3734
"2016","IOWA","DELAWARE",2957,590,5694,9241
"2016","IOWA","DES MOINES",8212,1362,9529,19103
"2016","IOWA","DICKINSON",3056,545,6753,10354
"2016","IOWA","DUBUQUE",22850,3411,23460,49721
"2016","IOWA","EMMET",1357,272,3124,4753
"2016","IOWA","FAYETTE",3689,666,5620,9975
"2016","IOWA","FLOYD",3179,506,4375,8060
"2016","IOWA","FRANKLIN",1493,312,3163,4968
"2016","IOWA","FREMONT",963,225,2407,3595
"2016","IOWA","GREENE",1691,310,2820,4821
"2016","IOWA","GRUNDY",1856,489,4527,6872
"2016","IOWA","GUTHRIE",1732,390,3628,5750
"2016","IOWA","HAMILTON",2726,505,4463,7694
"2016","IOWA","HANCOCK",1587,307,3977,5871
"2016","IOWA","HARDIN",2787,492,5254,8533
"2016","IOWA","HARRISON",2131,432,4902,7465
"2016","IOWA","HENRY",2904,721,5779,9404
"2016","IOWA","HOWARD",1677,271,2611,4559
"2016","IOWA","HUMBOLDT",1252,267,3568,5087
"2016","IOWA","IDA",792,165,2655,3612
"2016","IOWA","IOWA",3084,615,5205,8904
"2016","IOWA","JACKSON",3837,649,5824,10310
"2016","IOWA","JASPER",7109,1365,10560,19034
"2016","IOWA","JEFFERSON",3710,698,3748,8156
"2016","IOWA","JOHNSON",50200,5696,21044,76940
"2016","IOWA","JONES",3787,626,5720,10133
"2016","IOWA","KEOKUK",1342,253,3390,4985
"2016","IOWA","KOSSUTH",2543,411,5653,8607
"2016","IOWA","LEE",6215,1133,8803,16151
"2016","IOWA","LINN",58935,9773,48390,117098
"2016","IOWA","LOUISA",1648,291,3069,5008
"2016","IOWA","LUCAS",1239,238,2877,4354
"2016","IOWA","LYON",920,265,5192,6377
"2016","IOWA","MADISON",2678,598,5360,8636
"2016","IOWA","MAHASKA",2619,581,7432,10632
"2016","IOWA","MARION",5482,1372,10962,17816
"2016","IOWA","MARSHALL",7652,1182,9146,17980
"2016","IOWA","MILLS",2090,541,5067,7698
"2016","IOWA","MITCHELL",1888,339,3190,5417
"2016","IOWA","MONONA",1247,205,3120,4572
"2016","IOWA","MONROE",1056,171,2638,3865
"2016","IOWA","MONTGOMERY",1314,294,3436,5044
"2016","IOWA","MUSCATINE",8368,1482,9584,19434
"2016","IOWA","O'BRIEN",1315,339,5752,7406
"2016","IOWA","OSCEOLA",552,130,2531,3213
"2016","IOWA","PAGE",1807,344,4893,7044
"2016","IOWA","PALO ALTO",1398,224,3081,4703
"2016","IOWA","PLYMOUTH",2885,625,9680,13190
"2016","IOWA","POCAHONTAS",963,200,2702,3865
"2016","IOWA","POLK",119804,18259,93492,231555
"2016","IOWA","POTTAWATTAMIE",15355,2878,24447,42680
"2016","IOWA","POWESHIEK",4304,583,4946,9833
"2016","IOWA","RINGGOLD",753,130,1824,2707
"2016","IOWA","SAC",1270,239,3703,5212
"2016","IOWA","SCOTT",40440,6631,39149,86220
"2016","IOWA","SHELBY",1662,346,4362,6370
"2016","IOWA","SIOUX",2300,1109,14785,18194
"2016","IOWA","STORY",25709,5500,19458,50667
"2016","IOWA","TAMA",3196,585,4971,8752
"2016","IOWA","TAYLOR",758,160,2111,3029
"2016","IOWA","UNION",1922,385,3525,5832
"2016","IOWA","VAN BUREN",845,189,2527,3561
"2016","IOWA","WAPELLO",5594,840,8715,15149
"2016","IOWA","WARREN",10411,2075,14814,27300
"2016","IOWA","WASHINGTON",3943,813,6173,10929
"2016","IOWA","WAYNE",719,152,2069,2940
"2016","IOWA","WEBSTER",6305,1069,10056,17430
"2016","IOWA","WINNEBAGO",1931,409,3447,5787
"2016","IOWA","WINNESHIEK",5254,764,5344,11362
"2016","IOWA","WOODBURY",16210,2781,24727,43718
"2016","IOWA","WORTH",1530,274,2453,4257
"2016","IOWA","WRIGHT",1896,330,3800,6026
"2016","KANSAS","ALLEN",1433,370,3651,5454
"2016","KANSAS","ANDERSON",672,243,2435,3350
"2016","KANSAS","ATCHISON",1989,537,4049,6575
"2016","KANSAS","BARBER",286,116,1850,2252
"2016","KANSAS","BARTON",1839,542,7888,10269
"2016","KANSAS","BOURBON",1336,333,4424,6093
"2016","KANSAS","BROWN",863,267,2906,4036
"2016","KANSAS","BUTLER",6573,2011,19073,27657
"2016","KANSAS","CHASE",316,84,969,1369
"2016","KANSAS","CHAUTAUQUA",197,48,1236,1481
"2016","KANSAS","CHEROKEE",2005,433,6182,8620
"2016","KANSAS","CHEYENNE",181,53,1173,1407
"2016","KANSAS","CLARK",120,60,825,1005
"2016","KANSAS","CLAY",677,252,2891,3820
"2016","KANSAS","CLOUD",761,250,2919,3930
"2016","KANSAS","COFFEY",727,291,3050,4068
"2016","KANSAS","COMANCHE",102,50,715,867
"2016","KANSAS","COWLEY",3551,800,8270,12621
"2016","KANSAS","CRAWFORD",5199,1068,8624,14891
"2016","KANSAS","DECATUR",178,64,1210,1452
"2016","KANSAS","DICKINSON",1609,572,6029,8210
"2016","KANSAS","DONIPHAN",587,185,2606,3378
"2016","KANSAS","DOUGLAS",31195,4204,14688,50087
"2016","KANSAS","EDWARDS",212,70,1037,1319
"2016","KANSAS","ELK",160,51,1048,1259
"2016","KANSAS","ELLIS",2742,739,8466,11947
"2016","KANSAS","ELLSWORTH",521,189,1969,2679
"2016","KANSAS","FINNEY",3195,614,6350,10159
"2016","KANSAS","FORD",2149,455,5114,7718
"2016","KANSAS","FRANKLIN",2892,888,7185,10965
"2016","KANSAS","GEARY",2722,508,4274,7504
"2016","KANSAS","GOVE",149,54,1140,1343
"2016","KANSAS","GRAHAM",188,71,1025,1284
"2016","KANSAS","GRANT",441,144,1804,2389
"2016","KANSAS","GRAY",263,105,1698,2066
"2016","KANSAS","GREELEY",83,33,534,650
"2016","KANSAS","GREENWOOD",485,195,2160,2840
"2016","KANSAS","HAMILTON",121,50,705,876
"2016","KANSAS","HARPER",393,189,1996,2578
"2016","KANSAS","HARVEY",5068,1180,8668,14916
"2016","KANSAS","HASKELL",245,69,1040,1354
"2016","KANSAS","HODGEMAN",124,38,855,1017
"2016","KANSAS","JACKSON",1512,367,3939,5818
"2016","KANSAS","JEFFERSON",2518,606,5213,8337
"2016","KANSAS","JEWELL",180,91,1223,1494
"2016","KANSAS","JOHNSON",129852,22748,137490,290090
"2016","KANSAS","KEARNY",174,67,1075,1316
"2016","KANSAS","KINGMAN",599,205,2530,3334
"2016","KANSAS","KIOWA",114,65,900,1079
"2016","KANSAS","LABETTE",2291,481,5335,8107
"2016","KANSAS","LANE",106,47,718,871
"2016","KANSAS","LEAVENWORTH",10209,2454,17638,30301
"2016","KANSAS","LINCOLN",215,70,1179,1464
"2016","KANSAS","LINN",736,207,3484,4427
"2016","KANSAS","LOGAN",149,76,1132,1357
"2016","KANSAS","LYON",4649,1087,6552,12288
"2016","KANSAS","MARION",1204,417,4003,5624
"2016","KANSAS","MARSHALL",1072,294,3307,4673
"2016","KANSAS","MCPHERSON",3226,967,8549,12742
"2016","KANSAS","MEADE",210,95,1415,1720
"2016","KANSAS","MIAMI",3991,1028,10003,15022
"2016","KANSAS","MITCHELL",477,157,2308,2942
"2016","KANSAS","MONTGOMERY",2637,688,8679,12004
"2016","KANSAS","MORRIS",601,203,1820,2624
"2016","KANSAS","MORTON",147,50,995,1192
"2016","KANSAS","NEMAHA",725,273,4124,5122
"2016","KANSAS","NEOSHO",1501,382,4431,6314
"2016","KANSAS","NESS",162,64,1228,1454
"2016","KANSAS","NORTON",281,113,1840,2234
"2016","KANSAS","OSAGE",1753,467,4826,7046
"2016","KANSAS","OSBORNE",233,95,1460,1788
"2016","KANSAS","OTTAWA",424,196,2283,2903
"2016","KANSAS","PAWNEE",579,178,1904,2661
"2016","KANSAS","PHILLIPS",300,131,2233,2664
"2016","KANSAS","POTTAWATOMIE",2225,856,7612,10693
"2016","KANSAS","PRATT",771,233,2838,3842
"2016","KANSAS","RAWLINS",163,89,1220,1472
"2016","KANSAS","RENO",6837,1860,15513,24210
"2016","KANSAS","REPUBLIC",375,130,2024,2529
"2016","KANSAS","RICE",695,272,2837,3804
"2016","KANSAS","RILEY",9341,2084,10107,21532
"2016","KANSAS","ROOKS",275,113,2031,2419
"2016","KANSAS","RUSH",233,73,1197,1503
"2016","KANSAS","RUSSELL",461,158,2574,3193
"2016","KANSAS","SALINE",6317,1919,13828,22064
"2016","KANSAS","SCOTT",236,101,1865,2202
"2016","KANSAS","SEDGWICK",69627,14803,104353,188783
"2016","KANSAS","SEWARD",1628,251,3159,5038
"2016","KANSAS","SHAWNEE",33926,5546,35934,75406
"2016","KANSAS","SHERIDAN",127,50,1197,1374
"2016","KANSAS","SHERMAN",347,176,2089,2612
"2016","KANSAS","SMITH",297,84,1661,2042
"2016","KANSAS","STAFFORD",304,102,1490,1896
"2016","KANSAS","STANTON",115,30,492,637
"2016","KANSAS","STEVENS",220,72,1599,1891
"2016","KANSAS","SUMNER",2076,662,6984,9722
"2016","KANSAS","THOMAS",473,195,2908,3576
"2016","KANSAS","TREGO",198,57,1227,1482
"2016","KANSAS","WABAUNSEE",776,232,2372,3380
"2016","KANSAS","WALLACE",46,31,721,798
"2016","KANSAS","WASHINGTON",387,184,2194,2765
"2016","KANSAS","WICHITA",140,47,769,956
"2016","KANSAS","WILSON",594,209,2788,3591
"2016","KANSAS","WOODSON",273,88,1082,1443
"2016","KANSAS","WYANDOTTE",30146,2829,15806,48781
"2016","KENTUCKY","ADAIR",1323,273,6637,8233
"2016","KENTUCKY","ALLEN",1349,281,6466,8096
"2016","KENTUCKY","ANDERSON",2634,546,8242,11422
"2016","KENTUCKY","BALLARD",816,124,3161,4101
"2016","KENTUCKY","BARREN",4275,730,13483,18488
"2016","KENTUCKY","BATH",1361,144,3082,4587
"2016","KENTUCKY","BELL",1720,234,7764,9718
"2016","KENTUCKY","BOONE",15026,3510,39082,57618
"2016","KENTUCKY","BOURBON",2791,443,5569,8803
"2016","KENTUCKY","BOYD",6021,842,13591,20454
"2016","KENTUCKY","BOYLE",4281,625,8040,12946
"2016","KENTUCKY","BRACKEN",705,111,2711,3527
"2016","KENTUCKY","BREATHITT",1537,210,3991,5738
"2016","KENTUCKY","BRECKINRIDGE",1960,330,6484,8774
"2016","KENTUCKY","BULLITT",8255,1604,26210,36069
"2016","KENTUCKY","BUTLER",947,201,4428,5576
"2016","KENTUCKY","CALDWELL",1260,208,4507,5975
"2016","KENTUCKY","CALLOWAY",4749,933,10367,16049
"2016","KENTUCKY","CAMPBELL",14658,2802,25050,42510
"2016","KENTUCKY","CARLISLE",432,75,2094,2601
"2016","KENTUCKY","CARROLL",1106,161,2588,3855
"2016","KENTUCKY","CARTER",2276,415,7587,10278
"2016","KENTUCKY","CASEY",767,190,5482,6439
"2016","KENTUCKY","CHRISTIAN",7188,787,14108,22083
"2016","KENTUCKY","CLARK",4706,789,10710,16205
"2016","KENTUCKY","CLAY",752,154,5861,6767
"2016","KENTUCKY","CLINTON",547,106,3809,4462
"2016","KENTUCKY","CRITTENDEN",617,130,3290,4037
"2016","KENTUCKY","CUMBERLAND",459,105,2502,3066
"2016","KENTUCKY","DAVIESS",14163,2737,28907,45807
"2016","KENTUCKY","EDMONSON",979,130,4135,5244
"2016","KENTUCKY","ELLIOTT",740,115,2000,2855
"2016","KENTUCKY","ESTILL",1108,201,4236,5545
"2016","KENTUCKY","FAYETTE",69778,9643,56894,136315
"2016","KENTUCKY","FLEMING",1348,190,4722,6260
"2016","KENTUCKY","FLOYD",4015,532,11993,16540
"2016","KENTUCKY","FRANKLIN",10717,1329,11819,23865
"2016","KENTUCKY","FULTON",774,59,1549,2382
"2016","KENTUCKY","GALLATIN",749,146,2443,3338
"2016","KENTUCKY","GARRARD",1453,266,5904,7623
"2016","KENTUCKY","GRANT",1910,381,7268,9559
"2016","KENTUCKY","GRAVES",3308,627,12671,16606
"2016","KENTUCKY","GRAYSON",1959,398,8219,10576
"2016","KENTUCKY","GREEN",832,129,4372,5333
"2016","KENTUCKY","GREENUP",4146,585,11546,16277
"2016","KENTUCKY","HANCOCK",1244,263,2788,4295
"2016","KENTUCKY","HARDIN",13944,2241,26971,43156
"2016","KENTUCKY","HARLAN",1372,256,9129,10757
"2016","KENTUCKY","HARRISON",2031,315,5435,7781
"2016","KENTUCKY","HART",1730,214,5320,7264
"2016","KENTUCKY","HENDERSON",6707,844,12159,19710
"2016","KENTUCKY","HENRY",1828,377,4944,7149
"2016","KENTUCKY","HICKMAN",449,51,1657,2157
"2016","KENTUCKY","HOPKINS",4310,758,15277,20345
"2016","KENTUCKY","JACKSON",482,130,4889,5501
"2016","KENTUCKY","JEFFERSON",190836,18495,143768,353099
"2016","KENTUCKY","JESSAMINE",6144,1708,15474,23326
"2016","KENTUCKY","JOHNSON",1250,279,8043,9572
"2016","KENTUCKY","KENTON",24214,4826,42958,71998
"2016","KENTUCKY","KNOTT",1245,161,4357,5763
"2016","KENTUCKY","KNOX",1761,366,9885,12012
"2016","KENTUCKY","LARUE",1278,290,4799,6367
"2016","KENTUCKY","LAUREL",3440,801,20592,24833
"2016","KENTUCKY","LAWRENCE",1045,181,4816,6042
"2016","KENTUCKY","LEE",444,72,2151,2667
"2016","KENTUCKY","LESLIE",400,77,4015,4492
"2016","KENTUCKY","LETCHER",1542,299,7293,9134
"2016","KENTUCKY","LEWIS",785,150,4363,5298
"2016","KENTUCKY","LINCOLN",1865,358,7338,9561
"2016","KENTUCKY","LIVINGSTON",887,188,3570,4645
"2016","KENTUCKY","LOGAN",2755,366,7778,10899
"2016","KENTUCKY","LYON",1045,128,2789,3962
"2016","KENTUCKY","MADISON",11793,2147,23431,37371
"2016","KENTUCKY","MAGOFFIN",1172,120,3824,5116
"2016","KENTUCKY","MARION",2679,310,5122,8111
"2016","KENTUCKY","MARSHALL",3672,704,12322,16698
"2016","KENTUCKY","MARTIN",363,87,3503,3953
"2016","KENTUCKY","MASON",1970,305,4944,7219
"2016","KENTUCKY","MCCRACKEN",9134,1399,20774,31307
"2016","KENTUCKY","MCCREARY",664,100,5012,5776
"2016","KENTUCKY","MCLEAN",988,197,3381,4566
"2016","KENTUCKY","MEADE",3026,545,8660,12231
"2016","KENTUCKY","MENIFEE",700,69,2010,2779
"2016","KENTUCKY","MERCER",2395,450,7740,10585
"2016","KENTUCKY","METCALFE",976,153,3491,4620
"2016","KENTUCKY","MONROE",601,112,4278,4991
"2016","KENTUCKY","MONTGOMERY",3158,438,7856,11452
"2016","KENTUCKY","MORGAN",1006,141,3628,4775
"2016","KENTUCKY","MUHLENBERG",3272,395,9393,13060
"2016","KENTUCKY","NELSON",6434,937,13431,20802
"2016","KENTUCKY","NICHOLAS",787,97,1957,2841
"2016","KENTUCKY","OHIO",2080,376,7942,10398
"2016","KENTUCKY","OLDHAM",10268,2116,20469,32853
"2016","KENTUCKY","OWEN",1062,194,3745,5001
"2016","KENTUCKY","OWSLEY",256,29,1474,1759
"2016","KENTUCKY","PENDLETON",1164,239,4604,6007
"2016","KENTUCKY","PERRY",2136,278,8158,10572
"2016","KENTUCKY","PIKE",4280,638,19747,24665
"2016","KENTUCKY","POWELL",1272,172,3513,4957
"2016","KENTUCKY","PULASKI",4208,931,22902,28041
"2016","KENTUCKY","ROBERTSON",222,32,759,1013
"2016","KENTUCKY","ROCKCASTLE",915,167,5609,6691
"2016","KENTUCKY","ROWAN",3295,379,5174,8848
"2016","KENTUCKY","RUSSELL",1093,218,6863,8174
"2016","KENTUCKY","SCOTT",7715,1433,15052,24200
"2016","KENTUCKY","SHELBY",6276,1108,13196,20580
"2016","KENTUCKY","SIMPSON",2144,310,5077,7531
"2016","KENTUCKY","SPENCER",1921,398,7196,9515
"2016","KENTUCKY","TAYLOR",2553,433,8320,11306
"2016","KENTUCKY","TODD",1042,125,3612,4779
"2016","KENTUCKY","TRIGG",1587,233,4931,6751
"2016","KENTUCKY","TRIMBLE",879,148,2771,3798
"2016","KENTUCKY","UNION",1331,179,4701,6211
"2016","KENTUCKY","WARREN",16966,2815,28673,48454
"2016","KENTUCKY","WASHINGTON",1420,203,4013,5636
"2016","KENTUCKY","WAYNE",1431,190,6371,7992
"2016","KENTUCKY","WEBSTER",1240,168,4397,5805
"2016","KENTUCKY","WHITLEY",2067,395,11312,13774
"2016","KENTUCKY","WOLFE",753,78,1804,2635
"2016","KENTUCKY","WOODFORD",4958,908,7697,13563
"2016","LOUISIANA","ACADIA",5638,589,21162,27389
"2016","LOUISIANA","ALLEN",2106,272,6867,9245
"2016","LOUISIANA","ASCENSION",16476,2059,36143,54678
"2016","LOUISIANA","ASSUMPTION",3931,259,6714,10904
"2016","LOUISIANA","AVOYELLES",5035,386,11165,16586
"2016","LOUISIANA","BEAUREGARD",2393,447,12238,15078
"2016","LOUISIANA","BIENVILLE",3129,120,3756,7005
"2016","LOUISIANA","BOSSIER",12641,1733,35474,49848
"2016","LOUISIANA","CADDO",53483,3315,49006,105804
"2016","LOUISIANA","CALCASIEU",26296,3298,54191,83785
"2016","LOUISIANA","CALDWELL",788,82,3822,4692
"2016","LOUISIANA","CAMERON",323,113,3256,3692
"2016","LOUISIANA","CATAHOULA",1322,55,3479,4856
"2016","LOUISIANA","CLAIBORNE",2717,119,3585,6421
"2016","LOUISIANA","CONCORDIA",3272,123,5477,8872
"2016","LOUISIANA","DE SOTO",5165,267,8068,13500
"2016","LOUISIANA","EAST BATON ROUGE",102828,9003,84660,196491
"2016","LOUISIANA","EAST CARROLL",1838,42,1059,2939
"2016","LOUISIANA","EAST FELICIANA",4235,238,5569,10042
"2016","LOUISIANA","EVANGELINE",4208,314,10360,14882
"2016","LOUISIANA","FRANKLIN",2506,142,6514,9162
"2016","LOUISIANA","GRANT",1181,232,7408,8821
"2016","LOUISIANA","IBERIA",10698,853,20903,32454
"2016","LOUISIANA","IBERVILLE",8324,399,7320,16043
"2016","LOUISIANA","JACKSON",2139,156,5169,7464
"2016","LOUISIANA","JEFFERSON",73670,7571,100398,181639
"2016","LOUISIANA","JEFFERSON DAVIS",3080,422,10775,14277
"2016","LOUISIANA","LA SALLE",605,128,5836,6569
"2016","LOUISIANA","LAFAYETTE",32726,4682,68195,105603
"2016","LOUISIANA","LAFOURCHE",8423,1263,31959,41645
"2016","LOUISIANA","LINCOLN",7107,801,10761,18669
"2016","LOUISIANA","LIVINGSTON",6950,1956,48824,57730
"2016","LOUISIANA","MADISON",2744,61,1927,4732
"2016","LOUISIANA","MOREHOUSE",5155,195,6502,11852
"2016","LOUISIANA","NATCHITOCHES",7144,509,8968,16621
"2016","LOUISIANA","ORLEANS",133996,7524,24292,165812
"2016","LOUISIANA","OUACHITA",24428,1855,41734,68017
"2016","LOUISIANA","PLAQUEMINES",3347,326,6900,10573
"2016","LOUISIANA","POINTE COUPEE",4764,208,6789,11761
"2016","LOUISIANA","RAPIDES",18322,1706,36816,56844
"2016","LOUISIANA","RED RIVER",1938,93,2391,4422
"2016","LOUISIANA","RICHLAND",3157,153,6287,9597
"2016","LOUISIANA","SABINE",1703,205,7879,9787
"2016","LOUISIANA","ST. BERNARD",4960,618,10237,15815
"2016","LOUISIANA","ST. CHARLES",8559,1012,16621,26192
"2016","LOUISIANA","ST. HELENA",3353,114,2497,5964
"2016","LOUISIANA","ST. JAMES",6418,211,5456,12085
"2016","LOUISIANA","ST. JOHN THE BAPTIST",12661,513,7569,20743
"2016","LOUISIANA","ST. LANDRY",17209,797,21971,39977
"2016","LOUISIANA","ST. MARTIN",8266,611,16873,25750
"2016","LOUISIANA","ST. MARY",8050,468,14359,22877
"2016","LOUISIANA","ST. TAMMANY",27717,5760,90915,124392
"2016","LOUISIANA","TANGIPAHOA",16878,1579,33959,52416
"2016","LOUISIANA","TENSAS",1332,34,1182,2548
"2016","LOUISIANA","TERREBONNE",10665,1329,31902,43896
"2016","LOUISIANA","UNION",2691,231,7972,10894
"2016","LOUISIANA","VERMILION",4857,712,20063,25632
"2016","LOUISIANA","VERNON",2665,497,13471,16633
"2016","LOUISIANA","WASHINGTON",5692,380,12556,18628
"2016","LOUISIANA","WEBSTER",6260,343,11542,18145
"2016","LOUISIANA","WEST BATON ROUGE",5383,402,6927,12712
"2016","LOUISIANA","WEST CARROLL",715,74,3970,4759
"2016","LOUISIANA","WEST FELICIANA",2248,161,3390,5799
"2016","LOUISIANA","WINN",1644,120,4608,6372
"2016","MAINE","ANDROSCOGGIN",23009,4365,28227,55601
"2016","MAINE","AROOSTOOK",13386,2292,19419,35097
"2016","MAINE","CUMBERLAND",102981,11128,57709,171818
"2016","MAINE","FRANKLIN",7016,1554,7918,16488
"2016","MAINE","HANCOCK",16117,2308,13705,32130
"2016","MAINE","KENNEBEC",29302,5231,31675,66208
"2016","MAINE","KNOX",12443,1556,9148,23147
"2016","MAINE","LINCOLN",10241,1535,9727,21503
"2016","MAINE","MAINE UOCAVA",3017,321,648,3986
"2016","MAINE","OXFORD",12172,2819,16210,31201
"2016","MAINE","PENOBSCOT",32838,6080,41622,80540
"2016","MAINE","PISCATAQUIS",3098,678,5406,9182
"2016","MAINE","SAGADAHOC",10664,1648,9304,21616
"2016","MAINE","SOMERSET",9092,1971,15001,26064
"2016","MAINE","WALDO",10440,1889,10378,22707
"2016","MAINE","WASHINGTON",6075,1197,9093,16365
"2016","MAINE","YORK",55844,8027,50403,114274
"2016","MARYLAND","ALLEGANY",7875,1509,21270,30654
"2016","MARYLAND","ANNE ARUNDEL",128419,19259,122403,270081
"2016","MARYLAND","BALTIMORE",218412,22793,149477,390682
"2016","MARYLAND","BALTIMORE CITY",202673,11524,25205,239402
"2016","MARYLAND","CALVERT",18225,3007,26176,47408
"2016","MARYLAND","CAROLINE",4009,736,9368,14113
"2016","MARYLAND","CARROLL",26567,7066,58215,91848
"2016","MARYLAND","CECIL",13650,2751,28868,45269
"2016","MARYLAND","CHARLES",49341,3348,25614,78303
"2016","MARYLAND","DORCHESTER",6245,567,8413,15225
"2016","MARYLAND","FREDERICK",56522,9633,59522,125677
"2016","MARYLAND","GARRETT",2567,668,10776,14011
"2016","MARYLAND","HARFORD",47077,8735,77860,133672
"2016","MARYLAND","HOWARD",102597,12112,47484,162193
"2016","MARYLAND","KENT",4575,570,4876,10021
"2016","MARYLAND","MONTGOMERY",357837,28332,92704,478873
"2016","MARYLAND","PRINCE GEORGE'S",344049,13525,32811,390385
"2016","MARYLAND","QUEEN ANNE'S",7973,1557,16993,26523
"2016","MARYLAND","SOMERSET",4196,363,5341,9900
"2016","MARYLAND","ST. MARY'S",17534,3645,28663,49842
"2016","MARYLAND","TALBOT",8653,1176,10724,20553
"2016","MARYLAND","WASHINGTON",21129,3864,40998,65991
"2016","MARYLAND","WICOMICO",18050,2299,22198,42547
"2016","MARYLAND","WORCESTER",9753,1310,17210,28273
"2016","MASSACHUSETTS","BARNSTABLE",72430,7333,54099,133862
"2016","MASSACHUSETTS","BERKSHIRE",43714,4250,16839,64803
"2016","MASSACHUSETTS","BRISTOL",129540,13976,105443,248959
"2016","MASSACHUSETTS","DUKES",8400,625,2477,11502
"2016","MASSACHUSETTS","ESSEX",222310,21242,136316,379868
"2016","MASSACHUSETTS","FRANKLIN",24478,3335,10364,38177
"2016","MASSACHUSETTS","HAMPDEN",112590,11842,78685,203117
"2016","MASSACHUSETTS","HAMPSHIRE",55367,5799,21790,82956
"2016","MASSACHUSETTS","MIDDLESEX",520360,43881,219793,784034
"2016","MASSACHUSETTS","NANTUCKET",4146,368,1892,6406
"2016","MASSACHUSETTS","NORFOLK",221819,20020,119723,361562
"2016","MASSACHUSETTS","PLYMOUTH",135513,15981,115369,266863
"2016","MASSACHUSETTS","SUFFOLK",245751,12569,50421,308741
"2016","MASSACHUSETTS","WORCESTER",198778,27245,157682,383705
"2016","MICHIGAN","ALCONA",1732,265,4201,6198
"2016","MICHIGAN","ALGER",1663,270,2585,4518
"2016","MICHIGAN","ALLEGAN",18050,3553,34183,55786
"2016","MICHIGAN","ALPENA",4877,731,9090,14698
"2016","MICHIGAN","ANTRIM",4448,665,8469,13582
"2016","MICHIGAN","ARENAC",2384,362,4950,7696
"2016","MICHIGAN","BARAGA",1156,176,2158,3490
"2016","MICHIGAN","BARRY",9114,2013,19202,30329
"2016","MICHIGAN","BAY",21642,3007,28328,52977
"2016","MICHIGAN","BENZIE",4108,581,5539,10228
"2016","MICHIGAN","BERRIEN",29495,3889,38647,72031
"2016","MICHIGAN","BRANCH",5061,816,11786,17663
"2016","MICHIGAN","CALHOUN",24157,3251,31494,58902
"2016","MICHIGAN","CASS",7270,1082,14243,22595
"2016","MICHIGAN","CHARLEVOIX",5137,778,8674,14589
"2016","MICHIGAN","CHEBOYGAN",4302,687,8683,13672
"2016","MICHIGAN","CHIPPEWA",5379,955,9122,15456
"2016","MICHIGAN","CLARE",4249,635,8505,13389
"2016","MICHIGAN","CLINTON",16492,2527,21636,40655
"2016","MICHIGAN","CRAWFORD",2110,380,4354,6844
"2016","MICHIGAN","DELTA",6436,935,11121,18492
"2016","MICHIGAN","DICKINSON",3923,662,8580,13165
"2016","MICHIGAN","EATON",24938,3674,27609,56221
"2016","MICHIGAN","EMMET",6972,1214,10616,18802
"2016","MICHIGAN","GENESEE",102751,9370,84175,196296
"2016","MICHIGAN","GLADWIN",3794,554,8124,12472
"2016","MICHIGAN","GOGEBIC",2925,386,4018,7329
"2016","MICHIGAN","GRAND TRAVERSE",20965,3211,27413,51589
"2016","MICHIGAN","GRATIOT",5666,919,9880,16465
"2016","MICHIGAN","HILLSDALE",4799,1046,14095,19940
"2016","MICHIGAN","HOUGHTON",6018,1131,8475,15624
"2016","MICHIGAN","HURON",4579,646,10692,15917
"2016","MICHIGAN","INGHAM",79110,8160,43868,131138
"2016","MICHIGAN","IONIA",8352,1867,16635,26854
"2016","MICHIGAN","IOSCO",4345,671,8345,13361
"2016","MICHIGAN","IRON",2004,231,3675,5910
"2016","MICHIGAN","ISABELLA",11404,1650,12338,25392
"2016","MICHIGAN","JACKSON",25795,4089,39793,69677
"2016","MICHIGAN","KALAMAZOO",67148,8117,51034,126299
"2016","MICHIGAN","KALKASKA",2280,437,6116,8833
"2016","MICHIGAN","KENT",138683,21321,148180,308184
"2016","MICHIGAN","KEWEENAW",527,93,814,1434
"2016","MICHIGAN","LAKE",1939,230,3159,5328
"2016","MICHIGAN","LAPEER",12734,2412,30037,45183
"2016","MICHIGAN","LEELANAU",6774,744,7239,14757
"2016","MICHIGAN","LENAWEE",16750,2759,26430,45939
"2016","MICHIGAN","LIVINGSTON",34384,5802,65680,105866
"2016","MICHIGAN","LUCE",681,142,1756,2579
"2016","MICHIGAN","MACKINAC",2085,268,3744,6097
"2016","MICHIGAN","MACOMB",176317,18330,224665,419312
"2016","MICHIGAN","MANISTEE",4979,705,6915,12599
"2016","MICHIGAN","MARQUETTE",16042,2288,14646,32976
"2016","MICHIGAN","MASON",5281,899,8505,14685
"2016","MICHIGAN","MECOSTA",5827,1036,10305,17168
"2016","MICHIGAN","MENOMINEE",3539,527,6702,10768
"2016","MICHIGAN","MIDLAND",15635,3025,23846,42506
"2016","MICHIGAN","MISSAUKEE",1565,366,5386,7317
"2016","MICHIGAN","MONROE",26863,4094,43261,74218
"2016","MICHIGAN","MONTCALM",7874,1828,16907,26609
"2016","MICHIGAN","MONTMORENCY",1287,224,3498,5009
"2016","MICHIGAN","MUSKEGON",37304,4657,36127,78088
"2016","MICHIGAN","NEWAYGO",6212,1255,15173,22640
"2016","MICHIGAN","OAKLAND",343070,32341,289203,664614
"2016","MICHIGAN","OCEANA",3973,729,7228,11930
"2016","MICHIGAN","OGEMAW",3030,530,6827,10387
"2016","MICHIGAN","ONTONAGON",1176,184,2066,3426
"2016","MICHIGAN","OSCEOLA",2705,568,7336,10609
"2016","MICHIGAN","OSCODA",1044,186,2843,4073
"2016","MICHIGAN","OTSEGO",3556,716,8266,12538
"2016","MICHIGAN","OTTAWA",44973,9294,88467,142734
"2016","MICHIGAN","PRESQUE ISLE",2400,330,4488,7218
"2016","MICHIGAN","ROSCOMMON",4287,613,8141,13041
"2016","MICHIGAN","SAGINAW",44396,4455,45469,94320
"2016","MICHIGAN","SANILAC",4873,930,13446,19249
"2016","MICHIGAN","SCHOOLCRAFT",1369,229,2556,4154
"2016","MICHIGAN","SHIAWASSEE",12546,2335,19230,34111
"2016","MICHIGAN","ST. CLAIR",24553,4399,49051,78003
"2016","MICHIGAN","ST. JOSEPH",7526,1347,14884,23757
"2016","MICHIGAN","TUSCOLA",7429,1265,17102,25796
"2016","MICHIGAN","VAN BUREN",13258,2126,17890,33274
"2016","MICHIGAN","WASHTENAW",128483,9464,50631,188578
"2016","MICHIGAN","WAYNE",519444,29401,228993,777838
"2016","MICHIGAN","WEXFORD",4436,862,10000,15298
"2016","MINNESOTA","AITKIN",3134,581,5516,9231
"2016","MINNESOTA","ANOKA",75500,16919,93339,185758
"2016","MINNESOTA","BECKER",5208,1134,10880,17222
"2016","MINNESOTA","BELTRAMI",8688,2093,10783,21564
"2016","MINNESOTA","BENTON",5640,1546,12872,20058
"2016","MINNESOTA","BIG STONE",921,226,1608,2755
"2016","MINNESOTA","BLUE EARTH",14428,3498,15667,33593
"2016","MINNESOTA","BROWN",3763,1308,8708,13779
"2016","MINNESOTA","CARLTON",8460,1591,8160,18211
"2016","MINNESOTA","CARVER",21508,5132,29056,55696
"2016","MINNESOTA","CASS",4949,1068,9982,15999
"2016","MINNESOTA","CHIPPEWA",1978,480,3764,6222
"2016","MINNESOTA","CHISAGO",9278,2509,18441,30228
"2016","MINNESOTA","CLAY",12971,2884,13543,29398
"2016","MINNESOTA","CLEARWATER",1100,220,2925,4245
"2016","MINNESOTA","COOK",1912,327,1156,3395
"2016","MINNESOTA","COTTONWOOD",1678,364,3679,5721
"2016","MINNESOTA","CROW WING",10982,2573,22287,35842
"2016","MINNESOTA","DAKOTA",110483,21374,99583,231440
"2016","MINNESOTA","DODGE",3102,1025,6527,10654
"2016","MINNESOTA","DOUGLAS",6227,1592,13966,21785
"2016","MINNESOTA","FARIBAULT",2153,600,4659,7412
"2016","MINNESOTA","FILLMORE",3872,912,6271,11055
"2016","MINNESOTA","FREEBORN",6041,1202,8808,16051
"2016","MINNESOTA","GOODHUE",9446,2230,14041,25717
"2016","MINNESOTA","GRANT",1105,305,2063,3473
"2016","MINNESOTA","HENNEPIN",429288,58919,191770,679977
"2016","MINNESOTA","HOUSTON",4145,843,5616,10604
"2016","MINNESOTA","HUBBARD",3423,821,7261,11505
"2016","MINNESOTA","ISANTI",5657,1724,13635,21016
"2016","MINNESOTA","ITASCA",9015,1945,12920,23880
"2016","MINNESOTA","JACKSON",1492,383,3609,5484
"2016","MINNESOTA","KANABEC",2327,620,5230,8177
"2016","MINNESOTA","KANDIYOHI",7266,1721,12785,21772
"2016","MINNESOTA","KITTSON",823,213,1349,2385
"2016","MINNESOTA","KOOCHICHING",2306,488,3569,6363
"2016","MINNESOTA","LAC QUI PARLE",1305,262,2293,3860
"2016","MINNESOTA","LAKE",3077,512,2932,6521
"2016","MINNESOTA","LAKE OF THE WOODS",553,149,1540,2242
"2016","MINNESOTA","LE SUEUR",4623,1166,9182,14971
"2016","MINNESOTA","LINCOLN",860,228,1931,3019
"2016","MINNESOTA","LYON",3825,1134,7256,12215
"2016","MINNESOTA","MAHNOMEN",930,167,991,2088
"2016","MINNESOTA","MARSHALL",1225,384,3208,4817
"2016","MINNESOTA","MARTIN",2733,736,7062,10531
"2016","MINNESOTA","MCLEOD",4978,1674,12155,18807
"2016","MINNESOTA","MEEKER",3191,987,8104,12282
"2016","MINNESOTA","MILLE LACS",3710,967,8340,13017
"2016","MINNESOTA","MORRISON",3637,1052,12925,17614
"2016","MINNESOTA","MOWER",7437,1455,8823,17715
"2016","MINNESOTA","MURRAY",1295,399,2974,4668
"2016","MINNESOTA","NICOLLET",7886,1774,8437,18097
"2016","MINNESOTA","NOBLES",2733,600,5299,8632
"2016","MINNESOTA","NORMAN",1264,298,1699,3261
"2016","MINNESOTA","OLMSTED",36268,8193,35668,80129
"2016","MINNESOTA","OTTER TAIL",9340,2221,20939,32500
"2016","MINNESOTA","PENNINGTON",2147,568,4000,6715
"2016","MINNESOTA","PINE",4580,1040,8191,13811
"2016","MINNESOTA","PIPESTONE",1127,343,3338,4808
"2016","MINNESOTA","POLK",4712,1105,8979,14796
"2016","MINNESOTA","POPE",2106,420,3793,6319
"2016","MINNESOTA","RAMSEY",177738,24511,70894,273143
"2016","MINNESOTA","RED LAKE",540,200,1141,1881
"2016","MINNESOTA","REDWOOD",1887,587,5137,7611
"2016","MINNESOTA","RENVILLE",2117,599,4890,7606
"2016","MINNESOTA","RICE",14437,2577,15429,32443
"2016","MINNESOTA","ROCK",1373,375,3091,4839
"2016","MINNESOTA","ROSEAU",1856,497,5451,7804
"2016","MINNESOTA","SAINT LOUIS",57771,10021,44630,112422
"2016","MINNESOTA","SCOTT",28502,6579,39948,75029
"2016","MINNESOTA","SHERBURNE",13293,3937,31053,48283
"2016","MINNESOTA","SIBLEY",1954,627,5193,7774
"2016","MINNESOTA","STEARNS",25576,6399,47617,79592
"2016","MINNESOTA","STEELE",6241,1740,11198,19179
"2016","MINNESOTA","STEVENS",2116,483,2799,5398
"2016","MINNESOTA","SWIFT",1686,345,2963,4994
"2016","MINNESOTA","TODD",2783,725,8485,11993
"2016","MINNESOTA","TRAVERSE",630,119,1049,1798
"2016","MINNESOTA","WABASHA",3866,977,6989,11832
"2016","MINNESOTA","WADENA",1684,413,4837,6934
"2016","MINNESOTA","WASECA",2838,848,5967,9653
"2016","MINNESOTA","WASHINGTON",67086,12721,64428,144235
"2016","MINNESOTA","WATONWAN",1814,416,2768,4998
"2016","MINNESOTA","WILKIN",893,280,2129,3302
"2016","MINNESOTA","WINONA",11366,2586,12122,26074
"2016","MINNESOTA","WRIGHT",20334,6010,43274,69618
"2016","MINNESOTA","YELLOW MEDICINE",1524,370,3382,5276
"2016","MISSISSIPPI","ADAMS",7757,205,5874,13836
"2016","MISSISSIPPI","ALCORN",2684,280,11819,14783
"2016","MISSISSIPPI","AMITE",2697,64,4289,7050
"2016","MISSISSIPPI","ATTALA",3242,117,4897,8256
"2016","MISSISSIPPI","BENTON",1719,43,2251,4013
"2016","MISSISSIPPI","BOLIVAR",9046,188,4590,13824
"2016","MISSISSIPPI","CALHOUN",1910,96,4390,6396
"2016","MISSISSIPPI","CARROLL",1680,49,3799,5528
"2016","MISSISSIPPI","CHICKASAW",3649,114,4127,7890
"2016","MISSISSIPPI","CHOCTAW",1218,59,2788,4065
"2016","MISSISSIPPI","CLAIBORNE",3708,24,540,4272
"2016","MISSISSIPPI","CLARKE",2585,69,5137,7791
"2016","MISSISSIPPI","CLAY",5722,131,4150,10003
"2016","MISSISSIPPI","COAHOMA",6378,108,2426,8912
"2016","MISSISSIPPI","COPIAH",6741,138,6103,12982
"2016","MISSISSIPPI","COVINGTON",3276,100,5435,8811
"2016","MISSISSIPPI","DESOTO",20591,2015,43089,65695
"2016","MISSISSIPPI","FORREST",11716,887,15461,28064
"2016","MISSISSIPPI","FRANKLIN",1502,67,2721,4290
"2016","MISSISSIPPI","GEORGE",1027,168,8696,9891
"2016","MISSISSIPPI","GREENE",974,60,4335,5369
"2016","MISSISSIPPI","GRENADA",4424,119,5970,10513
"2016","MISSISSIPPI","HANCOCK",3344,482,13811,17637
"2016","MISSISSIPPI","HARRISON",21169,1790,40354,63313
"2016","MISSISSIPPI","HINDS",67594,1812,25275,94681
"2016","MISSISSIPPI","HOLMES",6689,78,1309,8076
"2016","MISSISSIPPI","HUMPHREYS",3071,31,1151,4253
"2016","MISSISSIPPI","ISSAQUENA",395,6,298,699
"2016","MISSISSIPPI","ITAWAMBA",1117,150,8470,9737
"2016","MISSISSIPPI","JACKSON",14657,1281,33629,49567
"2016","MISSISSIPPI","JASPER",4368,69,4038,8475
"2016","MISSISSIPPI","JEFFERSON",3337,33,490,3860
"2016","MISSISSIPPI","JEFFERSON DAVIS",3720,51,2466,6237
"2016","MISSISSIPPI","JONES",7791,428,20133,28352
"2016","MISSISSIPPI","KEMPER",2827,34,1778,4639
"2016","MISSISSIPPI","LAFAYETTE",7969,802,10872,19643
"2016","MISSISSIPPI","LAMAR",5190,651,18751,24592
"2016","MISSISSIPPI","LAUDERDALE",11269,496,17741,29506
"2016","MISSISSIPPI","LAWRENCE",2195,78,4091,6364
"2016","MISSISSIPPI","LEAKE",3584,83,4782,8449
"2016","MISSISSIPPI","LEE",10029,664,22220,32913
"2016","MISSISSIPPI","LEFLORE",7787,141,3212,11140
"2016","MISSISSIPPI","LINCOLN",4458,185,10550,15193
"2016","MISSISSIPPI","LOWNDES",11819,485,13271,25575
"2016","MISSISSIPPI","MADISON",20343,1194,28265,49802
"2016","MISSISSIPPI","MARION",3677,180,7836,11693
"2016","MISSISSIPPI","MARSHALL",8023,229,6587,14839
"2016","MISSISSIPPI","MONROE",5524,193,10167,15884
"2016","MISSISSIPPI","MONTGOMERY",2115,63,2818,4996
"2016","MISSISSIPPI","NESHOBA",2715,159,7679,10553
"2016","MISSISSIPPI","NEWTON",2756,134,6548,9438
"2016","MISSISSIPPI","NOXUBEE",4347,27,1200,5574
"2016","MISSISSIPPI","OKTIBBEHA",8859,689,8576,18124
"2016","MISSISSIPPI","PANOLA",7431,184,7449,15064
"2016","MISSISSIPPI","PEARL RIVER",3604,497,17782,21883
"2016","MISSISSIPPI","PERRY",1220,77,4135,5432
"2016","MISSISSIPPI","PIKE",8043,258,8009,16310
"2016","MISSISSIPPI","PONTOTOC",2386,262,10336,12984
"2016","MISSISSIPPI","PRENTISS",2067,157,7648,9872
"2016","MISSISSIPPI","QUITMAN",2312,52,1001,3365
"2016","MISSISSIPPI","RANKIN",14110,1480,47178,62768
"2016","MISSISSIPPI","SCOTT",4268,132,6122,10522
"2016","MISSISSIPPI","SHARKEY",1479,19,692,2190
"2016","MISSISSIPPI","SIMPSON",3874,152,7393,11419
"2016","MISSISSIPPI","SMITH",1617,82,5928,7627
"2016","MISSISSIPPI","STONE",1573,166,5306,7045
"2016","MISSISSIPPI","SUNFLOWER",6725,79,2794,9598
"2016","MISSISSIPPI","TALLAHATCHIE",3337,71,2462,5870
"2016","MISSISSIPPI","TATE",3926,206,7495,11627
"2016","MISSISSIPPI","TIPPAH",1842,153,7240,9235
"2016","MISSISSIPPI","TISHOMINGO",999,206,7166,8371
"2016","MISSISSIPPI","TUNICA",2667,47,853,3567
"2016","MISSISSIPPI","UNION",2012,249,9235,11496
"2016","MISSISSIPPI","WALTHALL",2790,73,4056,6919
"2016","MISSISSIPPI","WARREN",9284,365,9767,19416
"2016","MISSISSIPPI","WASHINGTON",11380,201,5244,16825
"2016","MISSISSIPPI","WAYNE",3524,85,5990,9599
"2016","MISSISSIPPI","WEBSTER",1019,74,3976,5069
"2016","MISSISSIPPI","WILKINSON",2857,43,1318,4218
"2016","MISSISSIPPI","WINSTON",3850,121,4910,8881
"2016","MISSISSIPPI","YALOBUSHA",2582,119,3376,6077
"2016","MISSISSIPPI","YAZOO",5369,103,4598,10070
"2016","MISSOURI","ADAIR",3500,696,6030,10226
"2016","MISSOURI","ANDREW",2045,430,6665,9140
"2016","MISSOURI","ATCHISON",541,123,2060,2724
"2016","MISSOURI","AUDRAIN",2570,510,6981,10061
"2016","MISSOURI","BARRY",2710,467,11428,14605
"2016","MISSOURI","BARTON",795,185,4959,5939
"2016","MISSOURI","BATES",1618,404,6001,8023
"2016","MISSOURI","BENTON",2025,74,7213,9312
"2016","MISSOURI","BOLLINGER",705,144,4827,5676
"2016","MISSOURI","BOONE",41125,6543,36200,83868
"2016","MISSOURI","BUCHANAN",12013,2326,21320,35659
"2016","MISSOURI","BUTLER",3036,573,13650,17259
"2016","MISSOURI","CALDWELL",838,242,3232,4312
"2016","MISSOURI","CALLAWAY",4989,1147,13057,19193
"2016","MISSOURI","CAMDEN",4768,802,16944,22514
"2016","MISSOURI","CAPE GIRARDEAU",8492,1529,27017,37038
"2016","MISSOURI","CARROLL",745,136,3480,4361
"2016","MISSOURI","CARTER",436,84,2324,2844
"2016","MISSOURI","CASS",14846,3046,33098,50990
"2016","MISSOURI","CEDAR",1011,256,5021,6288
"2016","MISSOURI","CHARITON",888,131,2950,3969
"2016","MISSOURI","CHRISTIAN",8508,2077,30946,41531
"2016","MISSOURI","CLARK",724,33,2458,3215
"2016","MISSOURI","CLAY",45304,7396,57476,110176
"2016","MISSOURI","CLINTON",2572,569,7067,10208
"2016","MISSOURI","COLE",10913,1845,24616,37374
"2016","MISSOURI","COOPER",1932,430,5624,7986
"2016","MISSOURI","CRAWFORD",1824,148,7724,9696
"2016","MISSOURI","DADE",637,130,3184,3951
"2016","MISSOURI","DALLAS",1272,286,5895,7453
"2016","MISSOURI","DAVIESS",730,96,2767,3593
"2016","MISSOURI","DEKALB",824,230,3540,4594
"2016","MISSOURI","DENT",978,213,5600,6791
"2016","MISSOURI","DOUGLAS",984,196,5486,6666
"2016","MISSOURI","DUNKLIN",2360,192,8026,10578
"2016","MISSOURI","FRANKLIN",12341,2342,35430,50113
"2016","MISSOURI","GASCONADE",1520,255,5670,7445
"2016","MISSOURI","GENTRY",605,134,2304,3043
"2016","MISSOURI","GREENE",42728,8468,78035,129231
"2016","MISSOURI","GRUNDY",780,68,3462,4310
"2016","MISSOURI","HARRISON",574,150,2965,3689
"2016","MISSOURI","HENRY",2357,434,7075,9866
"2016","MISSOURI","HICKORY",1016,166,3542,4724
"2016","MISSOURI","HOLT",347,82,1926,2355
"2016","MISSOURI","HOWARD",1283,308,3277,4868
"2016","MISSOURI","HOWELL",2881,681,13893,17455
"2016","MISSOURI","IRON",933,163,3173,4269
"2016","MISSOURI","JACKSON",71237,10481,91557,173275
"2016","MISSOURI","JASPER",10572,2684,35070,48326
"2016","MISSOURI","JEFFERSON",31568,5634,69036,106238
"2016","MISSOURI","JOHNSON",5930,1483,13719,21132
"2016","MISSOURI","KANSAS CITY",97735,6212,24654,128601
"2016","MISSOURI","KNOX",379,75,1416,1870
"2016","MISSOURI","LACLEDE",2553,617,12881,16051
"2016","MISSOURI","LAFAYETTE",4053,835,10988,15876
"2016","MISSOURI","LAWRENCE",2901,725,13089,16715
"2016","MISSOURI","LEWIS",934,178,3344,4456
"2016","MISSOURI","LINCOLN",5575,1228,18159,24962
"2016","MISSOURI","LINN",1240,259,4088,5587
"2016","MISSOURI","LIVINGSTON",1265,277,4879,6421
"2016","MISSOURI","MACON",1548,275,5798,7621
"2016","MISSOURI","MADISON",1005,214,4102,5321
"2016","MISSOURI","MARIES",794,145,3561,4500
"2016","MISSOURI","MARION",2994,525,9419,12938
"2016","MISSOURI","MCDONALD",1329,314,6599,8242
"2016","MISSOURI","MERCER",216,43,1486,1745
"2016","MISSOURI","MILLER",1750,381,9285,11416
"2016","MISSOURI","MISSISSIPPI",1458,111,3600,5169
"2016","MISSOURI","MONITEAU",1237,246,5347,6830
"2016","MISSOURI","MONROE",853,144,3159,4156
"2016","MISSOURI","MONTGOMERY",1119,183,4127,5429
"2016","MISSOURI","MORGAN",1768,293,6760,8821
"2016","MISSOURI","NEW MADRID",1933,154,5270,7357
"2016","MISSOURI","NEWTON",4990,1063,20553,26606
"2016","MISSOURI","NODAWAY",2529,549,6380,9458
"2016","MISSOURI","OREGON",865,132,3671,4668
"2016","MISSOURI","OSAGE",998,236,5856,7090
"2016","MISSOURI","OZARK",724,142,3639,4505
"2016","MISSOURI","PEMISCOT",1947,116,3964,6027
"2016","MISSOURI","PERRY",1520,312,6908,8740
"2016","MISSOURI","PETTIS",4324,977,12810,18111
"2016","MISSOURI","PHELPS",4766,1078,12709,18553
"2016","MISSOURI","PIKE",1806,302,5274,7382
"2016","MISSOURI","PLATTE",20057,2895,25933,48885
"2016","MISSOURI","POLK",2631,694,10438,13763
"2016","MISSOURI","PULASKI",2922,690,9876,13488
"2016","MISSOURI","PUTNAM",353,57,1936,2346
"2016","MISSOURI","RALLS",1138,159,3969,5266
"2016","MISSOURI","RANDOLPH",2283,497,7529,10309
"2016","MISSOURI","RAY",3090,675,7104,10869
"2016","MISSOURI","REYNOLDS",540,92,2406,3038
"2016","MISSOURI","RIPLEY",830,172,4522,5524
"2016","MISSOURI","SALINE",2789,508,5977,9274
"2016","MISSOURI","SCHUYLER",354,77,1505,1936
"2016","MISSOURI","SCOTLAND",365,78,1525,1968
"2016","MISSOURI","SCOTT",3575,513,13168,17256
"2016","MISSOURI","SHANNON",776,162,2966,3904
"2016","MISSOURI","SHELBY",606,125,2524,3255
"2016","MISSOURI","ST. CHARLES",68626,10729,121650,201005
"2016","MISSOURI","ST. CLAIR",936,193,3501,4630
"2016","MISSOURI","ST. FRANCOIS",6250,1010,17468,24728
"2016","MISSOURI","ST. LOUIS CITY",104235,6124,20832,131191
"2016","MISSOURI","ST. LOUIS COUNTY",286704,25720,202434,514858
"2016","MISSOURI","STE. GENEVIEVE",2542,431,5496,8469
"2016","MISSOURI","STODDARD",1876,336,11079,13291
"2016","MISSOURI","STONE",2887,522,13158,16567
"2016","MISSOURI","SULLIVAN",526,76,1884,2486
"2016","MISSOURI","TANEY",4373,866,18276,23515
"2016","MISSOURI","TEXAS",1728,353,8875,10956
"2016","MISSOURI","VERNON",1707,359,6533,8599
"2016","MISSOURI","WARREN",3915,758,11111,15784
"2016","MISSOURI","WASHINGTON",1926,308,7048,9282
"2016","MISSOURI","WAYNE",948,49,4658,5655
"2016","MISSOURI","WEBSTER",3177,726,12840,16743
"2016","MISSOURI","WORTH",195,43,808,1046
"2016","MISSOURI","WRIGHT",1170,242,6707,8119
"2016","MONTANA","BEAVERHEAD",1143,353,3353,4849
"2016","MONTANA","BIG HORN",2094,290,1853,4237
"2016","MONTANA","BLAINE",1202,214,1268,2684
"2016","MONTANA","BROADWATER",573,212,2348,3133
"2016","MONTANA","CARBON",1828,415,3748,5991
"2016","MONTANA","CARTER",70,38,678,786
"2016","MONTANA","CASCADE",12175,2764,19632,34571
"2016","MONTANA","CHOUTEAU",732,192,1679,2603
"2016","MONTANA","CUSTER",1176,352,3657,5185
"2016","MONTANA","DANIELS",168,64,730,962
"2016","MONTANA","DAWSON",787,267,3320,4374
"2016","MONTANA","DEER LODGE",2058,385,1763,4206
"2016","MONTANA","FALLON",154,51,1279,1484
"2016","MONTANA","FERGUS",1202,369,4269,5840
"2016","MONTANA","FLATHEAD",13293,3038,30240,46571
"2016","MONTANA","GALLATIN",24246,5771,23802,53819
"2016","MONTANA","GARFIELD",34,31,653,718
"2016","MONTANA","GLACIER",3121,334,1620,5075
"2016","MONTANA","GOLDEN VALLEY",71,38,365,474
"2016","MONTANA","GRANITE",472,113,1192,1777
"2016","MONTANA","HILL",2371,596,3478,6445
"2016","MONTANA","JEFFERSON",1998,539,4177,6714
"2016","MONTANA","JUDITH BASIN",235,101,872,1208
"2016","MONTANA","LAKE",4776,875,7530,13181
"2016","MONTANA","LEWIS AND CLARK",14478,3105,16895,34478
"2016","MONTANA","LIBERTY",206,57,698,961
"2016","MONTANA","LINCOLN",2041,560,6729,9330
"2016","MONTANA","MADISON",1180,301,3297,4778
"2016","MONTANA","MCCONE",154,44,862,1060
"2016","MONTANA","MEAGHER",193,55,729,977
"2016","MONTANA","MINERAL",519,163,1330,2012
"2016","MONTANA","MISSOULA",31543,5410,22250,59203
"2016","MONTANA","MUSSELSHELL",332,142,1967,2441
"2016","MONTANA","PARK",3595,784,4980,9359
"2016","MONTANA","PETROLEUM",30,14,278,322
"2016","MONTANA","PHILLIPS",318,130,1723,2171
"2016","MONTANA","PONDERA",738,186,1799,2723
"2016","MONTANA","POWDER RIVER",127,42,884,1053
"2016","MONTANA","POWELL",551,214,2029,2794
"2016","MONTANA","PRAIRIE",100,33,556,689
"2016","MONTANA","RAVALLI",6223,1523,14810,22556
"2016","MONTANA","RICHLAND",671,292,3908,4871
"2016","MONTANA","ROOSEVELT",1560,295,1797,3652
"2016","MONTANA","ROSEBUD",987,213,2253,3453
"2016","MONTANA","SANDERS",1218,449,4286,5953
"2016","MONTANA","SHERIDAN",477,117,1241,1835
"2016","MONTANA","SILVER BOW",8619,1457,6376,16452
"2016","MONTANA","STILLWATER",908,304,3661,4873
"2016","MONTANA","SWEET GRASS",402,110,1595,2107
"2016","MONTANA","TETON",808,210,2170,3188
"2016","MONTANA","TOOLE",402,138,1497,2037
"2016","MONTANA","TREASURE",59,33,351,443
"2016","MONTANA","VALLEY",886,310,2698,3894
"2016","MONTANA","WHEATLAND",179,65,702,946
"2016","MONTANA","WIBAUX",55,23,463,541
"2016","MONTANA","YELLOWSTONE",22171,6017,40920,69108
"2016","NEBRASKA","ADAMS",3302,924,9287,13513
"2016","NEBRASKA","ANTELOPE",383,166,2732,3281
"2016","NEBRASKA","ARTHUR",17,12,244,273
"2016","NEBRASKA","BANNER",19,26,357,402
"2016","NEBRASKA","BLAINE",30,11,276,317
"2016","NEBRASKA","BOONE",414,192,2299,2905
"2016","NEBRASKA","BOX BUTTE",965,342,3617,4924
"2016","NEBRASKA","BOYD",128,45,983,1156
"2016","NEBRASKA","BROWN",153,59,1385,1597
"2016","NEBRASKA","BUFFALO",4763,1797,14569,21129
"2016","NEBRASKA","BURT",930,261,2367,3558
"2016","NEBRASKA","BUTLER",691,211,3079,3981
"2016","NEBRASKA","CASS",3484,997,8452,12933
"2016","NEBRASKA","CEDAR",571,317,3532,4420
"2016","NEBRASKA","CHASE",171,79,1648,1898
"2016","NEBRASKA","CHERRY",317,178,2623,3118
"2016","NEBRASKA","CHEYENNE",711,335,3665,4711
"2016","NEBRASKA","CLAY",477,166,2422,3065
"2016","NEBRASKA","COLFAX",859,184,2171,3214
"2016","NEBRASKA","CUMING",719,233,3122,4074
"2016","NEBRASKA","CUSTER",641,316,4695,5652
"2016","NEBRASKA","DAKOTA",2314,349,3616,6279
"2016","NEBRASKA","DAWES",801,243,2632,3676
"2016","NEBRASKA","DAWSON",2136,515,5984,8635
"2016","NEBRASKA","DEUEL",120,55,809,984
"2016","NEBRASKA","DIXON",556,185,2041,2782
"2016","NEBRASKA","DODGE",4544,1052,9933,15529
"2016","NEBRASKA","DOUGLAS",113798,18558,108077,240433
"2016","NEBRASKA","DUNDY",89,41,823,953
"2016","NEBRASKA","FILLMORE",613,198,2130,2941
"2016","NEBRASKA","FRANKLIN",250,76,1347,1673
"2016","NEBRASKA","FRONTIER",161,57,1110,1328
"2016","NEBRASKA","FURNAS",304,115,1921,2340
"2016","NEBRASKA","GAGE",2935,733,6380,10048
"2016","NEBRASKA","GARDEN",153,53,869,1075
"2016","NEBRASKA","GARFIELD",121,38,821,980
"2016","NEBRASKA","GOSPER",166,50,794,1010
"2016","NEBRASKA","GRANT",20,18,367,405
"2016","NEBRASKA","GREELEY",210,53,912,1175
"2016","NEBRASKA","HALL",6282,1370,14408,22060
"2016","NEBRASKA","HAMILTON",878,343,3783,5004
"2016","NEBRASKA","HARLAN",254,82,1496,1832
"2016","NEBRASKA","HAYES",30,12,472,514
"2016","NEBRASKA","HITCHCOCK",161,75,1232,1468
"2016","NEBRASKA","HOLT",531,233,4354,5118
"2016","NEBRASKA","HOOKER",40,22,355,417
"2016","NEBRASKA","HOWARD",544,166,2284,2994
"2016","NEBRASKA","JEFFERSON",837,258,2399,3494
"2016","NEBRASKA","JOHNSON",563,171,1355,2089
"2016","NEBRASKA","KEARNEY",550,215,2531,3296
"2016","NEBRASKA","KEITH",571,228,3235,4034
"2016","NEBRASKA","KEYA PAHA",40,19,460,519
"2016","NEBRASKA","KIMBALL",230,117,1330,1677
"2016","NEBRASKA","KNOX",720,207,3188,4115
"2016","NEBRASKA","LANCASTER",61898,12737,61588,136223
"2016","NEBRASKA","LINCOLN",2913,1054,12164,16131
"2016","NEBRASKA","LOGAN",32,21,400,453
"2016","NEBRASKA","LOUP",48,14,323,385
"2016","NEBRASKA","MADISON",2711,1004,10628,14343
"2016","NEBRASKA","MCPHERSON",14,16,257,287
"2016","NEBRASKA","MERRICK",602,260,2926,3788
"2016","NEBRASKA","MORRILL",284,123,1802,2209
"2016","NEBRASKA","NANCE",281,79,1261,1621
"2016","NEBRASKA","NEMAHA",785,260,2116,3161
"2016","NEBRASKA","NUCKOLLS",353,126,1726,2205
"2016","NEBRASKA","OTOE",2025,572,4860,7457
"2016","NEBRASKA","PAWNEE",279,74,974,1327
"2016","NEBRASKA","PERKINS",161,77,1217,1455
"2016","NEBRASKA","PHELPS",572,274,3849,4695
"2016","NEBRASKA","PIERCE",382,196,3052,3630
"2016","NEBRASKA","PLATTE",2646,822,10965,14433
"2016","NEBRASKA","POLK",413,141,2028,2582
"2016","NEBRASKA","RED WILLOW",645,267,4258,5170
"2016","NEBRASKA","RICHARDSON",818,218,2769,3805
"2016","NEBRASKA","ROCK",70,41,687,798
"2016","NEBRASKA","SALINE",1733,399,3004,5136
"2016","NEBRASKA","SARPY",28033,7404,45143,80580
"2016","NEBRASKA","SAUNDERS",2523,782,7555,10860
"2016","NEBRASKA","SCOTTS BLUFF",3207,1034,10076,14317
"2016","NEBRASKA","SEWARD",1875,593,5454,7922
"2016","NEBRASKA","SHERIDAN",287,110,2211,2608
"2016","NEBRASKA","SHERMAN",340,83,1150,1573
"2016","NEBRASKA","SIOUX",81,39,616,736
"2016","NEBRASKA","STANTON",417,197,2187,2801
"2016","NEBRASKA","THAYER",499,140,2051,2690
"2016","NEBRASKA","THOMAS",30,19,344,393
"2016","NEBRASKA","THURSTON",919,126,1043,2088
"2016","NEBRASKA","VALLEY",339,86,1780,2205
"2016","NEBRASKA","WASHINGTON",2623,785,7424,10832
"2016","NEBRASKA","WAYNE",835,248,2693,3776
"2016","NEBRASKA","WEBSTER",306,72,1330,1708
"2016","NEBRASKA","WHEELER",62,26,377,465
"2016","NEBRASKA","YORK",1186,495,4700,6381
"2016","NEVADA","CARSON CITY",9610,2281,13125,25016
"2016","NEVADA","CHURCHILL",2210,898,7830,10938
"2016","NEVADA","CLARK",402227,44872,320057,767156
"2016","NEVADA","DOUGLAS",8454,2016,17415,27885
"2016","NEVADA","ELKO",3401,1607,13551,18559
"2016","NEVADA","ESMERALDA",65,29,329,423
"2016","NEVADA","EUREKA",74,57,723,854
"2016","NEVADA","HUMBOLDT",1386,526,4521,6433
"2016","NEVADA","LANDER",403,182,1828,2413
"2016","NEVADA","LINCOLN",285,176,1671,2132
"2016","NEVADA","LYON",6146,1611,16005,23762
"2016","NEVADA","MINERAL",637,181,1179,1997
"2016","NEVADA","NYE",5094,1177,13324,19595
"2016","NEVADA","PERSHING",430,149,1403,1982
"2016","NEVADA","STOREY",752,190,1616,2558
"2016","NEVADA","WASHOE",97379,17772,94758,209909
"2016","NEVADA","WHITE PINE",707,343,2723,3773
"2016","NEW HAMPSHIRE","BELKNAP",13517,2213,19315,35045
"2016","NEW HAMPSHIRE","CARROLL",12987,1994,14635,29616
"2016","NEW HAMPSHIRE","CHESHIRE",22064,2955,16876,41895
"2016","NEW HAMPSHIRE","COOS",6563,1112,7952,15627
"2016","NEW HAMPSHIRE","GRAFTON",28510,3671,19010,51191
"2016","NEW HAMPSHIRE","HILLSBOROUGH",99589,14555,100013,214157
"2016","NEW HAMPSHIRE","MERRIMACK",40198,5776,37674,83648
"2016","NEW HAMPSHIRE","ROCKINGHAM",79994,10993,90447,181434
"2016","NEW HAMPSHIRE","STRAFFORD",34894,5034,29072,69000
"2016","NEW HAMPSHIRE","SULLIVAN",10210,1677,10796,22683
"2016","NEW JERSEY","ATLANTIC",60924,3677,52690,117291
"2016","NEW JERSEY","BERGEN",231211,12556,175529,419296
"2016","NEW JERSEY","BURLINGTON",121725,7946,89272,218943
"2016","NEW JERSEY","CAMDEN",146717,7244,72631,226592
"2016","NEW JERSEY","CAPE MAY",18750,1526,28446,48722
"2016","NEW JERSEY","CUMBERLAND",27771,1780,24453,54004
"2016","NEW JERSEY","ESSEX",240837,6921,63176,310934
"2016","NEW JERSEY","GLOUCESTER",66870,5128,67544,139542
"2016","NEW JERSEY","HUDSON",163917,6415,49043,219375
"2016","NEW JERSEY","HUNTERDON",28898,3226,38712,70836
"2016","NEW JERSEY","MERCER",104775,5561,46193,156529
"2016","NEW JERSEY","MIDDLESEX",193044,10105,122953,326102
"2016","NEW JERSEY","MONMOUTH",137181,10473,166723,314377
"2016","NEW JERSEY","MORRIS",115249,9096,126071,250416
"2016","NEW JERSEY","OCEAN",87150,8133,179079,274362
"2016","NEW JERSEY","PASSAIC",116759,5141,72902,194802
"2016","NEW JERSEY","SALEM",11904,1209,16381,29494
"2016","NEW JERSEY","SOMERSET",85689,5898,65505,157092
"2016","NEW JERSEY","SUSSEX",24212,3256,46658,74126
"2016","NEW JERSEY","UNION",147414,6447,68114,221975
"2016","NEW JERSEY","WARREN",17281,2097,29858,49236
"2016","NEW MEXICO","BERNALILLO",143417,36547,94698,274662
"2016","NEW MEXICO","CATRON",427,158,1464,2049
"2016","NEW MEXICO","CHAVES",5534,1865,12872,20271
"2016","NEW MEXICO","CIBOLA",3741,1127,3195,8063
"2016","NEW MEXICO","COLFAX",2129,618,2585,5332
"2016","NEW MEXICO","CURRY",3121,1214,9035,13370
"2016","NEW MEXICO","DE BACA",193,97,620,910
"2016","NEW MEXICO","DONA ANA",37947,7327,25374,70648
"2016","NEW MEXICO","EDDY",5033,1487,13147,19667
"2016","NEW MEXICO","GRANT",6276,1247,5288,12811
"2016","NEW MEXICO","GUADALUPE",970,262,595,1827
"2016","NEW MEXICO","HARDING",156,60,311,527
"2016","NEW MEXICO","HIDALGO",784,178,910,1872
"2016","NEW MEXICO","LEA",3930,1287,12495,17712
"2016","NEW MEXICO","LINCOLN",2331,675,5896,8902
"2016","NEW MEXICO","LOS ALAMOS",5562,1964,3359,10885
"2016","NEW MEXICO","LUNA",3195,622,3478,7295
"2016","NEW MEXICO","MCKINLEY",13576,3023,5104,21703
"2016","NEW MEXICO","MORA",1536,240,665,2441
"2016","NEW MEXICO","OTERO",6124,2049,11887,20060
"2016","NEW MEXICO","QUAY",1017,343,2212,3572
"2016","NEW MEXICO","RIO ARRIBA",9592,1687,3599,14878
"2016","NEW MEXICO","ROOSEVELT",1454,612,3884,5950
"2016","NEW MEXICO","SAN JUAN",12865,5299,27946,46110
"2016","NEW MEXICO","SAN MIGUEL",7285,1153,2313,10751
"2016","NEW MEXICO","SANDOVAL",27707,8078,25905,61690
"2016","NEW MEXICO","SANTA FE",50793,6309,14332,71434
"2016","NEW MEXICO","SIERRA",1612,559,3010,5181
"2016","NEW MEXICO","SOCORRO",3313,939,2616,6868
"2016","NEW MEXICO","TAOS",10668,1865,2727,15260
"2016","NEW MEXICO","TORRANCE",1785,825,3714,6324
"2016","NEW MEXICO","UNION",320,166,1216,1702
"2016","NEW MEXICO","VALENCIA",10841,3536,13215,27592
"2016","NEW YORK","ALBANY",83077,8943,47810,139830
"2016","NEW YORK","ALLEGANY",4882,1285,12525,18692
"2016","NEW YORK","BRONX",353646,8079,37797,399522
"2016","NEW YORK","BROOME",39212,5917,40943,86072
"2016","NEW YORK","CATTARAUGUS",9497,1972,19692,31161
"2016","NEW YORK","CAYUGA",13522,2266,17384,33172
"2016","NEW YORK","CHAUTAUQUA",19091,3549,31594,54234
"2016","NEW YORK","CHEMUNG",13757,2265,20097,36119
"2016","NEW YORK","CHENANGO",6775,1464,11921,20160
"2016","NEW YORK","CLINTON",15059,2597,14449,32105
"2016","NEW YORK","COLUMBIA",15284,1862,13756,30902
"2016","NEW YORK","CORTLAND",8771,1573,9900,20244
"2016","NEW YORK","DELAWARE",6627,1223,11942,19792
"2016","NEW YORK","DUTCHESS",62261,6876,61797,130934
"2016","NEW YORK","ERIE",215456,19866,188303,423625
"2016","NEW YORK","ESSEX",7762,1498,7958,17218
"2016","NEW YORK","FRANKLIN",7297,1434,8221,16952
"2016","NEW YORK","FULTON",6496,1256,13462,21214
"2016","NEW YORK","GENESEE",7650,1867,16915,26432
"2016","NEW YORK","GREENE",7405,1572,13073,22050
"2016","NEW YORK","HAMILTON",949,212,2064,3225
"2016","NEW YORK","HERKIMER",8083,1473,16699,26255
"2016","NEW YORK","JEFFERSON",13809,2664,21763,38236
"2016","NEW YORK","KINGS",640553,24008,141044,805605
"2016","NEW YORK","LEWIS",3146,779,7400,11325
"2016","NEW YORK","LIVINGSTON",10697,2044,17290,30031
"2016","NEW YORK","MADISON",11667,2461,15936,30064
"2016","NEW YORK","MONROE",188592,22616,136582,347790
"2016","NEW YORK","MONTGOMERY",6595,1158,11301,19054
"2016","NEW YORK","NASSAU",326088,22566,288313,636967
"2016","NEW YORK","NEW YORK",579013,24997,64929,668939
"2016","NEW YORK","NIAGARA",35559,4882,51961,92402
"2016","NEW YORK","ONEIDA",33743,5829,51437,91009
"2016","NEW YORK","ONONDAGA",112337,12454,83649,208440
"2016","NEW YORK","ONTARIO",22233,3996,26029,52258
"2016","NEW YORK","ORANGE",68278,7098,76645,152021
"2016","NEW YORK","ORLEANS",4470,974,10936,16380
"2016","NEW YORK","OSWEGO",17095,3397,27688,48180
"2016","NEW YORK","OTSEGO",10451,1909,13308,25668
"2016","NEW YORK","PUTNAM",19366,2173,27024,48563
"2016","NEW YORK","QUEENS",517220,19832,149341,686393
"2016","NEW YORK","RENSSELAER",32717,5119,33726,71562
"2016","NEW YORK","RICHMOND",74143,5380,101437,180960
"2016","NEW YORK","ROCKLAND",69342,4834,60911,135087
"2016","NEW YORK","SARATOGA",50913,8606,54575,114094
"2016","NEW YORK","SCHENECTADY",33747,4580,28953,67280
"2016","NEW YORK","SCHOHARIE",4240,979,8831,14050
"2016","NEW YORK","SCHUYLER",3091,631,5050,8772
"2016","NEW YORK","SENECA",5697,1047,7236,13980
"2016","NEW YORK","ST. LAWRENCE",16488,2728,19942,39158
"2016","NEW YORK","STEUBEN",12526,2645,26831,42002
"2016","NEW YORK","SUFFOLK",303951,26733,350570,681254
"2016","NEW YORK","SULLIVAN",12568,1456,15931,29955
"2016","NEW YORK","TIOGA",7526,1513,13260,22299
"2016","NEW YORK","TOMPKINS",28890,3417,10371,42678
"2016","NEW YORK","ULSTER",42101,5248,34006,81355
"2016","NEW YORK","WARREN",13091,2566,15751,31408
"2016","NEW YORK","WASHINGTON",9098,1820,13610,24528
"2016","NEW YORK","WAYNE",13473,2834,23380,39687
"2016","NEW YORK","WESTCHESTER",272926,16491,131238,420655
"2016","NEW YORK","WYOMING",3904,952,12442,17298
"2016","NEW YORK","YATES",3659,747,5660,10066
"2016","NORTH CAROLINA","ALAMANCE",29833,2509,38815,71157
"2016","NORTH CAROLINA","ALEXANDER",3767,611,13893,18271
"2016","NORTH CAROLINA","ALLEGHANY",1306,195,3814,5315
"2016","NORTH CAROLINA","ANSON",5859,180,4506,10545
"2016","NORTH CAROLINA","ASHE",3500,512,9412,13424
"2016","NORTH CAROLINA","AVERY",1689,262,6298,8249
"2016","NORTH CAROLINA","BEAUFORT",8764,631,14543,23938
"2016","NORTH CAROLINA","BERTIE",5778,113,3456,9347
"2016","NORTH CAROLINA","BLADEN",7058,289,8550,15897
"2016","NORTH CAROLINA","BRUNSWICK",23282,2349,42720,68351
"2016","NORTH CAROLINA","BUNCOMBE",75452,7779,55716,138947
"2016","NORTH CAROLINA","BURKE",11251,1431,26238,38920
"2016","NORTH CAROLINA","CABARRUS",35521,3949,53819,93289
"2016","NORTH CAROLINA","CALDWELL",8425,1274,26621,36320
"2016","NORTH CAROLINA","CAMDEN",1274,186,3546,5006
"2016","NORTH CAROLINA","CARTERET",9939,1273,26569,37781
"2016","NORTH CAROLINA","CASWELL",4792,252,6026,11070
"2016","NORTH CAROLINA","CATAWBA",21216,2811,48324,72351
"2016","NORTH CAROLINA","CHATHAM",21065,1679,17105,39849
"2016","NORTH CAROLINA","CHEROKEE",2860,477,10844,14181
"2016","NORTH CAROLINA","CHOWAN",2992,222,4014,7228
"2016","NORTH CAROLINA","CLAY",1367,206,4437,6010
"2016","NORTH CAROLINA","CLEVELAND",14964,1230,28479,44673
"2016","NORTH CAROLINA","COLUMBUS",9063,397,14272,23732
"2016","NORTH CAROLINA","CRAVEN",17630,1640,27731,47001
"2016","NORTH CAROLINA","CUMBERLAND",71605,4636,51265,127506
"2016","NORTH CAROLINA","CURRITUCK",2913,593,9163,12669
"2016","NORTH CAROLINA","DARE",7222,927,11460,19609
"2016","NORTH CAROLINA","DAVIDSON",18109,2430,54317,74856
"2016","NORTH CAROLINA","DAVIE",5270,884,15602,21756
"2016","NORTH CAROLINA","DUPLIN",8283,356,12217,20856
"2016","NORTH CAROLINA","DURHAM",121250,6534,28350,156134
"2016","NORTH CAROLINA","EDGECOMBE",16224,401,8261,24886
"2016","NORTH CAROLINA","FORSYTH",94464,7873,75975,178312
"2016","NORTH CAROLINA","FRANKLIN",12874,1126,16368,30368
"2016","NORTH CAROLINA","GASTON",31177,3456,61798,96431
"2016","NORTH CAROLINA","GATES",2385,133,2874,5392
"2016","NORTH CAROLINA","GRAHAM",768,117,3283,4168
"2016","NORTH CAROLINA","GRANVILLE",12909,853,13591,27353
"2016","NORTH CAROLINA","GREENE",3605,116,4374,8095
"2016","NORTH CAROLINA","GUILFORD",149248,10095,98062,257405
"2016","NORTH CAROLINA","HALIFAX",15748,388,9031,25167
"2016","NORTH CAROLINA","HARNETT",16737,1714,27614,46065
"2016","NORTH CAROLINA","HAYWOOD",10473,1325,18929,30727
"2016","NORTH CAROLINA","HENDERSON",19827,2540,35809,58176
"2016","NORTH CAROLINA","HERTFORD",6910,177,3099,10186
"2016","NORTH CAROLINA","HOKE",9726,744,7760,18230
"2016","NORTH CAROLINA","HYDE",965,51,1288,2304
"2016","NORTH CAROLINA","IREDELL",24734,3079,54754,82567
"2016","NORTH CAROLINA","JACKSON",7713,1130,9870,18713
"2016","NORTH CAROLINA","JOHNSTON",28362,3175,54372,85909
"2016","NORTH CAROLINA","JONES",2065,96,2974,5135
"2016","NORTH CAROLINA","LEE",10469,903,13712,25084
"2016","NORTH CAROLINA","LENOIR",12634,560,13613,26807
"2016","NORTH CAROLINA","LINCOLN",9897,1320,28806,40023
"2016","NORTH CAROLINA","MACON",4876,731,12127,17734
"2016","NORTH CAROLINA","MADISON",3926,560,6783,11269
"2016","NORTH CAROLINA","MARTIN",5846,221,5897,11964
"2016","NORTH CAROLINA","MCDOWELL",4667,640,14568,19875
"2016","NORTH CAROLINA","MECKLENBURG",294562,22777,155518,472857
"2016","NORTH CAROLINA","MITCHELL",1596,218,6282,8096
"2016","NORTH CAROLINA","MONTGOMERY",4150,260,7130,11540
"2016","NORTH CAROLINA","MOORE",16329,1873,30490,48692
"2016","NORTH CAROLINA","NASH",23235,1111,23319,47665
"2016","NORTH CAROLINA","NEW HANOVER",50979,5582,55344,111905
"2016","NORTH CAROLINA","NORTHAMPTON",6144,122,3582,9848
"2016","NORTH CAROLINA","ONSLOW",17514,2499,37122,57135
"2016","NORTH CAROLINA","ORANGE",59923,3860,18557,82340
"2016","NORTH CAROLINA","PAMLICO",2448,164,4258,6870
"2016","NORTH CAROLINA","PASQUOTANK",8615,596,8180,17391
"2016","NORTH CAROLINA","PENDER",9354,892,17639,27885
"2016","NORTH CAROLINA","PERQUIMANS",2319,212,4177,6708
"2016","NORTH CAROLINA","PERSON",7833,597,11185,19615
"2016","NORTH CAROLINA","PITT",41824,3012,35691,80527
"2016","NORTH CAROLINA","POLK",3735,431,6768,10934
"2016","NORTH CAROLINA","RANDOLPH",13194,1951,49430,64575
"2016","NORTH CAROLINA","RICHMOND",8501,444,10383,19328
"2016","NORTH CAROLINA","ROBESON",19016,1080,20762,40858
"2016","NORTH CAROLINA","ROCKINGHAM",14228,1220,26830,42278
"2016","NORTH CAROLINA","ROWAN",19400,2159,42810,64369
"2016","NORTH CAROLINA","RUTHERFORD",7512,924,21871,30307
"2016","NORTH CAROLINA","SAMPSON",10547,543,14838,25928
"2016","NORTH CAROLINA","SCOTLAND",7319,353,6256,13928
"2016","NORTH CAROLINA","STANLY",7094,859,21964,29917
"2016","NORTH CAROLINA","STOKES",4665,769,17116,22550
"2016","NORTH CAROLINA","SURRY",7488,1037,23671,32196
"2016","NORTH CAROLINA","SWAIN",2196,363,3565,6124
"2016","NORTH CAROLINA","TRANSYLVANIA",6558,791,10520,17869
"2016","NORTH CAROLINA","TYRRELL",720,44,975,1739
"2016","NORTH CAROLINA","UNION",34337,4666,66707,105710
"2016","NORTH CAROLINA","VANCE",12229,416,7332,19977
"2016","NORTH CAROLINA","WAKE",302736,28806,196082,527624
"2016","NORTH CAROLINA","WARREN",6413,215,3214,9842
"2016","NORTH CAROLINA","WASHINGTON",3510,91,2564,6165
"2016","NORTH CAROLINA","WATAUGA",14138,2150,13697,29985
"2016","NORTH CAROLINA","WAYNE",21770,1379,27540,50689
"2016","NORTH CAROLINA","WILKES",6638,906,23752,31296
"2016","NORTH CAROLINA","WILSON",19663,941,17531,38135
"2016","NORTH CAROLINA","YADKIN",3160,584,13880,17624
"2016","NORTH CAROLINA","YANCEY",3196,379,6385,9960
"2016","NORTH DAKOTA","ADAMS",216,93,909,1218
"2016","NORTH DAKOTA","BARNES",1597,587,3160,5344
"2016","NORTH DAKOTA","BENSON",842,240,929,2011
"2016","NORTH DAKOTA","BILLINGS",59,51,495,605
"2016","NORTH DAKOTA","BOTTINEAU",736,264,2494,3494
"2016","NORTH DAKOTA","BOWMAN",227,114,1446,1787
"2016","NORTH DAKOTA","BURKE",119,38,895,1052
"2016","NORTH DAKOTA","BURLEIGH",10881,4566,32532,47979
"2016","NORTH DAKOTA","CASS",31361,9644,39816,80821
"2016","NORTH DAKOTA","CAVALIER",476,173,1357,2006
"2016","NORTH DAKOTA","DICKEY",554,186,1667,2407
"2016","NORTH DAKOTA","DIVIDE",245,107,867,1219
"2016","NORTH DAKOTA","DUNN",358,114,1771,2243
"2016","NORTH DAKOTA","EDDY",355,85,791,1231
"2016","NORTH DAKOTA","EMMONS",215,89,1677,1981
"2016","NORTH DAKOTA","FOSTER",347,131,1241,1719
"2016","NORTH DAKOTA","GOLDEN VALLEY",99,62,796,957
"2016","NORTH DAKOTA","GRAND FORKS",10851,3174,16340,30365
"2016","NORTH DAKOTA","GRANT",185,88,1108,1381
"2016","NORTH DAKOTA","GRIGGS",298,120,847,1265
"2016","NORTH DAKOTA","HETTINGER",168,78,1050,1296
"2016","NORTH DAKOTA","KIDDER",179,86,1111,1376
"2016","NORTH DAKOTA","LAMOURE",502,168,1481,2151
"2016","NORTH DAKOTA","LOGAN",114,65,888,1067
"2016","NORTH DAKOTA","MCHENRY",490,280,2050,2820
"2016","NORTH DAKOTA","MCINTOSH",235,111,1100,1446
"2016","NORTH DAKOTA","MCKENZIE",698,304,3670,4672
"2016","NORTH DAKOTA","MCLEAN",1081,374,3860,5315
"2016","NORTH DAKOTA","MERCER",621,302,3759,4682
"2016","NORTH DAKOTA","MORTON",3080,1416,11336,15832
"2016","NORTH DAKOTA","MOUNTRAIL",1220,304,2582,4106
"2016","NORTH DAKOTA","NELSON",536,156,1025,1717
"2016","NORTH DAKOTA","OLIVER",119,68,830,1017
"2016","NORTH DAKOTA","PEMBINA",681,264,2208,3153
"2016","NORTH DAKOTA","PIERCE",431,203,1437,2071
"2016","NORTH DAKOTA","RAMSEY",1505,583,3217,5305
"2016","NORTH DAKOTA","RANSOM",838,311,1210,2359
"2016","NORTH DAKOTA","RENVILLE",201,99,993,1293
"2016","NORTH DAKOTA","RICHLAND",2064,761,4767,7592
"2016","NORTH DAKOTA","ROLETTE",2099,439,1217,3755
"2016","NORTH DAKOTA","SARGENT",694,215,1088,1997
"2016","NORTH DAKOTA","SHERIDAN",95,42,650,787
"2016","NORTH DAKOTA","SIOUX",758,214,260,1232
"2016","NORTH DAKOTA","SLOPE",43,25,362,430
"2016","NORTH DAKOTA","STARK",1753,814,9755,12322
"2016","NORTH DAKOTA","STEELE",361,100,538,999
"2016","NORTH DAKOTA","STUTSMAN",2498,939,6718,10155
"2016","NORTH DAKOTA","TOWNER",305,119,733,1157
"2016","NORTH DAKOTA","TRAILL",1241,427,2265,3933
"2016","NORTH DAKOTA","WALSH",1167,474,2995,4636
"2016","NORTH DAKOTA","WARD",5806,2970,18636,27412
"2016","NORTH DAKOTA","WELLS",419,168,1796,2383
"2016","NORTH DAKOTA","WILLIAMS",1735,1003,10069,12807
"2016","OHIO","ADAMS",2326,374,8659,11359
"2016","OHIO","ALLEN",13294,2113,30487,45894
"2016","OHIO","ASHLAND",5740,1357,17493,24590
"2016","OHIO","ASHTABULA",15577,1972,23318,40867
"2016","OHIO","ATHENS",16370,1719,11354,29443
"2016","OHIO","AUGLAIZE",3980,989,18658,23627
"2016","OHIO","BELMONT",8785,1229,21108,31122
"2016","OHIO","BROWN",4353,681,14573,19607
"2016","OHIO","BUTLER",58642,8221,106976,173839
"2016","OHIO","CARROLL",3154,666,9254,13074
"2016","OHIO","CHAMPAIGN",4594,879,12631,18104
"2016","OHIO","CLARK",23328,2896,35205,61429
"2016","OHIO","CLERMONT",26715,4888,67518,99121
"2016","OHIO","CLINTON",4066,771,13838,18675
"2016","OHIO","COLUMBIANA",12432,2093,31676,46201
"2016","OHIO","COSHOCTON",4013,754,10785,15552
"2016","OHIO","CRAWFORD",4625,1001,13611,19237
"2016","OHIO","CUYAHOGA",398271,21340,184211,603822
"2016","OHIO","DARKE",4470,1002,20012,25484
"2016","OHIO","DEFIANCE",5368,1136,11688,18192
"2016","OHIO","DELAWARE",40872,5420,57568,103860
"2016","OHIO","ERIE",16057,1873,19648,37578
"2016","OHIO","FAIRFIELD",24881,3718,44314,72913
"2016","OHIO","FAYETTE",2739,428,7995,11162
"2016","OHIO","FRANKLIN",351198,30611,199331,581140
"2016","OHIO","FULTON",6069,1447,13709,21225
"2016","OHIO","GALLIA",2628,481,9822,12931
"2016","OHIO","GEAUGA",17569,2145,30227,49941
"2016","OHIO","GREENE",28943,4375,48540,81858
"2016","OHIO","GUERNSEY",4359,753,11445,16557
"2016","OHIO","HAMILTON",215719,19725,173665,409109
"2016","OHIO","HANCOCK",9609,2231,24183,36023
"2016","OHIO","HARDIN",2920,657,8717,12294
"2016","OHIO","HARRISON",1688,293,5098,7079
"2016","OHIO","HENRY",3756,875,9301,13932
"2016","OHIO","HIGHLAND",3773,708,14020,18501
"2016","OHIO","HOCKING",3775,566,8497,12838
"2016","OHIO","HOLMES",1788,546,8720,11054
"2016","OHIO","HURON",7192,1416,16226,24834
"2016","OHIO","JACKSON",3226,518,9949,13693
"2016","OHIO","JEFFERSON",9675,1409,21117,32201
"2016","OHIO","KNOX",8171,1385,19131,28687
"2016","OHIO","LAKE",46397,5594,64255,116246
"2016","OHIO","LAWRENCE",6974,944,18689,26607
"2016","OHIO","LICKING",27376,4144,51241,82761
"2016","OHIO","LOGAN",4647,967,15957,21571
"2016","OHIO","LORAIN",66949,6795,66818,140562
"2016","OHIO","LUCAS",110833,11025,75698,197556
"2016","OHIO","MADISON",4779,880,11631,17290
"2016","OHIO","MAHONING",57381,4075,53616,115072
"2016","OHIO","MARION",7928,1433,16961,26322
"2016","OHIO","MEDINA",32182,4381,54810,91373
"2016","OHIO","MEIGS",2260,416,7309,9985
"2016","OHIO","MERCER",3384,836,17506,21726
"2016","OHIO","MIAMI",13120,2535,37079,52734
"2016","OHIO","MONROE",1662,265,4868,6795
"2016","OHIO","MONTGOMERY",122016,12376,123909,258301
"2016","OHIO","MORGAN",1736,276,4431,6443
"2016","OHIO","MORROW",3761,839,11948,16548
"2016","OHIO","MUSKINGUM",11123,1812,24056,36991
"2016","OHIO","NOBLE",1221,243,4549,6013
"2016","OHIO","OTTAWA",8285,1280,12653,22218
"2016","OHIO","PAULDING",2093,454,6500,9047
"2016","OHIO","PERRY",4138,629,10228,14995
"2016","OHIO","PICKAWAY",6529,1140,17076,24745
"2016","OHIO","PIKE",3539,438,7902,11879
"2016","OHIO","PORTAGE",32397,3771,39971,76139
"2016","OHIO","PREBLE",4325,794,15446,20565
"2016","OHIO","PUTNAM",2922,884,14961,18767
"2016","OHIO","RICHLAND",16085,2539,36590,55214
"2016","OHIO","ROSS",10356,1372,18652,30380
"2016","OHIO","SANDUSKY",9929,1799,16316,28044
"2016","OHIO","SCIOTO",9132,1102,20550,30784
"2016","OHIO","SENECA",7404,1758,14825,23987
"2016","OHIO","SHELBY",4243,907,18590,23740
"2016","OHIO","STARK",68146,8705,98388,175239
"2016","OHIO","SUMMIT",134256,11697,112026,257979
"2016","OHIO","TRUMBULL",43014,3991,49024,96029
"2016","OHIO","TUSCARAWAS",12188,2183,26918,41289
"2016","OHIO","UNION",7718,1615,18096,27429
"2016","OHIO","VAN WERT",2697,604,10469,13770
"2016","OHIO","VINTON",1351,268,3883,5502
"2016","OHIO","WARREN",33730,5894,77643,117267
"2016","OHIO","WASHINGTON",8026,1300,20514,29840
"2016","OHIO","WAYNE",15031,2552,32270,49853
"2016","OHIO","WILLIAMS",4358,1011,11939,17308
"2016","OHIO","WOOD",27318,4525,32498,64341
"2016","OHIO","WYANDOT",2515,609,7468,10592
"2016","OKLAHOMA","ADAIR",1382,344,4787,6513
"2016","OKLAHOMA","ALFALFA",216,109,1933,2258
"2016","OKLAHOMA","ATOKA",795,139,4084,5018
"2016","OKLAHOMA","BEAVER",176,74,1993,2243
"2016","OKLAHOMA","BECKHAM",960,284,6308,7552
"2016","OKLAHOMA","BLAINE",711,198,2884,3793
"2016","OKLAHOMA","BRYAN",2804,536,10478,13818
"2016","OKLAHOMA","CADDO",2420,446,6482,9348
"2016","OKLAHOMA","CANADIAN",11674,3618,39986,55278
"2016","OKLAHOMA","CARTER",4002,780,13752,18534
"2016","OKLAHOMA","CHEROKEE",5456,1040,9994,16490
"2016","OKLAHOMA","CHOCTAW",1067,153,4206,5426
"2016","OKLAHOMA","CIMARRON",71,45,963,1079
"2016","OKLAHOMA","CLEVELAND",38829,8083,62538,109450
"2016","OKLAHOMA","COAL",411,90,1898,2399
"2016","OKLAHOMA","COMANCHE",11463,1918,19183,32564
"2016","OKLAHOMA","COTTON",424,124,2054,2602
"2016","OKLAHOMA","CRAIG",1252,250,4283,5785
"2016","OKLAHOMA","CREEK",5841,1414,21575,28830
"2016","OKLAHOMA","CUSTER",2104,611,7826,10541
"2016","OKLAHOMA","DELAWARE",3311,579,11826,15716
"2016","OKLAHOMA","DEWEY",222,61,1965,2248
"2016","OKLAHOMA","ELLIS",155,61,1611,1827
"2016","OKLAHOMA","GARFIELD",4397,1304,16009,21710
"2016","OKLAHOMA","GARVIN",1855,438,8253,10546
"2016","OKLAHOMA","GRADY",3882,1088,17316,22286
"2016","OKLAHOMA","GRANT",288,86,1827,2201
"2016","OKLAHOMA","GREER",323,91,1482,1896
"2016","OKLAHOMA","HARMON",225,37,715,977
"2016","OKLAHOMA","HARPER",134,47,1318,1499
"2016","OKLAHOMA","HASKELL",882,155,3701,4738
"2016","OKLAHOMA","HUGHES",961,177,3388,4526
"2016","OKLAHOMA","JACKSON",1473,364,5969,7806
"2016","OKLAHOMA","JEFFERSON",365,75,1910,2350
"2016","OKLAHOMA","JOHNSTON",786,139,3093,4018
"2016","OKLAHOMA","KAY",3738,893,12172,16803
"2016","OKLAHOMA","KINGFISHER",786,189,5156,6131
"2016","OKLAHOMA","KIOWA",767,130,2596,3493
"2016","OKLAHOMA","LATIMER",797,159,3100,4056
"2016","OKLAHOMA","LE FLORE",3250,609,13362,17221
"2016","OKLAHOMA","LINCOLN",2430,741,10854,14025
"2016","OKLAHOMA","LOGAN",4248,1098,13633,18979
"2016","OKLAHOMA","LOVE",735,132,2922,3789
"2016","OKLAHOMA","MAJOR",310,149,2948,3407
"2016","OKLAHOMA","MARSHALL",1096,190,4206,5492
"2016","OKLAHOMA","MAYES",3423,739,11555,15717
"2016","OKLAHOMA","MCCLAIN",2894,795,13169,16858
"2016","OKLAHOMA","MCCURTAIN",1802,268,8656,10726
"2016","OKLAHOMA","MCINTOSH",2123,335,5505,7963
"2016","OKLAHOMA","MURRAY",1087,266,4175,5528
"2016","OKLAHOMA","MUSKOGEE",7977,1196,15043,24216
"2016","OKLAHOMA","NOBLE",901,262,3715,4878
"2016","OKLAHOMA","NOWATA",742,174,3321,4237
"2016","OKLAHOMA","OKFUSKEE",943,200,2800,3943
"2016","OKLAHOMA","OKLAHOMA",112813,19560,141569,273942
"2016","OKLAHOMA","OKMULGEE",4385,620,8944,13949
"2016","OKLAHOMA","OSAGE",5597,792,12577,18966
"2016","OKLAHOMA","OTTAWA",2584,475,7631,10690
"2016","OKLAHOMA","PAWNEE",1344,291,4729,6364
"2016","OKLAHOMA","PAYNE",8788,2321,16651,27760
"2016","OKLAHOMA","PITTSBURG",3711,807,12753,17271
"2016","OKLAHOMA","PONTOTOC",3637,763,10431,14831
"2016","OKLAHOMA","POTTAWATOMIE",6015,1589,17848,25452
"2016","OKLAHOMA","PUSHMATAHA",748,154,3581,4483
"2016","OKLAHOMA","ROGER MILLS",151,61,1547,1759
"2016","OKLAHOMA","ROGERS",7902,2047,30913,40862
"2016","OKLAHOMA","SEMINOLE",2071,353,5613,8037
"2016","OKLAHOMA","SEQUOYAH",3061,488,10888,14437
"2016","OKLAHOMA","STEPHENS",3086,636,14182,17904
"2016","OKLAHOMA","TEXAS",858,301,4621,5780
"2016","OKLAHOMA","TILLMAN",657,105,1944,2706
"2016","OKLAHOMA","TULSA",87847,14949,144258,247054
"2016","OKLAHOMA","WAGONER",6723,1572,23005,31300
"2016","OKLAHOMA","WASHINGTON",5048,1351,15825,22224
"2016","OKLAHOMA","WASHITA",588,189,3854,4631
"2016","OKLAHOMA","WOODS",522,199,2947,3668
"2016","OKLAHOMA","WOODWARD",873,375,6347,7595
"2016","OREGON","BAKER",1797,764,6218,8779
"2016","OREGON","BENTON",29193,6115,13445,48753
"2016","OREGON","CLACKAMAS",102095,23552,88392,214039
"2016","OREGON","CLATSOP",9252,2274,8138,19664
"2016","OREGON","COLUMBIA",10167,3234,13217,26618
"2016","OREGON","COOS",10448,3000,17865,31313
"2016","OREGON","CROOK",2637,1024,8511,12172
"2016","OREGON","CURRY",4300,1099,7212,12611
"2016","OREGON","DESCHUTES",42444,10421,45692,98557
"2016","OREGON","DOUGLAS",14096,4843,34582,53521
"2016","OREGON","GILLIAM",239,109,671,1019
"2016","OREGON","GRANT",739,391,3210,4340
"2016","OREGON","HARNEY",683,379,2912,3974
"2016","OREGON","HOOD RIVER",6510,1128,3272,10910
"2016","OREGON","JACKSON",44447,11010,53870,109327
"2016","OREGON","JEFFERSON",2980,996,5483,9459
"2016","OREGON","JOSEPHINE",13453,4184,26923,44560
"2016","OREGON","KLAMATH",7210,2862,20435,30507
"2016","OREGON","LAKE",639,269,3022,3930
"2016","OREGON","LANE",102753,22056,67141,191950
"2016","OREGON","LINCOLN",12501,2716,10039,25256
"2016","OREGON","LINN",17995,7236,33488,58719
"2016","OREGON","MALHEUR",2246,995,7194,10435
"2016","OREGON","MARION",57788,15675,63377,136840
"2016","OREGON","MORROW",1017,429,2721,4167
"2016","OREGON","MULTNOMAH",292561,38588,67954,399103
"2016","OREGON","POLK",16420,4935,18940,40295
"2016","OREGON","SHERMAN",202,83,732,1017
"2016","OREGON","TILLAMOOK",5768,1497,6538,13803
"2016","OREGON","UMATILLA",7673,2865,17059,27597
"2016","OREGON","UNION",3249,1288,8431,12968
"2016","OREGON","WALLOWA",1116,402,2848,4366
"2016","OREGON","WASCO",4781,1350,5833,11964
"2016","OREGON","WASHINGTON",153251,32784,83197,269232
"2016","OREGON","WHEELER",155,72,591,818
"2016","OREGON","YAMHILL",19301,6202,23250,48753
"2016","PENNSYLVANIA","ADAMS",14219,1847,31423,47489
"2016","PENNSYLVANIA","ALLEGHENY",367617,23017,259480,650114
"2016","PENNSYLVANIA","ARMSTRONG",7178,956,23484,31618
"2016","PENNSYLVANIA","BEAVER",32531,2873,48167,83571
"2016","PENNSYLVANIA","BEDFORD",3645,440,19552,23637
"2016","PENNSYLVANIA","BERKS",78437,8002,96626,183065
"2016","PENNSYLVANIA","BLAIR",13958,1816,39135,54909
"2016","PENNSYLVANIA","BRADFORD",6369,1198,18141,25708
"2016","PENNSYLVANIA","BUCKS",167060,12876,164361,344297
"2016","PENNSYLVANIA","BUTLER",28584,4059,64428,97071
"2016","PENNSYLVANIA","CAMBRIA",18867,1947,42258,63072
"2016","PENNSYLVANIA","CAMERON",531,66,1589,2186
"2016","PENNSYLVANIA","CARBON",8936,1097,18743,28776
"2016","PENNSYLVANIA","CENTRE",37088,3786,35274,76148
"2016","PENNSYLVANIA","CHESTER",141682,11004,116114,268800
"2016","PENNSYLVANIA","CLARION",4273,686,12576,17535
"2016","PENNSYLVANIA","CLEARFIELD",8200,1139,24932,34271
"2016","PENNSYLVANIA","CLINTON",4744,628,10022,15394
"2016","PENNSYLVANIA","COLUMBIA",8934,1290,18004,28228
"2016","PENNSYLVANIA","CRAWFORD",10971,1534,24987,37492
"2016","PENNSYLVANIA","CUMBERLAND",47085,5456,69076,121617
"2016","PENNSYLVANIA","DAUPHIN",64706,5303,60863,130872
"2016","PENNSYLVANIA","DELAWARE",177402,9565,110667,297634
"2016","PENNSYLVANIA","ELK",3853,548,10025,14426
"2016","PENNSYLVANIA","ERIE",58112,5498,60069,123679
"2016","PENNSYLVANIA","FAYETTE",17946,1231,34590,53767
"2016","PENNSYLVANIA","FOREST",626,92,1683,2401
"2016","PENNSYLVANIA","FRANKLIN",17465,2498,49768,69731
"2016","PENNSYLVANIA","FULTON",912,165,5694,6771
"2016","PENNSYLVANIA","GREENE",4482,433,10849,15764
"2016","PENNSYLVANIA","HUNTINGDON",4539,673,14494,19706
"2016","PENNSYLVANIA","INDIANA",11528,1354,24888,37770
"2016","PENNSYLVANIA","JEFFERSON",3650,636,15192,19478
"2016","PENNSYLVANIA","JUNIATA",1821,360,8273,10454
"2016","PENNSYLVANIA","LACKAWANNA",51983,3089,48384,103456
"2016","PENNSYLVANIA","LANCASTER",91093,12105,137914,241112
"2016","PENNSYLVANIA","LAWRENCE",14009,1316,25428,40753
"2016","PENNSYLVANIA","LEBANON",18953,2367,40525,61845
"2016","PENNSYLVANIA","LEHIGH",81324,5979,73690,160993
"2016","PENNSYLVANIA","LUZERNE",52451,3844,78688,134983
"2016","PENNSYLVANIA","LYCOMING",13020,1918,35627,50565
"2016","PENNSYLVANIA","MCKEAN",4025,636,11635,16296
"2016","PENNSYLVANIA","MERCER",18733,2032,31544,52309
"2016","PENNSYLVANIA","MIFFLIN",3877,630,14094,18601
"2016","PENNSYLVANIA","MONROE",33918,2448,33386,69752
"2016","PENNSYLVANIA","MONTGOMERY",256082,15874,162731,434687
"2016","PENNSYLVANIA","MONTOUR",2857,411,5288,8556
"2016","PENNSYLVANIA","NORTHAMPTON",66272,5511,71736,143519
"2016","PENNSYLVANIA","NORTHUMBERLAND",9788,1407,25427,36622
"2016","PENNSYLVANIA","PERRY",4632,910,15616,21158
"2016","PENNSYLVANIA","PHILADELPHIA",584025,14858,108748,707631
"2016","PENNSYLVANIA","PIKE",9256,789,16056,26101
"2016","PENNSYLVANIA","POTTER",1302,231,6251,7784
"2016","PENNSYLVANIA","SCHUYLKILL",16770,2098,44001,62869
"2016","PENNSYLVANIA","SNYDER",4002,636,11725,16363
"2016","PENNSYLVANIA","SOMERSET",7376,1018,27379,35773
"2016","PENNSYLVANIA","SULLIVAN",750,95,2291,3136
"2016","PENNSYLVANIA","SUSQUEHANNA",5123,849,12891,18863
"2016","PENNSYLVANIA","TIOGA",3901,810,13614,18325
"2016","PENNSYLVANIA","UNION",6180,666,10622,17468
"2016","PENNSYLVANIA","VENANGO",6309,1018,16021,23348
"2016","PENNSYLVANIA","WARREN",5145,812,12477,18434
"2016","PENNSYLVANIA","WASHINGTON",36322,3742,61386,101450
"2016","PENNSYLVANIA","WAYNE",7008,766,16244,24018
"2016","PENNSYLVANIA","WESTMORELAND",59669,5860,116522,182051
"2016","PENNSYLVANIA","WYOMING",3811,496,8837,13144
"2016","PENNSYLVANIA","YORK",68524,8934,128528,205986
"2016","RHODE ISLAND","BRISTOL",14609,1901,8965,25475
"2016","RHODE ISLAND","FEDERAL PRECINCT",637,38,53,728
"2016","RHODE ISLAND","KENT",37788,5929,38336,82053
"2016","RHODE ISLAND","NEWPORT",22851,3117,15077,41045
"2016","RHODE ISLAND","PROVIDENCE",142899,14693,90882,248474
"2016","RHODE ISLAND","WASHINGTON",33741,5398,27230,66369
"2016","SOUTH CAROLINA","ABBEVILLE",3741,271,6763,10775
"2016","SOUTH CAROLINA","AIKEN",25455,3371,46025,74851
"2016","SOUTH CAROLINA","ALLENDALE",2735,68,789,3592
"2016","SOUTH CAROLINA","ANDERSON",21097,3154,56232,80483
"2016","SOUTH CAROLINA","BAMBERG",3898,112,2204,6214
"2016","SOUTH CAROLINA","BARNWELL",4400,196,4889,9485
"2016","SOUTH CAROLINA","BEAUFORT",32138,3464,42922,78524
"2016","SOUTH CAROLINA","BERKELEY",30705,4225,44587,79517
"2016","SOUTH CAROLINA","CALHOUN",3573,189,3787,7549
"2016","SOUTH CAROLINA","CHARLESTON",89299,11603,75443,176345
"2016","SOUTH CAROLINA","CHEROKEE",6092,500,15167,21759
"2016","SOUTH CAROLINA","CHESTER",6579,348,7265,14192
"2016","SOUTH CAROLINA","CHESTERFIELD",6858,411,9312,16581
"2016","SOUTH CAROLINA","CLARENDON",7732,277,7386,15395
"2016","SOUTH CAROLINA","COLLETON",7627,533,9091,17251
"2016","SOUTH CAROLINA","DARLINGTON",13888,797,14989,29674
"2016","SOUTH CAROLINA","DILLON",5834,227,5637,11698
"2016","SOUTH CAROLINA","DORCHESTER",24055,3525,34987,62567
"2016","SOUTH CAROLINA","EDGEFIELD",4491,311,6842,11644
"2016","SOUTH CAROLINA","FAIRFIELD",6945,295,4027,11267
"2016","SOUTH CAROLINA","FLORENCE",26710,1648,29573,57931
"2016","SOUTH CAROLINA","GEORGETOWN",13310,958,17389,31657
"2016","SOUTH CAROLINA","GREENVILLE",74483,12850,127832,215165
"2016","SOUTH CAROLINA","GREENWOOD",10711,1091,16961,28763
"2016","SOUTH CAROLINA","HAMPTON",5170,148,3488,8806
"2016","SOUTH CAROLINA","HORRY",39410,4222,89288,132920
"2016","SOUTH CAROLINA","JASPER",5956,284,5187,11427
"2016","SOUTH CAROLINA","KERSHAW",10330,1123,17542,28995
"2016","SOUTH CAROLINA","LANCASTER",13812,1407,23719,38938
"2016","SOUTH CAROLINA","LAURENS",8889,861,16816,26566
"2016","SOUTH CAROLINA","LEE",5199,154,2803,8156
"2016","SOUTH CAROLINA","LEXINGTON",35230,6837,80026,122093
"2016","SOUTH CAROLINA","MARION",8569,263,5444,14276
"2016","SOUTH CAROLINA","MARLBORO",5954,168,4267,10389
"2016","SOUTH CAROLINA","MCCORMICK",2479,85,2652,5216
"2016","SOUTH CAROLINA","NEWBERRY",6217,573,10017,16807
"2016","SOUTH CAROLINA","OCONEE",7998,1459,24178,33635
"2016","SOUTH CAROLINA","ORANGEBURG",26318,661,11931,38910
"2016","SOUTH CAROLINA","PICKENS",10354,2459,36236,49049
"2016","SOUTH CAROLINA","RICHLAND",108000,8253,52469,168722
"2016","SOUTH CAROLINA","SALUDA",2813,225,5526,8564
"2016","SOUTH CAROLINA","SPARTANBURG",39997,4816,76277,121090
"2016","SOUTH CAROLINA","SUMTER",24047,1294,18745,44086
"2016","SOUTH CAROLINA","UNION",4729,302,7061,12092
"2016","SOUTH CAROLINA","WILLIAMSBURG",9953,237,4864,15054
"2016","SOUTH CAROLINA","YORK",41593,6010,66754,114357
"2016","SOUTH DAKOTA","AURORA",340,93,974,1407
"2016","SOUTH DAKOTA","BEADLE",1912,405,4455,6772
"2016","SOUTH DAKOTA","BENNETT",412,71,666,1149
"2016","SOUTH DAKOTA","BON HOMME",704,165,2105,2974
"2016","SOUTH DAKOTA","BROOKINGS",4879,1053,6748,12680
"2016","SOUTH DAKOTA","BROWN",5452,1049,9613,16114
"2016","SOUTH DAKOTA","BRULE",571,152,1565,2288
"2016","SOUTH DAKOTA","BUFFALO",296,23,171,490
"2016","SOUTH DAKOTA","BUTTE",696,298,3357,4351
"2016","SOUTH DAKOTA","CAMPBELL",105,22,704,831
"2016","SOUTH DAKOTA","CHARLES MIX",935,116,2382,3433
"2016","SOUTH DAKOTA","CLARK",398,120,1139,1657
"2016","SOUTH DAKOTA","CLAY",2608,352,2109,5069
"2016","SOUTH DAKOTA","CODINGTON",3174,731,7764,11669
"2016","SOUTH DAKOTA","CORSON",535,52,588,1175
"2016","SOUTH DAKOTA","CUSTER",1121,307,3293,4721
"2016","SOUTH DAKOTA","DAVISON",2355,440,5157,7952
"2016","SOUTH DAKOTA","DAY",974,146,1627,2747
"2016","SOUTH DAKOTA","DEUEL",570,144,1366,2080
"2016","SOUTH DAKOTA","DEWEY",888,97,723,1708
"2016","SOUTH DAKOTA","DOUGLAS",214,53,1338,1605
"2016","SOUTH DAKOTA","EDMUNDS",380,105,1433,1918
"2016","SOUTH DAKOTA","FALL RIVER",821,231,2511,3563
"2016","SOUTH DAKOTA","FAULK",204,56,858,1118
"2016","SOUTH DAKOTA","GRANT",971,211,2382,3564
"2016","SOUTH DAKOTA","GREGORY",391,100,1600,2091
"2016","SOUTH DAKOTA","HAAKON",77,31,936,1044
"2016","SOUTH DAKOTA","HAMLIN",555,156,2051,2762
"2016","SOUTH DAKOTA","HAND",334,93,1391,1818
"2016","SOUTH DAKOTA","HANSON",424,85,1497,2006
"2016","SOUTH DAKOTA","HARDING",38,37,695,770
"2016","SOUTH DAKOTA","HUGHES",2450,551,5174,8175
"2016","SOUTH DAKOTA","HUTCHINSON",692,156,2517,3365
"2016","SOUTH DAKOTA","HYDE",125,22,543,690
"2016","SOUTH DAKOTA","JACKSON",323,50,722,1095
"2016","SOUTH DAKOTA","JERAULD",264,55,648,967
"2016","SOUTH DAKOTA","JONES",69,39,450,558
"2016","SOUTH DAKOTA","KINGSBURY",703,168,1680,2551
"2016","SOUTH DAKOTA","LAKE",2314,434,4038,6786
"2016","SOUTH DAKOTA","LAWRENCE",3356,1075,7411,11842
"2016","SOUTH DAKOTA","LINCOLN",8076,1656,15499,25231
"2016","SOUTH DAKOTA","LYMAN",369,75,977,1421
"2016","SOUTH DAKOTA","MARSHALL",754,137,1056,1947
"2016","SOUTH DAKOTA","MCCOOK",623,170,1794,2587
"2016","SOUTH DAKOTA","MCPHERSON",192,53,892,1137
"2016","SOUTH DAKOTA","MEADE",2223,957,8441,11621
"2016","SOUTH DAKOTA","MELLETTE",238,43,402,683
"2016","SOUTH DAKOTA","MINER",281,77,706,1064
"2016","SOUTH DAKOTA","MINNEHAHA",30610,5610,42043,78263
"2016","SOUTH DAKOTA","MOODY",1043,159,1731,2933
"2016","SOUTH DAKOTA","OGLALA LAKOTA",2510,154,241,2905
"2016","SOUTH DAKOTA","PENNINGTON",14074,3865,29804,47743
"2016","SOUTH DAKOTA","PERKINS",188,85,1333,1606
"2016","SOUTH DAKOTA","POTTER",215,51,1071,1337
"2016","SOUTH DAKOTA","ROBERTS",1540,205,2144,3889
"2016","SOUTH DAKOTA","SANBORN",241,63,819,1123
"2016","SOUTH DAKOTA","SPINK",919,178,1854,2951
"2016","SOUTH DAKOTA","STANLEY",329,90,1148,1567
"2016","SOUTH DAKOTA","SULLY",137,45,679,861
"2016","SOUTH DAKOTA","TODD",1505,133,487,2125
"2016","SOUTH DAKOTA","TRIPP",462,99,2069,2630
"2016","SOUTH DAKOTA","TURNER",961,252,2937,4150
"2016","SOUTH DAKOTA","UNION",2227,380,5290,7897
"2016","SOUTH DAKOTA","WALWORTH",457,124,1896,2477
"2016","SOUTH DAKOTA","YANKTON",3301,663,5659,9623
"2016","SOUTH DAKOTA","ZIEBACH",353,46,368,767
"2016","TENNESSEE","ANDERSON",9013,1656,19212,29881
"2016","TENNESSEE","BEDFORD",3395,474,11486,15355
"2016","TENNESSEE","BENTON",1474,138,4716,6328
"2016","TENNESSEE","BLEDSOE",897,145,3622,4664
"2016","TENNESSEE","BLOUNT",12100,2665,37443,52208
"2016","TENNESSEE","BRADLEY",7070,1828,29768,38666
"2016","TENNESSEE","CAMPBELL",2248,414,9870,12532
"2016","TENNESSEE","CANNON",1127,180,4007,5314
"2016","TENNESSEE","CARROLL",2327,301,7756,10384
"2016","TENNESSEE","CARTER",3453,733,16898,21084
"2016","TENNESSEE","CHEATHAM",3878,749,11297,15924
"2016","TENNESSEE","CHESTER",1243,183,5081,6507
"2016","TENNESSEE","CLAIBORNE",1832,306,8602,10740
"2016","TENNESSEE","CLAY",707,72,2141,2920
"2016","TENNESSEE","COCKE",1981,354,9791,12126
"2016","TENNESSEE","COFFEE",4743,811,14417,19971
"2016","TENNESSEE","CROCKETT",1303,112,3982,5397
"2016","TENNESSEE","CUMBERLAND",5202,745,20413,26360
"2016","TENNESSEE","DAVIDSON",148864,15654,84550,249068
"2016","TENNESSEE","DECATUR",894,110,3588,4592
"2016","TENNESSEE","DEKALB",1569,215,5171,6955
"2016","TENNESSEE","DICKSON",4722,744,13233,18699
"2016","TENNESSEE","DYER",2816,340,10180,13336
"2016","TENNESSEE","FAYETTE",5874,465,13055,19394
"2016","TENNESSEE","FENTRESS",1100,195,6038,7333
"2016","TENNESSEE","FRANKLIN",4374,498,11532,16404
"2016","TENNESSEE","GIBSON",5258,503,13786,19547
"2016","TENNESSEE","GILES",2917,250,7970,11137
"2016","TENNESSEE","GRAINGER",1154,228,6626,8008
"2016","TENNESSEE","GREENE",4216,805,18562,23583
"2016","TENNESSEE","GRUNDY",999,128,3636,4763
"2016","TENNESSEE","HAMBLEN",4075,760,15857,20692
"2016","TENNESSEE","HAMILTON",55316,8359,78733,142408
"2016","TENNESSEE","HANCOCK",322,66,1843,2231
"2016","TENNESSEE","HARDEMAN",4185,169,4919,9273
"2016","TENNESSEE","HARDIN",1622,315,8012,9949
"2016","TENNESSEE","HAWKINS",3507,619,16648,20774
"2016","TENNESSEE","HAYWOOD",3711,110,3013,6834
"2016","TENNESSEE","HENDERSON",1800,279,8138,10217
"2016","TENNESSEE","HENRY",3063,374,9508,12945
"2016","TENNESSEE","HICKMAN",1824,294,5695,7813
"2016","TENNESSEE","HOUSTON",866,120,2182,3168
"2016","TENNESSEE","HUMPHREYS",1967,256,4930,7153
"2016","TENNESSEE","JACKSON",1129,101,3236,4466
"2016","TENNESSEE","JEFFERSON",3494,802,14776,19072
"2016","TENNESSEE","JOHNSON",988,181,5410,6579
"2016","TENNESSEE","KNOX",62878,12052,105767,180697
"2016","TENNESSEE","LAKE",577,36,1357,1970
"2016","TENNESSEE","LAUDERDALE",3056,147,4884,8087
"2016","TENNESSEE","LAWRENCE",2821,425,12420,15666
"2016","TENNESSEE","LEWIS",890,147,3585,4622
"2016","TENNESSEE","LINCOLN",2554,396,10398,13348
"2016","TENNESSEE","LOUDON",4919,862,17610,23391
"2016","TENNESSEE","MACON",1072,169,6263,7504
"2016","TENNESSEE","MADISON",15448,1337,21335,38120
"2016","TENNESSEE","MARION",2832,334,7696,10862
"2016","TENNESSEE","MARSHALL",2852,419,8184,11455
"2016","TENNESSEE","MAURY",10038,1532,23799,35369
"2016","TENNESSEE","MCMINN",3510,554,14691,18755
"2016","TENNESSEE","MCNAIRY",1848,349,7841,10038
"2016","TENNESSEE","MEIGS",856,122,3342,4320
"2016","TENNESSEE","MONROE",3186,533,13374,17093
"2016","TENNESSEE","MONTGOMERY",21699,3580,32341,57620
"2016","TENNESSEE","MOORE",496,105,2325,2926
"2016","TENNESSEE","MORGAN",1054,210,5441,6705
"2016","TENNESSEE","OBION",2426,297,9526,12249
"2016","TENNESSEE","OVERTON",1945,225,6059,8229
"2016","TENNESSEE","PERRY",597,91,2167,2855
"2016","TENNESSEE","PICKETT",536,58,2021,2615
"2016","TENNESSEE","POLK",1252,171,5097,6520
"2016","TENNESSEE","PUTNAM",6851,1359,19002,27212
"2016","TENNESSEE","RHEA",1942,460,8660,11062
"2016","TENNESSEE","ROANE",4837,952,15880,21669
"2016","TENNESSEE","ROBERTSON",6637,1066,19410,27113
"2016","TENNESSEE","RUTHERFORD",36706,6215,64515,107436
"2016","TENNESSEE","SCOTT",934,145,6044,7123
"2016","TENNESSEE","SEQUATCHIE",1053,200,4441,5694
"2016","TENNESSEE","SEVIER",6297,1386,28629,36312
"2016","TENNESSEE","SHELBY",208992,12047,116344,337383
"2016","TENNESSEE","SMITH",1689,253,5494,7436
"2016","TENNESSEE","STEWART",1222,213,3864,5299
"2016","TENNESSEE","SULLIVAN",12578,2721,46979,62278
"2016","TENNESSEE","SUMNER",18161,3215,50129,71505
"2016","TENNESSEE","TIPTON",5785,786,16910,23481
"2016","TENNESSEE","TROUSDALE",946,111,2103,3160
"2016","TENNESSEE","UNICOI",1262,262,5671,7195
"2016","TENNESSEE","UNION",1012,182,5053,6247
"2016","TENNESSEE","VAN BUREN",539,60,1820,2419
"2016","TENNESSEE","WARREN",3535,537,9540,13612
"2016","TENNESSEE","WASHINGTON",13024,2474,34252,49750
"2016","TENNESSEE","WAYNE",717,104,5036,5857
"2016","TENNESSEE","WEAKLEY",2772,404,9008,12184
"2016","TENNESSEE","WHITE",1845,309,7671,9825
"2016","TENNESSEE","WILLIAMSON",31013,7046,68212,106271
"2016","TENNESSEE","WILSON",14385,2943,39406,56734
"2016","TEXAS","ANDERSON",3369,407,13201,16977
"2016","TEXAS","ANDREWS",836,180,3927,4943
"2016","TEXAS","ANGELINA",7538,705,21668,29911
"2016","TEXAS","ARANSAS",2465,307,7740,10512
"2016","TEXAS","ARCHER",394,103,3786,4283
"2016","TEXAS","ARMSTRONG",70,27,924,1021
"2016","TEXAS","ATASCOSA",4651,404,8618,13673
"2016","TEXAS","AUSTIN",2320,317,9637,12274
"2016","TEXAS","BAILEY",397,52,1344,1793
"2016","TEXAS","BANDERA",1726,329,8163,10218
"2016","TEXAS","BASTROP",10569,1557,16328,28454
"2016","TEXAS","BAYLOR",191,41,1267,1499
"2016","TEXAS","BEE",3444,297,4744,8485
"2016","TEXAS","BELL",37801,5195,51998,94994
"2016","TEXAS","BEXAR",319550,29762,240333,589645
"2016","TEXAS","BLANCO",1244,229,4212,5685
"2016","TEXAS","BORDEN",31,4,330,365
"2016","TEXAS","BOSQUE",1278,221,6339,7838
"2016","TEXAS","BOWIE",8838,840,24924,34602
"2016","TEXAS","BRAZORIA",43200,5190,72791,121181
"2016","TEXAS","BRAZOS",23121,5352,38738,67211
"2016","TEXAS","BREWSTER",1873,302,2077,4252
"2016","TEXAS","BRISCOE",91,20,625,736
"2016","TEXAS","BROOKS",1937,46,613,2596
"2016","TEXAS","BROWN",1621,388,12017,14026
"2016","TEXAS","BURLESON",1491,153,5316,6960
"2016","TEXAS","BURNET",3797,769,14638,19204
"2016","TEXAS","CALDWELL",4795,606,6691,12092
"2016","TEXAS","CALHOUN",2118,209,4638,6965
"2016","TEXAS","CALLAHAN",569,145,4865,5579
"2016","TEXAS","CAMERON",59402,3205,29472,92079
"2016","TEXAS","CAMP",1260,81,3201,4542
"2016","TEXAS","CARSON",249,95,2620,2964
"2016","TEXAS","CASS",2391,227,9726,12344
"2016","TEXAS","CASTRO",526,57,1414,1997
"2016","TEXAS","CHAMBERS",2948,499,13339,16786
"2016","TEXAS","CHEROKEE",3469,402,12919,16790
"2016","TEXAS","CHILDRESS",253,29,1802,2084
"2016","TEXAS","CLAY",536,105,4377,5018
"2016","TEXAS","COCHRAN",190,32,679,901
"2016","TEXAS","COKE",140,18,1265,1423
"2016","TEXAS","COLEMAN",388,78,3177,3643
"2016","TEXAS","COLLIN",140624,19781,201014,361419
"2016","TEXAS","COLLINGSWORTH",145,28,983,1156
"2016","TEXAS","COLORADO",1987,201,6325,8513
"2016","TEXAS","COMAL",14238,2804,45136,62178
"2016","TEXAS","COMANCHE",789,115,4333,5237
"2016","TEXAS","CONCHO",148,35,885,1068
"2016","TEXAS","COOKE",2352,422,13181,15955
"2016","TEXAS","CORYELL",5064,964,12225,18253
"2016","TEXAS","COTTLE",92,14,506,612
"2016","TEXAS","CRANE",299,36,1049,1384
"2016","TEXAS","CROCKETT",372,43,980,1395
"2016","TEXAS","CROSBY",468,79,1181,1728
"2016","TEXAS","CULBERSON",454,33,280,767
"2016","TEXAS","DALLAM",222,61,1261,1544
"2016","TEXAS","DALLAS",461080,34948,262945,758973
"2016","TEXAS","DAWSON",835,92,2636,3563
"2016","TEXAS","DEAF SMITH",1185,120,2911,4216
"2016","TEXAS","DELTA",400,45,1836,2281
"2016","TEXAS","DENTON",110890,17152,170603,298645
"2016","TEXAS","DEWITT",1163,162,5519,6844
"2016","TEXAS","DICKENS",128,26,755,909
"2016","TEXAS","DIMMIT",2173,78,974,3225
"2016","TEXAS","DONLEY",191,49,1225,1465
"2016","TEXAS","DUVAL",2783,69,1316,4168
"2016","TEXAS","EASTLAND",776,176,6011,6963
"2016","TEXAS","ECTOR",10249,1261,25020,36530
"2016","TEXAS","EDWARDS",303,24,746,1073
"2016","TEXAS","EL PASO",147843,10653,55512,214008
"2016","TEXAS","ELLIS",16253,2479,44941,63673
"2016","TEXAS","ERATH",2160,523,11210,13893
"2016","TEXAS","FALLS",1684,123,3441,5248
"2016","TEXAS","FANNIN",2132,364,9548,12044
"2016","TEXAS","FAYETTE",2144,287,8743,11174
"2016","TEXAS","FISHER",403,61,1265,1729
"2016","TEXAS","FLOYD",435,50,1474,1959
"2016","TEXAS","FOARD",113,17,383,513
"2016","TEXAS","FORT BEND",134686,10089,117291,262066
"2016","TEXAS","FRANKLIN",665,130,3585,4380
"2016","TEXAS","FREESTONE",1471,187,6026,7684
"2016","TEXAS","FRIO",2444,100,1856,4400
"2016","TEXAS","GAINES",597,116,3907,4620
"2016","TEXAS","GALVESTON",43658,5488,73757,122903
"2016","TEXAS","GARZA",230,29,1225,1484
"2016","TEXAS","GILLESPIE",2288,480,10446,13214
"2016","TEXAS","GLASSCOCK",34,17,553,604
"2016","TEXAS","GOLIAD",973,115,2620,3708
"2016","TEXAS","GONZALES",1571,176,4587,6334
"2016","TEXAS","GRAY",701,204,6500,7405
"2016","TEXAS","GRAYSON",10301,1790,35325,47416
"2016","TEXAS","GREGG",11677,1308,28764,41749
"2016","TEXAS","GRIMES",2194,274,7065,9533
"2016","TEXAS","GUADALUPE",18391,2799,36632,57822
"2016","TEXAS","HALE",2101,391,6366,8858
"2016","TEXAS","HALL",164,34,893,1091
"2016","TEXAS","HAMILTON",479,81,3060,3620
"2016","TEXAS","HANSFORD",171,46,1730,1947
"2016","TEXAS","HARDEMAN",249,57,1207,1513
"2016","TEXAS","HARDIN",2780,394,19606,22780
"2016","TEXAS","HARRIS",707914,58243,545955,1312112
"2016","TEXAS","HARRISON",7151,648,18749,26548
"2016","TEXAS","HARTLEY",173,49,1730,1952
"2016","TEXAS","HASKELL",314,53,1403,1770
"2016","TEXAS","HAYS",33224,5114,33826,72164
"2016","TEXAS","HEMPHILL",181,52,1462,1695
"2016","TEXAS","HENDERSON",5669,726,23650,30045
"2016","TEXAS","HIDALGO",118809,5986,48642,173437
"2016","TEXAS","HILL",2547,315,10108,12970
"2016","TEXAS","HOCKLEY",1260,242,5809,7311
"2016","TEXAS","HOOD",4008,872,21382,26262
"2016","TEXAS","HOPKINS",2510,321,10707,13538
"2016","TEXAS","HOUSTON",1978,170,6205,8353
"2016","TEXAS","HOWARD",1770,316,6637,8723
"2016","TEXAS","HUDSPETH",324,44,503,871
"2016","TEXAS","HUNT",6396,1248,23910,31554
"2016","TEXAS","HUTCHINSON",854,259,7042,8155
"2016","TEXAS","IRION",90,16,660,766
"2016","TEXAS","JACK",314,63,2973,3350
"2016","TEXAS","JACKSON",904,132,4266,5302
"2016","TEXAS","JASPER",2590,220,10609,13419
"2016","TEXAS","JEFF DAVIS",422,74,695,1191
"2016","TEXAS","JEFFERSON",42443,2313,42862,87618
"2016","TEXAS","JIM HOGG",1635,54,430,2119
"2016","TEXAS","JIM WELLS",6694,265,5420,12379
"2016","TEXAS","JOHNSON",10988,2236,44382,57606
"2016","TEXAS","JONES",936,205,4819,5960
"2016","TEXAS","KARNES",1145,88,2965,4198
"2016","TEXAS","KAUFMAN",10278,1400,29587,41265
"2016","TEXAS","KENDALL",3643,777,15700,20120
"2016","TEXAS","KENEDY",99,3,84,186
"2016","TEXAS","KENT",59,15,360,434
"2016","TEXAS","KERR",4681,889,17727,23297
"2016","TEXAS","KIMBLE",206,49,1697,1952
"2016","TEXAS","KING",5,5,149,159
"2016","TEXAS","KINNEY",458,36,936,1430
"2016","TEXAS","KLEBERG",4716,429,4367,9512
"2016","TEXAS","KNOX",247,42,1078,1367
"2016","TEXAS","LA SALLE",1129,58,872,2059
"2016","TEXAS","LAMAR",3583,467,14561,18611
"2016","TEXAS","LAMB",771,113,3111,3995
"2016","TEXAS","LAMPASAS",1483,337,6385,8205
"2016","TEXAS","LAVACA",1170,144,7347,8661
"2016","TEXAS","LEE",1372,166,4997,6535
"2016","TEXAS","LEON",909,139,6391,7439
"2016","TEXAS","LIBERTY",4862,513,18892,24267
"2016","TEXAS","LIMESTONE",1778,165,5796,7739
"2016","TEXAS","LIPSCOMB",135,38,1159,1332
"2016","TEXAS","LIVE OAK",742,96,3464,4302
"2016","TEXAS","LLANO",1825,323,8299,10447
"2016","TEXAS","LOVING",4,3,58,65
"2016","TEXAS","LUBBOCK",28023,5339,65651,99013
"2016","TEXAS","LYNN",403,60,1546,2009
"2016","TEXAS","MADISON",881,57,3351,4289
"2016","TEXAS","MARION",1165,90,2983,4238
"2016","TEXAS","MARTIN",266,41,1455,1762
"2016","TEXAS","MASON",354,47,1656,2057
"2016","TEXAS","MATAGORDA",3500,330,8366,12196
"2016","TEXAS","MAVERICK",10397,375,2816,13588
"2016","TEXAS","MCCULLOCH",482,69,2552,3103
"2016","TEXAS","MCLENNAN",27063,3752,48260,79075
"2016","TEXAS","MCMULLEN",40,5,454,499
"2016","TEXAS","MEDINA",4634,527,12085,17246
"2016","TEXAS","MENARD",154,28,682,864
"2016","TEXAS","MIDLAND",10025,2214,36973,49212
"2016","TEXAS","MILAM",2051,249,6364,8664
"2016","TEXAS","MILLS",243,51,1951,2245
"2016","TEXAS","MITCHELL",354,62,1780,2196
"2016","TEXAS","MONTAGUE",885,193,7526,8604
"2016","TEXAS","MONTGOMERY",45835,8483,150314,204632
"2016","TEXAS","MOORE",1098,209,3977,5284
"2016","TEXAS","MORRIS",1425,102,3446,4973
"2016","TEXAS","MOTLEY",40,9,566,615
"2016","TEXAS","NACOGDOCHES",6846,1005,14771,22622
"2016","TEXAS","NAVARRO",4002,437,11994,16433
"2016","TEXAS","NEWTON",1156,90,4288,5534
"2016","TEXAS","NOLAN",1029,276,3552,4857
"2016","TEXAS","NUECES",49198,4441,50766,104405
"2016","TEXAS","OCHILTREE",274,100,2628,3002
"2016","TEXAS","OLDHAM",78,20,850,948
"2016","TEXAS","ORANGE",5735,752,25513,32000
"2016","TEXAS","PALO PINTO",1708,278,8284,10270
"2016","TEXAS","PANOLA",1835,136,8445,10416
"2016","TEXAS","PARKER",8344,2000,46473,56817
"2016","TEXAS","PARMER",485,66,1915,2466
"2016","TEXAS","PECOS",1554,163,2468,4185
"2016","TEXAS","POLK",4187,489,15176,19852
"2016","TEXAS","POTTER",7657,1364,19630,28651
"2016","TEXAS","PRESIDIO",1458,98,652,2208
"2016","TEXAS","RAINS",628,105,3968,4701
"2016","TEXAS","RANDALL",8367,2476,43462,54305
"2016","TEXAS","REAGAN",167,28,709,904
"2016","TEXAS","REAL",262,37,1382,1681
"2016","TEXAS","RED RIVER",1149,86,3926,5161
"2016","TEXAS","REEVES",1659,108,1417,3184
"2016","TEXAS","REFUGIO",1034,84,1830,2948
"2016","TEXAS","ROBERTS",20,10,524,554
"2016","TEXAS","ROBERTSON",2203,164,4668,7035
"2016","TEXAS","ROCKWALL",9655,1842,28451,39948
"2016","TEXAS","RUNNELS",453,79,3250,3782
"2016","TEXAS","RUSK",3935,384,14675,18994
"2016","TEXAS","SABINE",614,39,3998,4651
"2016","TEXAS","SAN AUGUSTINE",910,37,2622,3569
"2016","TEXAS","SAN JACINTO",2038,246,8059,10343
"2016","TEXAS","SAN PATRICIO",7871,755,13030,21656
"2016","TEXAS","SAN SABA",293,39,2025,2357
"2016","TEXAS","SCHLEICHER",208,30,821,1059
"2016","TEXAS","SCURRY",733,146,4410,5289
"2016","TEXAS","SHACKELFORD",103,23,1378,1504
"2016","TEXAS","SHELBY",1758,149,7179,9086
"2016","TEXAS","SHERMAN",96,32,807,935
"2016","TEXAS","SMITH",22300,3538,58930,84768
"2016","TEXAS","SOMERVELL",541,150,3206,3897
"2016","TEXAS","STARR",9289,227,2224,11740
"2016","TEXAS","STEPHENS",348,79,3034,3461
"2016","TEXAS","STERLING",70,14,549,633
"2016","TEXAS","STONEWALL",135,11,555,701
"2016","TEXAS","SUTTON",313,28,1075,1416
"2016","TEXAS","SWISHER",462,71,1671,2204
"2016","TEXAS","TARRANT",288392,34201,345921,668514
"2016","TEXAS","TAYLOR",10085,2424,33250,45759
"2016","TEXAS","TERRELL",140,10,288,438
"2016","TEXAS","TERRY",753,143,2459,3355
"2016","TEXAS","THROCKMORTON",84,9,715,808
"2016","TEXAS","TITUS",2597,311,6511,9419
"2016","TEXAS","TOM GREEN",9173,1812,27494,38479
"2016","TEXAS","TRAVIS",308260,33251,127209,468720
"2016","TEXAS","TRINITY",1154,94,4737,5985
"2016","TEXAS","TYLER",1248,144,6624,8016
"2016","TEXAS","UPSHUR",2380,424,13209,16013
"2016","TEXAS","UPTON",286,54,1007,1347
"2016","TEXAS","UVALDE",3867,262,4835,8964
"2016","TEXAS","VAL VERDE",6964,763,5890,13617
"2016","TEXAS","VAN ZANDT",2799,618,18473,21890
"2016","TEXAS","VICTORIA",8866,982,21275,31123
"2016","TEXAS","WALKER",6091,821,12884,19796
"2016","TEXAS","WALLER",5748,505,10531,16784
"2016","TEXAS","WARD",783,115,2547,3445
"2016","TEXAS","WASHINGTON",3382,501,10945,14828
"2016","TEXAS","WEBB",42307,1651,12947,56905
"2016","TEXAS","WHARTON",4238,345,10149,14732
"2016","TEXAS","WHEELER",194,25,2087,2306
"2016","TEXAS","WICHITA",8770,1718,27631,38119
"2016","TEXAS","WILBARGER",809,130,3166,4105
"2016","TEXAS","WILLACY",3422,126,1547,5095
"2016","TEXAS","WILLIAMSON",84468,14438,104175,203081
"2016","TEXAS","WILSON",4790,644,13998,19432
"2016","TEXAS","WINKLER",420,53,1403,1876
"2016","TEXAS","WISE",3412,694,20670,24776
"2016","TEXAS","WOOD",2630,397,15700,18727
"2016","TEXAS","YOAKUM",426,80,1797,2303
"2016","TEXAS","YOUNG",876,230,6601,7707
"2016","TEXAS","ZAPATA",2063,50,1029,3142
"2016","TEXAS","ZAVALA",2636,66,694,3396
"2016","UTAH","BEAVER",264,389,1838,2491
"2016","UTAH","BOX ELDER",2282,5223,12230,19735
"2016","UTAH","CACHE",8563,16455,21139,46157
"2016","UTAH","CARBON",1717,960,5275,7952
"2016","UTAH","DAGGETT",77,66,331,474
"2016","UTAH","DAVIS",28776,47416,62219,138411
"2016","UTAH","DUCHESNE",500,934,5508,6942
"2016","UTAH","EMERY",380,484,3425,4289
"2016","UTAH","GARFIELD",358,380,1606,2344
"2016","UTAH","GRAND",1960,598,1975,4533
"2016","UTAH","IRON",2450,3643,11561,17654
"2016","UTAH","JUAB",442,908,2827,4177
"2016","UTAH","KANE",741,499,2265,3505
"2016","UTAH","MILLARD",431,951,3860,5242
"2016","UTAH","MORGAN",577,1427,3188,5192
"2016","UTAH","PIUTE",47,56,626,729
"2016","UTAH","RICH",104,208,797,1109
"2016","UTAH","SALT LAKE",175863,104962,138043,418868
"2016","UTAH","SAN JUAN",2042,760,2645,5447
"2016","UTAH","SANPETE",1061,2430,6673,10164
"2016","UTAH","SEVIER",695,1219,6740,8654
"2016","UTAH","SUMMIT",10503,2805,7333,20641
"2016","UTAH","TOOELE",4573,6087,11169,21829
"2016","UTAH","UINTAH",995,1992,9810,12797
"2016","UTAH","UTAH",28522,70847,102182,201551
"2016","UTAH","WASATCH",3063,2942,6115,12120
"2016","UTAH","WASHINGTON",10288,9025,42650,61963
"2016","UTAH","WAYNE",271,184,966,1421
"2016","UTAH","WEBER",23131,21673,40235,85039
"2016","VERMONT","ADDISON",11219,2515,5297,19031
"2016","VERMONT","BENNINGTON",9539,1917,5925,17381
"2016","VERMONT","CALEDONIA",6445,2096,5534,14075
"2016","VERMONT","CHITTENDEN",54814,10003,18601,83418
"2016","VERMONT","ESSEX",1019,400,1506,2925
"2016","VERMONT","FRANKLIN",9351,3308,8752,21411
"2016","VERMONT","GRAND ISLE",2094,529,1487,4110
"2016","VERMONT","LAMOILLE",7241,1951,3570,12762
"2016","VERMONT","ORANGE",7541,2101,5007,14649
"2016","VERMONT","ORLEANS",5185,1703,5159,12047
"2016","VERMONT","RUTLAND",13635,3505,12479,29619
"2016","VERMONT","WASHINGTON",18594,4499,7993,31086
"2016","VERMONT","WINDHAM",14340,2841,5454,22635
"2016","VERMONT","WINDSOR",17556,3767,8605,29928
"2016","VIRGINIA","ACCOMACK",6740,495,8583,15818
"2016","VIRGINIA","ALBEMARLE",33345,4122,19259,56726
"2016","VIRGINIA","ALEXANDRIA",57242,5243,13285,75770
"2016","VIRGINIA","ALLEGHANY",2166,285,4874,7325
"2016","VIRGINIA","AMELIA",2128,204,4708,7040
"2016","VIRGINIA","AMHERST",5057,620,9719,15396
"2016","VIRGINIA","APPOMATTOX",2023,273,5715,8011
"2016","VIRGINIA","ARLINGTON",92016,9154,20186,121356
"2016","VIRGINIA","AUGUSTA",8177,2003,26163,36343
"2016","VIRGINIA","BATH",603,102,1548,2253
"2016","VIRGINIA","BEDFORD",9768,2098,30659,42525
"2016","VIRGINIA","BLAND",453,113,2573,3139
"2016","VIRGINIA","BOTETOURT",4494,870,13375,18739
"2016","VIRGINIA","BRISTOL",1835,305,4892,7032
"2016","VIRGINIA","BRUNSWICK",4481,142,3046,7669
"2016","VIRGINIA","BUCHANAN",1721,230,7296,9247
"2016","VIRGINIA","BUCKINGHAM",3128,217,3950,7295
"2016","VIRGINIA","BUENA VISTA",693,284,1430,2407
"2016","VIRGINIA","CAMPBELL",6664,1320,19551,27535
"2016","VIRGINIA","CAROLINE",6432,1284,7147,14863
"2016","VIRGINIA","CARROLL",2559,446,10663,13668
"2016","VIRGINIA","CHARLES CITY",2496,135,1476,4107
"2016","VIRGINIA","CHARLOTTE",2155,174,3479,5808
"2016","VIRGINIA","CHARLOTTESVILLE",17901,1611,2960,22472
"2016","VIRGINIA","CHESAPEAKE",52627,6031,54047,112705
"2016","VIRGINIA","CHESTERFIELD",81074,10342,85045,176461
"2016","VIRGINIA","CLARKE",3051,501,4661,8213
"2016","VIRGINIA","COLONIAL HEIGHTS",2367,409,5681,8457
"2016","VIRGINIA","COVINGTON",914,119,1349,2382
"2016","VIRGINIA","CRAIG",541,113,2140,2794
"2016","VIRGINIA","CULPEPER",7759,1110,13349,22218
"2016","VIRGINIA","CUMBERLAND",2036,173,2697,4906
"2016","VIRGINIA","DANVILLE",11059,590,7303,18952
"2016","VIRGINIA","DICKENSON",1335,173,4932,6440
"2016","VIRGINIA","DINWIDDIE",5765,363,7447,13575
"2016","VIRGINIA","EMPORIA",1530,48,789,2367
"2016","VIRGINIA","ESSEX",2542,209,2657,5408
"2016","VIRGINIA","FAIRFAX",362500,39301,161412,563213
"2016","VIRGINIA","FALLS CHURCH",5819,614,1324,7757
"2016","VIRGINIA","FAUQUIER",12971,2369,22127,37467
"2016","VIRGINIA","FLOYD",2300,458,5293,8051
"2016","VIRGINIA","FLUVANNA",5760,812,7025,13597
"2016","VIRGINIA","FRANKLIN",9776,1275,19990,31041
"2016","VIRGINIA","FREDERICK",11932,2425,26083,40440
"2016","VIRGINIA","FREDERICKSBURG",6707,813,3744,11264
"2016","VIRGINIA","GALAX",681,92,1603,2376
"2016","VIRGINIA","GILES",1950,352,5910,8212
"2016","VIRGINIA","GLOUCESTER",5404,1119,13096,19619
"2016","VIRGINIA","GOOCHLAND",4889,764,8384,14037
"2016","VIRGINIA","GRAYSON",1407,286,5592,7285
"2016","VIRGINIA","GREENE",2924,739,5945,9608
"2016","VIRGINIA","GREENSVILLE",2558,68,1737,4363
"2016","VIRGINIA","HALIFAX",6897,400,9704,17001
"2016","VIRGINIA","HAMPTON",41312,3142,17902,62356
"2016","VIRGINIA","HANOVER",19382,3741,39630,62753
"2016","VIRGINIA","HARRISONBURG",10212,1519,6262,17993
"2016","VIRGINIA","HENRICO",93935,9862,59857,163654
"2016","VIRGINIA","HENRY",8198,700,15208,24106
"2016","VIRGINIA","HIGHLAND",371,62,958,1391
"2016","VIRGINIA","HOPEWELL",4724,399,3885,9008
"2016","VIRGINIA","ISLE OF WIGHT",7881,990,12204,21075
"2016","VIRGINIA","JAMES CITY",19105,2762,21306,43173
"2016","VIRGINIA","KING AND QUEEN",1468,130,2099,3697
"2016","VIRGINIA","KING GEORGE",4007,711,7341,12059
"2016","VIRGINIA","KING WILLIAM",2760,426,5975,9161
"2016","VIRGINIA","LANCASTER",2869,253,3523,6645
"2016","VIRGINIA","LEE",1627,229,7543,9399
"2016","VIRGINIA","LEXINGTON",1514,185,766,2465
"2016","VIRGINIA","LOUDOUN",100795,12353,69949,183097
"2016","VIRGINIA","LOUISA",6212,891,10528,17631
"2016","VIRGINIA","LUNENBURG",2227,155,3204,5586
"2016","VIRGINIA","LYNCHBURG",14792,2897,17982,35671
"2016","VIRGINIA","MADISON",2203,357,4419,6979
"2016","VIRGINIA","MANASSAS",8423,1035,5953,15411
"2016","VIRGINIA","MANASSAS PARK",3204,295,1733,5232
"2016","VIRGINIA","MARTINSVILLE",3533,225,2149,5907
"2016","VIRGINIA","MATHEWS",1563,231,3517,5311
"2016","VIRGINIA","MECKLENBURG",6285,372,8288,14945
"2016","VIRGINIA","MIDDLESEX",2108,239,3670,6017
"2016","VIRGINIA","MONTGOMERY",20021,3551,19459,43031
"2016","VIRGINIA","NELSON",3689,475,4154,8318
"2016","VIRGINIA","NEW KENT",3546,578,8118,12242
"2016","VIRGINIA","NEWPORT NEWS",45618,4629,25468,75715
"2016","VIRGINIA","NORFOLK",57023,4813,21552,83388
"2016","VIRGINIA","NORTHAMPTON",3255,231,2686,6172
"2016","VIRGINIA","NORTHUMBERLAND",2852,244,4302,7398
"2016","VIRGINIA","NORTON",383,56,1021,1460
"2016","VIRGINIA","NOTTOWAY",2829,203,3712,6744
"2016","VIRGINIA","ORANGE",5957,792,10521,17270
"2016","VIRGINIA","PAGE",2514,395,7831,10740
"2016","VIRGINIA","PATRICK",1768,303,6454,8525
"2016","VIRGINIA","PETERSBURG",12021,314,1451,13786
"2016","VIRGINIA","PITTSYLVANIA",9199,845,21554,31598
"2016","VIRGINIA","POQUOSON",1601,484,5092,7177
"2016","VIRGINIA","PORTSMOUTH",28497,1973,12795,43265
"2016","VIRGINIA","POWHATAN",4060,955,11885,16900
"2016","VIRGINIA","PRINCE EDWARD",4591,451,4101,9143
"2016","VIRGINIA","PRINCE GEORGE",6419,608,9157,16184
"2016","VIRGINIA","PRINCE WILLIAM",113144,11673,71721,196538
"2016","VIRGINIA","PULASKI",4172,673,10322,15167
"2016","VIRGINIA","RADFORD",2925,522,2638,6085
"2016","VIRGINIA","RAPPAHANNOCK",1747,197,2539,4483
"2016","VIRGINIA","RICHMOND",82606,6745,17794,107145
"2016","VIRGINIA","ROANOKE",39486,5272,46197,90955
"2016","VIRGINIA","ROCKBRIDGE",3508,607,6680,10795
"2016","VIRGINIA","ROCKINGHAM",9366,2131,25990,37487
"2016","VIRGINIA","RUSSELL",2330,395,9521,12246
"2016","VIRGINIA","SALEM",4202,797,7226,12225
"2016","VIRGINIA","SCOTT",1581,272,8247,10100
"2016","VIRGINIA","SHENANDOAH",5273,1146,14094,20513
"2016","VIRGINIA","SMYTH",2665,475,9750,12890
"2016","VIRGINIA","SOUTHAMPTON",3595,248,5035,8878
"2016","VIRGINIA","SPOTSYLVANIA",24207,3732,34623,62562
"2016","VIRGINIA","STAFFORD",27908,4158,33868,65934
"2016","VIRGINIA","STAUNTON",5333,789,5133,11255
"2016","VIRGINIA","SUFFOLK",23280,1954,18006,43240
"2016","VIRGINIA","SURRY",2272,137,1819,4228
"2016","VIRGINIA","SUSSEX",2879,110,2055,5044
"2016","VIRGINIA","TAZEWELL",2895,503,15168,18566
"2016","VIRGINIA","VIRGINIA BEACH",91032,14006,98224,203262
"2016","VIRGINIA","WARREN",5169,1018,11773,17960
"2016","VIRGINIA","WASHINGTON",5553,974,19320,25847
"2016","VIRGINIA","WAYNESBORO",3764,639,4801,9204
"2016","VIRGINIA","WESTMORELAND",3836,290,4448,8574
"2016","VIRGINIA","WILLIAMSBURG",5206,495,1925,7626
"2016","VIRGINIA","WINCHESTER",5164,713,4790,10667
"2016","VIRGINIA","WISE",2701,376,12086,15163
"2016","VIRGINIA","WYTHE",2770,527,10046,13343
"2016","VIRGINIA","YORK",12999,2282,18837,34118
"2016","WASHINGTON","ADAMS",1299,262,3083,4644
"2016","WASHINGTON","ASOTIN",3134,861,5741,9736
"2016","WASHINGTON","BENTON",26360,6473,47194,80027
"2016","WASHINGTON","CHELAN",13032,2234,18114,33380
"2016","WASHINGTON","CLALLAM",17677,2986,18794,39457
"2016","WASHINGTON","CLARK",92757,14962,92441,200160
"2016","WASHINGTON","COLUMBIA",526,159,1497,2182
"2016","WASHINGTON","COWLITZ",17908,3599,24185,45692
"2016","WASHINGTON","DOUGLAS",4918,1022,9603,15543
"2016","WASHINGTON","FERRY",1098,301,2202,3601
"2016","WASHINGTON","FRANKLIN",8886,1628,13206,23720
"2016","WASHINGTON","GARFIELD",279,116,851,1246
"2016","WASHINGTON","GRANT",7810,2018,18518,28346
"2016","WASHINGTON","GRAYS HARBOR",12020,2280,14067,28367
"2016","WASHINGTON","ISLAND",20960,3451,18465,42876
"2016","WASHINGTON","JEFFERSON",12656,1583,6037,20276
"2016","WASHINGTON","KING",718322,63838,216339,998499
"2016","WASHINGTON","KITSAP",63156,12143,49018,124317
"2016","WASHINGTON","KITTITAS",7489,1366,10100,18955
"2016","WASHINGTON","KLICKITAT",4194,786,5789,10769
"2016","WASHINGTON","LEWIS",9654,2503,21992,34149
"2016","WASHINGTON","LINCOLN",1244,361,4108,5713
"2016","WASHINGTON","MASON",11993,2403,13677,28073
"2016","WASHINGTON","OKANOGAN",6298,1183,9610,17091
"2016","WASHINGTON","PACIFIC",4620,736,5360,10716
"2016","WASHINGTON","PEND OREILLE",1934,495,4373,6802
"2016","WASHINGTON","PIERCE",172538,29123,146824,348485
"2016","WASHINGTON","SAN JUAN",7172,914,2688,10774
"2016","WASHINGTON","SKAGIT",26690,4542,24736,55968
"2016","WASHINGTON","SKAMANIA",2232,479,2928,5639
"2016","WASHINGTON","SNOHOMISH",185227,28691,128255,342173
"2016","WASHINGTON","SPOKANE",93767,20044,113435,227246
"2016","WASHINGTON","STEVENS",5767,1749,15161,22677
"2016","WASHINGTON","THURSTON",68798,11988,48624,129410
"2016","WASHINGTON","WAHKIAKUM",832,182,1344,2358
"2016","WASHINGTON","WALLA WALLA",9694,2074,13651,25419
"2016","WASHINGTON","WHATCOM",60340,8734,40599,109673
"2016","WASHINGTON","WHITMAN",8146,1756,7403,17305
"2016","WASHINGTON","YAKIMA",31291,4724,41735,77750
"2016","WEST VIRGINIA","BARBOUR",1222,305,4527,6054
"2016","WEST VIRGINIA","BERKELEY",12321,2285,28244,42850
"2016","WEST VIRGINIA","BOONE",1790,389,6504,8683
"2016","WEST VIRGINIA","BRAXTON",1321,232,3537,5090
"2016","WEST VIRGINIA","BROOKE",2568,420,6625,9613
"2016","WEST VIRGINIA","CABELL",11447,1788,19850,33085
"2016","WEST VIRGINIA","CALHOUN",456,126,2035,2617
"2016","WEST VIRGINIA","CLAY",568,104,2300,2972
"2016","WEST VIRGINIA","DODDRIDGE",362,120,2358,2840
"2016","WEST VIRGINIA","FAYETTE",4290,690,10357,15337
"2016","WEST VIRGINIA","GILMER",545,102,1896,2543
"2016","WEST VIRGINIA","GRANT",512,98,4346,4956
"2016","WEST VIRGINIA","GREENBRIER",3765,745,9556,14066
"2016","WEST VIRGINIA","HAMPSHIRE",1580,336,6692,8608
"2016","WEST VIRGINIA","HANCOCK",3262,531,8909,12702
"2016","WEST VIRGINIA","HARDY",1155,214,4274,5643
"2016","WEST VIRGINIA","HARRISON",7694,1516,18750,27960
"2016","WEST VIRGINIA","JACKSON",2663,504,9020,12187
"2016","WEST VIRGINIA","JEFFERSON",9518,1425,13204,24147
"2016","WEST VIRGINIA","KANAWHA",28263,3577,43850,75690
"2016","WEST VIRGINIA","LEWIS",1347,307,5274,6928
"2016","WEST VIRGINIA","LINCOLN",1459,300,5307,7066
"2016","WEST VIRGINIA","LOGAN",2092,370,9897,12359
"2016","WEST VIRGINIA","MARION",6964,1397,14668,23029
"2016","WEST VIRGINIA","MARSHALL",2918,632,9666,13216
"2016","WEST VIRGINIA","MASON",2081,451,7654,10186
"2016","WEST VIRGINIA","MCDOWELL",1438,136,4629,6203
"2016","WEST VIRGINIA","MERCER",4704,874,17404,22982
"2016","WEST VIRGINIA","MINERAL",2050,444,9070,11564
"2016","WEST VIRGINIA","MINGO",1370,229,7911,9510
"2016","WEST VIRGINIA","MONONGALIA",14699,2917,18432,36048
"2016","WEST VIRGINIA","MONROE",1111,251,4443,5805
"2016","WEST VIRGINIA","MORGAN",1573,349,5732,7654
"2016","WEST VIRGINIA","NICHOLAS",1840,400,7251,9491
"2016","WEST VIRGINIA","OHIO",5493,1306,11139,17938
"2016","WEST VIRGINIA","PENDLETON",729,98,2398,3225
"2016","WEST VIRGINIA","PLEASANTS",621,171,2358,3150
"2016","WEST VIRGINIA","POCAHONTAS",928,222,2496,3646
"2016","WEST VIRGINIA","PRESTON",2470,651,9538,12659
"2016","WEST VIRGINIA","PUTNAM",5884,1221,17788,24893
"2016","WEST VIRGINIA","RALEIGH",6443,1127,22048,29618
"2016","WEST VIRGINIA","RANDOLPH",2735,512,7629,10876
"2016","WEST VIRGINIA","RITCHIE",496,174,3405,4075
"2016","WEST VIRGINIA","ROANE",1222,244,3781,5247
"2016","WEST VIRGINIA","SUMMERS",1190,217,3455,4862
"2016","WEST VIRGINIA","TAYLOR",1491,314,4733,6538
"2016","WEST VIRGINIA","TUCKER",751,159,2565,3475
"2016","WEST VIRGINIA","TYLER",507,151,2996,3654
"2016","WEST VIRGINIA","UPSHUR",1766,447,7005,9218
"2016","WEST VIRGINIA","WAYNE",3357,673,11152,15182
"2016","WEST VIRGINIA","WEBSTER",556,120,2302,2978
"2016","WEST VIRGINIA","WETZEL",1359,387,4519,6265
"2016","WEST VIRGINIA","WIRT",386,125,1911,2422
"2016","WEST VIRGINIA","WOOD",8400,1781,25434,35615
"2016","WEST VIRGINIA","WYOMING",1062,222,6547,7831
"2016","WISCONSIN","ADAMS",3770,411,5983,10164
"2016","WISCONSIN","ASHLAND",4228,499,3302,8029
"2016","WISCONSIN","BARRON",7879,1158,13606,22643
"2016","WISCONSIN","BAYFIELD",4954,450,4125,9529
"2016","WISCONSIN","BROWN",53364,8416,67199,128979
"2016","WISCONSIN","BUFFALO",2531,408,4049,6988
"2016","WISCONSIN","BURNETT",2948,383,5412,8743
"2016","WISCONSIN","CALUMET",9646,1656,15348,26650
"2016","WISCONSIN","CHIPPEWA",11886,1766,17909,31561
"2016","WISCONSIN","CLARK",4227,723,8646,13596
"2016","WISCONSIN","COLUMBIA",13526,2085,14160,29771
"2016","WISCONSIN","CRAWFORD",3425,475,3844,7744
"2016","WISCONSIN","DANE",217526,21212,71279,310017
"2016","WISCONSIN","DODGE",13968,2454,26643,43065
"2016","WISCONSIN","DOOR",8026,998,8584,17608
"2016","WISCONSIN","DOUGLAS",11345,1507,9659,22511
"2016","WISCONSIN","DUNN",9026,1577,11488,22091
"2016","WISCONSIN","EAU CLAIRE",27294,4280,23311,54885
"2016","WISCONSIN","FLORENCE",666,94,1897,2657
"2016","WISCONSIN","FOND DU LAC",17391,2892,31044,51327
"2016","WISCONSIN","FOREST",1584,168,2788,4540
"2016","WISCONSIN","GRANT",10046,1926,12349,24321
"2016","WISCONSIN","GREEN",9122,1170,8693,18985
"2016","WISCONSIN","GREEN LAKE",2701,474,6213,9388
"2016","WISCONSIN","IOWA",6669,782,4809,12260
"2016","WISCONSIN","IRON",1273,134,2090,3497
"2016","WISCONSIN","JACKSON",3821,544,4907,9272
"2016","WISCONSIN","JEFFERSON",16561,3175,23410,43146
"2016","WISCONSIN","JUNEAU",4073,536,7123,11732
"2016","WISCONSIN","KENOSHA",35771,5280,36025,77076
"2016","WISCONSIN","KEWAUNEE",3623,519,6616,10758
"2016","WISCONSIN","LA CROSSE",32406,4173,26389,62968
"2016","WISCONSIN","LAFAYETTE",3288,397,3977,7662
"2016","WISCONSIN","LANGLADE",3260,436,6436,10132
"2016","WISCONSIN","LINCOLN",5370,936,8400,14706
"2016","WISCONSIN","MANITOWOC",14506,2647,23193,40346
"2016","WISCONSIN","MARATHON",26477,4025,39013,69515
"2016","WISCONSIN","MARINETTE",6243,808,12995,20046
"2016","WISCONSIN","MARQUETTE",2809,370,4714,7893
"2016","WISCONSIN","MENOMINEE",1003,7,269,1279
"2016","WISCONSIN","MILWAUKEE",288797,25604,125846,440247
"2016","WISCONSIN","MONROE",7048,1270,11352,19670
"2016","WISCONSIN","OCONTO",5884,841,13253,19978
"2016","WISCONSIN","ONEIDA",8104,1252,12117,21473
"2016","WISCONSIN","OUTAGAMIE",38087,5897,49884,93868
"2016","WISCONSIN","OZAUKEE",20168,3925,30430,54523
"2016","WISCONSIN","PEPIN",1345,188,2206,3739
"2016","WISCONSIN","PIERCE",8382,1549,11258,21189
"2016","WISCONSIN","POLK",7570,1364,13815,22749
"2016","WISCONSIN","PORTAGE",18521,2669,17306,38496
"2016","WISCONSIN","PRICE",2669,346,4562,7577
"2016","WISCONSIN","RACINE",42512,5010,46611,94133
"2016","WISCONSIN","RICHLAND",3577,455,4023,8055
"2016","WISCONSIN","ROCK",39343,5237,31488,76068
"2016","WISCONSIN","RUSK",2171,352,4564,7087
"2016","WISCONSIN","SAUK",14692,1835,14791,31318
"2016","WISCONSIN","SAWYER",3504,432,5185,9121
"2016","WISCONSIN","SHAWANO",6056,953,12742,19751
"2016","WISCONSIN","SHEBOYGAN",22956,4241,32458,59655
"2016","WISCONSIN","ST. CROIX",17486,3802,26220,47508
"2016","WISCONSIN","TAYLOR",2398,497,6589,9484
"2016","WISCONSIN","TREMPEALEAU",5636,675,7364,13675
"2016","WISCONSIN","VERNON",6352,865,6996,14213
"2016","WISCONSIN","VILAS",4770,673,8169,13612
"2016","WISCONSIN","WALWORTH",18706,3767,28851,51324
"2016","WISCONSIN","WASHBURN",3284,460,5404,9148
"2016","WISCONSIN","WASHINGTON",20855,5419,51729,78003
"2016","WISCONSIN","WAUKESHA",79200,17321,142521,239042
"2016","WISCONSIN","WAUPACA",8440,1395,16189,26024
"2016","WISCONSIN","WAUSHARA",3792,538,7669,11999
"2016","WISCONSIN","WINNEBAGO",37054,6642,43448,87144
"2016","WISCONSIN","WOOD",14232,2065,21503,37800
"2016","WYOMING","ALBANY",6890,2568,7602,17060
"2016","WYOMING","BIG HORN",604,646,4067,5317
"2016","WYOMING","CAMPBELL",1324,1097,15778,18199
"2016","WYOMING","CARBON",1279,686,4409,6374
"2016","WYOMING","CONVERSE",668,466,5520,6654
"2016","WYOMING","CROOK",273,205,3348,3826
"2016","WYOMING","FREMONT",4200,1656,11167,17023
"2016","WYOMING","GOSHEN",924,454,4418,5796
"2016","WYOMING","HOT SPRINGS",400,247,1939,2586
"2016","WYOMING","JOHNSON",638,302,3477,4417
"2016","WYOMING","LARAMIE",11573,4549,24847,40969
"2016","WYOMING","LINCOLN",1105,991,6779,8875
"2016","WYOMING","NATRONA",6577,3219,23552,33348
"2016","WYOMING","NIOBRARA",115,83,1116,1314
"2016","WYOMING","PARK",2535,1445,11115,15095
"2016","WYOMING","PLATTE",719,373,3437,4529
"2016","WYOMING","SHERIDAN",2927,1317,10266,14510
"2016","WYOMING","SUBLETTE",644,337,3409,4390
"2016","WYOMING","SWEETWATER",3231,1745,12154,17130
"2016","WYOMING","TETON",7314,1392,3921,12627
"2016","WYOMING","UINTA",1202,1114,6154,8470
"2016","WYOMING","WASHAKIE",532,371,2911,3814
"2016","WYOMING","WESTON",299,194,3033,3526
"2020","ALABAMA","AUTAUGA",7503,429,19838,27770
"2020","ALABAMA","BALDWIN",24578,1557,83544,109679
"2020","ALABAMA","BARBOUR",4816,80,5622,10518
"2020","ALABAMA","BIBB",1986,84,7525,9595
"2020","ALABAMA","BLOUNT",2640,237,24711,27588
"2020","ALABAMA","BULLOCK",3446,21,1146,4613
"2020","ALABAMA","BUTLER",3965,65,5458,9488
"2020","ALABAMA","CALHOUN",15216,666,35101,50983
"2020","ALABAMA","CHAMBERS",6365,166,8753,15284
"2020","ALABAMA","CHEROKEE",1624,94,10583,12301
"2020","ALABAMA","CHILTON",3073,152,16085,19310
"2020","ALABAMA","CHOCTAW",3127,41,4296,7464
"2020","ALABAMA","CLARKE",5755,56,7324,13135
"2020","ALABAMA","CLAY",1267,62,5601,6930
"2020","ALABAMA","CLEBURNE",675,68,6484,7227
"2020","ALABAMA","COFFEE",5076,300,16899,22275
"2020","ALABAMA","COLBERT",8343,340,19203,27886
"2020","ALABAMA","CONECUH",2966,33,3442,6441
"2020","ALABAMA","COOSA",1796,52,3631,5479
"2020","ALABAMA","COVINGTON",2721,123,14586,17430
"2020","ALABAMA","CRENSHAW",1700,53,4864,6617
"2020","ALABAMA","CULLMAN",4478,493,36880,41851
"2020","ALABAMA","DALE",5170,265,14303,19738
"2020","ALABAMA","DALLAS",12230,110,5524,17864
"2020","ALABAMA","DEKALB",4281,308,24767,29356
"2020","ALABAMA","ELMORE",10367,499,30164,41030
"2020","ALABAMA","ESCAMBIA",4918,123,10869,15910
"2020","ALABAMA","ETOWAH",11567,633,35528,47728
"2020","ALABAMA","FAYETTE",1395,71,7300,8766
"2020","ALABAMA","FRANKLIN",2086,116,10376,12578
"2020","ALABAMA","GENEVA",1595,102,10848,12545
"2020","ALABAMA","GREENE",3884,16,875,4775
"2020","ALABAMA","HALE",4663,45,3192,7900
"2020","ALABAMA","HENRY",2606,85,6607,9298
"2020","ALABAMA","HOUSTON",12917,638,32618,46173
"2020","ALABAMA","JACKSON",3717,249,19670,23636
"2020","ALABAMA","JEFFERSON",181688,5317,138843,325848
"2020","ALABAMA","LAMAR",978,41,6174,7193
"2020","ALABAMA","LAUDERDALE",11915,703,31721,44339
"2020","ALABAMA","LAWRENCE",3562,147,12322,16031
"2020","ALABAMA","LEE",27860,1368,42221,71449
"2020","ALABAMA","LIMESTONE",13672,923,34640,49235
"2020","ALABAMA","LOWNDES",4972,27,1836,6835
"2020","ALABAMA","MACON",7108,74,1541,8723
"2020","ALABAMA","MADISON",87286,4701,102780,194767
"2020","ALABAMA","MARENGO",5488,69,5343,10900
"2020","ALABAMA","MARION",1463,139,12205,13807
"2020","ALABAMA","MARSHALL",5943,521,33191,39655
"2020","ALABAMA","MOBILE",79474,2447,101243,183164
"2020","ALABAMA","MONROE",4455,66,6147,10668
"2020","ALABAMA","MONTGOMERY",64529,1299,33311,99139
"2020","ALABAMA","MORGAN",13234,824,39664,53722
"2020","ALABAMA","PERRY",3860,31,1339,5230
"2020","ALABAMA","PICKENS",4022,52,5594,9668
"2020","ALABAMA","PIKE",5636,163,8042,13841
"2020","ALABAMA","RANDOLPH",2203,75,8559,10837
"2020","ALABAMA","RUSSELL",11228,237,9864,21329
"2020","ALABAMA","SHELBY",33268,1982,79700,114950
"2020","ALABAMA","ST. CLAIR",7744,531,36166,44441
"2020","ALABAMA","SUMTER",4648,45,1598,6291
"2020","ALABAMA","TALLADEGA",13138,290,22235,35663
"2020","ALABAMA","TALLAPOOSA",5859,169,14963,20991
"2020","ALABAMA","TUSCALOOSA",37765,1290,51117,90172
"2020","ALABAMA","WALKER",4834,334,26002,31170
"2020","ALABAMA","WASHINGTON",2258,54,6564,8876
"2020","ALABAMA","WILCOX",4048,22,1833,5903
"2020","ALABAMA","WINSTON",974,115,10195,11284
"2020","ALASKA","DISTRICT 1",3477,326,3511,7314
"2020","ALASKA","DISTRICT 10",2727,397,8081,11205
"2020","ALASKA","DISTRICT 11",3130,402,7096,10628
"2020","ALASKA","DISTRICT 12",2957,388,7893,11238
"2020","ALASKA","DISTRICT 13",2666,395,4652,7713
"2020","ALASKA","DISTRICT 14",4261,468,6714,11443
"2020","ALASKA","DISTRICT 15",2622,266,2671,5559
"2020","ALASKA","DISTRICT 16",4274,328,3516,8118
"2020","ALASKA","DISTRICT 17",4136,293,2810,7239
"2020","ALASKA","DISTRICT 18",4681,279,2760,7720
"2020","ALASKA","DISTRICT 19",3118,208,1975,5301
"2020","ALASKA","DISTRICT 2",2104,358,3674,6136
"2020","ALASKA","DISTRICT 20",4881,233,2383,7497
"2020","ALASKA","DISTRICT 21",5414,325,3690,9429
"2020","ALASKA","DISTRICT 22",4553,283,4684,9520
"2020","ALASKA","DISTRICT 23",3810,274,3655,7739
"2020","ALASKA","DISTRICT 24",4736,314,5378,10428
"2020","ALASKA","DISTRICT 25",4600,318,4407,9325
"2020","ALASKA","DISTRICT 26",4558,310,5243,10111
"2020","ALASKA","DISTRICT 27",4844,338,4324,9506
"2020","ALASKA","DISTRICT 28",6264,323,6162,12749
"2020","ALASKA","DISTRICT 29",2985,298,7464,10747
"2020","ALASKA","DISTRICT 3",1903,406,6076,8385
"2020","ALASKA","DISTRICT 30",2638,358,7180,10176
"2020","ALASKA","DISTRICT 31",5037,402,6971,12410
"2020","ALASKA","DISTRICT 32",3506,389,4440,8335
"2020","ALASKA","DISTRICT 33",7535,361,3059,10955
"2020","ALASKA","DISTRICT 34",5763,423,4543,10729
"2020","ALASKA","DISTRICT 35",5011,322,4769,10102
"2020","ALASKA","DISTRICT 36",3796,382,5114,9292
"2020","ALASKA","DISTRICT 37",2560,224,2358,5142
"2020","ALASKA","DISTRICT 38",3202,360,1737,5299
"2020","ALASKA","DISTRICT 39",3580,372,1939,5891
"2020","ALASKA","DISTRICT 4",5345,476,4690,10511
"2020","ALASKA","DISTRICT 40",2318,291,1994,4603
"2020","ALASKA","DISTRICT 5",4204,373,4077,8654
"2020","ALASKA","DISTRICT 6",3272,418,5770,9460
"2020","ALASKA","DISTRICT 7",2215,380,7027,9622
"2020","ALASKA","DISTRICT 8",1953,341,7618,9912
"2020","ALASKA","DISTRICT 9",2769,437,7787,10993
"2020","ALASKA","DISTRICT 99",373,1,59,433
"2020","ARIZONA","APACHE",23293,437,11442,35172
"2020","ARIZONA","COCHISE",23732,1153,35557,60442
"2020","ARIZONA","COCONINO",44698,1522,27052,73272
"2020","ARIZONA","GILA",8943,342,18377,27662
"2020","ARIZONA","GRAHAM",4034,212,10749,14995
"2020","ARIZONA","GREENLEE",1182,70,2433,3685
"2020","ARIZONA","LA PAZ",2236,93,5129,7458
"2020","ARIZONA","MARICOPA",1040774,31705,995665,2068144
"2020","ARIZONA","MOHAVE",24831,1302,78535,104668
"2020","ARIZONA","NAVAJO",23383,727,27657,51767
"2020","ARIZONA","PIMA",304981,7658,207758,520397
"2020","ARIZONA","PINAL",75106,2791,107077,184974
"2020","ARIZONA","SANTA CRUZ",13138,224,6194,19556
"2020","ARIZONA","YAVAPAI",49602,2092,91527,143221
"2020","ARIZONA","YUMA",32210,1137,36534,69881
"2020","ARKANSAS","ARKANSAS",1818,170,4304,6292
"2020","ARKANSAS","ASHLEY",2125,253,5548,7926
"2020","ARKANSAS","BAXTER",4635,536,15836,21007
"2020","ARKANSAS","BENTON",42249,3698,73965,119912
"2020","ARKANSAS","BOONE",3064,398,13652,17114
"2020","ARKANSAS","BRADLEY",1214,105,2335,3654
"2020","ARKANSAS","CALHOUN",479,67,1636,2182
"2020","ARKANSAS","CARROLL",4023,350,7424,11797
"2020","ARKANSAS","CHICOT",2260,91,1752,4103
"2020","ARKANSAS","CLARK",3438,341,4616,8395
"2020","ARKANSAS","CLAY",962,135,4086,5183
"2020","ARKANSAS","CLEBURNE",1988,364,10328,12680
"2020","ARKANSAS","CLEVELAND",651,82,2867,3600
"2020","ARKANSAS","COLUMBIA",2814,302,5500,8616
"2020","ARKANSAS","CONWAY",2615,376,5694,8685
"2020","ARKANSAS","CRAIGHEAD",11921,1032,25558,38511
"2020","ARKANSAS","CRAWFORD",4959,525,18607,24091
"2020","ARKANSAS","CRITTENDEN",8514,520,7333,16367
"2020","ARKANSAS","CROSS",1772,224,4946,6942
"2020","ARKANSAS","DALLAS",963,113,1573,2649
"2020","ARKANSAS","DESHA",2016,227,1921,4164
"2020","ARKANSAS","DREW",2426,133,4349,6908
"2020","ARKANSAS","FAULKNER",18347,1660,34421,54428
"2020","ARKANSAS","FRANKLIN",1300,152,5677,7129
"2020","ARKANSAS","FULTON",1035,123,3961,5119
"2020","ARKANSAS","GARLAND",14045,1085,29069,44199
"2020","ARKANSAS","GRANT",1268,138,6794,8200
"2020","ARKANSAS","GREENE",3058,372,12670,16100
"2020","ARKANSAS","HEMPSTEAD",2138,240,4470,6848
"2020","ARKANSAS","HOT SPRING",3082,273,9202,12557
"2020","ARKANSAS","HOWARD",1340,127,3367,4834
"2020","ARKANSAS","INDEPENDENCE",2806,456,11250,14512
"2020","ARKANSAS","IZARD",1021,158,4631,5810
"2020","ARKANSAS","JACKSON",1365,133,3593,5091
"2020","ARKANSAS","JEFFERSON",14981,656,9521,25158
"2020","ARKANSAS","JOHNSON",2283,277,6938,9498
"2020","ARKANSAS","LAFAYETTE",839,83,1757,2679
"2020","ARKANSAS","LAWRENCE",1080,208,4569,5857
"2020","ARKANSAS","LEE",1423,139,1286,2848
"2020","ARKANSAS","LINCOLN",1032,114,2729,3875
"2020","ARKANSAS","LITTLE RIVER",1226,236,3715,5177
"2020","ARKANSAS","LOGAN",1544,240,6441,8225
"2020","ARKANSAS","LONOKE",6686,1092,22884,30662
"2020","ARKANSAS","MADISON",1563,130,5658,7351
"2020","ARKANSAS","MARION",1531,189,5783,7503
"2020","ARKANSAS","MILLER",4245,364,11920,16529
"2020","ARKANSAS","MISSISSIPPI",4558,488,7296,12342
"2020","ARKANSAS","MONROE",1147,124,1545,2816
"2020","ARKANSAS","MONTGOMERY",731,96,3046,3873
"2020","ARKANSAS","NEVADA",1076,149,2133,3358
"2020","ARKANSAS","NEWTON",709,97,3192,3998
"2020","ARKANSAS","OUACHITA",3995,340,5294,9629
"2020","ARKANSAS","PERRY",1012,136,3479,4627
"2020","ARKANSAS","PHILLIPS",3623,202,2417,6242
"2020","ARKANSAS","PIKE",644,83,3519,4246
"2020","ARKANSAS","POINSETT",1424,179,5918,7521
"2020","ARKANSAS","POLK",1246,209,7035,8490
"2020","ARKANSAS","POPE",5772,579,18081,24432
"2020","ARKANSAS","PRAIRIE",654,55,2786,3495
"2020","ARKANSAS","PULASKI",101947,4322,63687,169956
"2020","ARKANSAS","RANDOLPH",1215,242,5355,6812
"2020","ARKANSAS","SALINE",16060,1343,39556,56959
"2020","ARKANSAS","SCOTT",483,106,2962,3551
"2020","ARKANSAS","SEARCY",588,66,3365,4019
"2020","ARKANSAS","SEBASTIAN",14487,1455,31198,47140
"2020","ARKANSAS","SEVIER",1116,202,3884,5202
"2020","ARKANSAS","SHARP",1398,230,5938,7566
"2020","ARKANSAS","ST. FRANCIS",3604,262,3242,7108
"2020","ARKANSAS","STONE",1180,142,4616,5938
"2020","ARKANSAS","UNION",5584,545,10478,16607
"2020","ARKANSAS","VAN BUREN",1593,180,6034,7807
"2020","ARKANSAS","WASHINGTON",43824,2938,47504,94266
"2020","ARKANSAS","WHITE",5978,725,24182,30885
"2020","ARKANSAS","WOODRUFF",856,77,1543,2476
"2020","ARKANSAS","YELL",1284,231,5226,6741
"2020","CALIFORNIA","ALAMEDA",617659,16102,136309,770070
"2020","CALIFORNIA","ALPINE",476,21,244,741
"2020","CALIFORNIA","AMADOR",8153,566,13585,22304
"2020","CALIFORNIA","BUTTE",50426,2910,48730,102066
"2020","CALIFORNIA","CALAVERAS",10046,600,16518,27164
"2020","CALIFORNIA","COLUSA",3239,163,4559,7961
"2020","CALIFORNIA","CONTRA COSTA",416386,12053,152877,581316
"2020","CALIFORNIA","DEL NORTE",4677,315,6461,11453
"2020","CALIFORNIA","EL DORADO",51621,2700,61838,116159
"2020","CALIFORNIA","FRESNO",193025,7428,164464,364917
"2020","CALIFORNIA","GLENN",3995,239,7063,11297
"2020","CALIFORNIA","HUMBOLDT",44768,2305,21770,68843
"2020","CALIFORNIA","IMPERIAL",34678,1218,20847,56743
"2020","CALIFORNIA","INYO",4634,230,4620,9484
"2020","CALIFORNIA","KERN",133366,7442,164484,305292
"2020","CALIFORNIA","KINGS",18699,1090,24072,43861
"2020","CALIFORNIA","LAKE",14941,748,13123,28812
"2020","CALIFORNIA","LASSEN",2799,218,8970,11987
"2020","CALIFORNIA","LOS ANGELES",3028885,89950,1145530,4264365
"2020","CALIFORNIA","MADERA",23168,1186,29378,53732
"2020","CALIFORNIA","MARIN",128288,2930,24612,155830
"2020","CALIFORNIA","MARIPOSA",4088,242,5950,10280
"2020","CALIFORNIA","MENDOCINO",28782,1291,13267,43340
"2020","CALIFORNIA","MERCED",48991,2166,39397,90554
"2020","CALIFORNIA","MODOC",1150,84,3109,4343
"2020","CALIFORNIA","MONO",4013,212,2513,6738
"2020","CALIFORNIA","MONTEREY",113953,3671,46299,163923
"2020","CALIFORNIA","NAPA",49817,1657,20676,72150
"2020","CALIFORNIA","NEVADA",36359,1612,26779,64750
"2020","CALIFORNIA","ORANGE",814009,31606,676498,1522113
"2020","CALIFORNIA","PLACER",106869,5727,122488,235084
"2020","CALIFORNIA","PLUMAS",4561,254,6445,11260
"2020","CALIFORNIA","RIVERSIDE",528340,19672,449144,997156
"2020","CALIFORNIA","SACRAMENTO",440808,18227,259405,718440
"2020","CALIFORNIA","SAN BENITO",17628,612,10590,28830
"2020","CALIFORNIA","SAN BERNARDINO",455859,19014,366257,841130
"2020","CALIFORNIA","SAN DIEGO",964650,37399,600094,1602143
"2020","CALIFORNIA","SAN FRANCISCO",378156,8980,56417,443553
"2020","CALIFORNIA","SAN JOAQUIN",161137,6257,121098,288492
"2020","CALIFORNIA","SAN LUIS OBISPO",88310,3968,67436,159714
"2020","CALIFORNIA","SAN MATEO",291496,7171,75584,374251
"2020","CALIFORNIA","SANTA BARBARA",129963,4640,65736,200339
"2020","CALIFORNIA","SANTA CLARA",617967,18162,214612,850741
"2020","CALIFORNIA","SANTA CRUZ",114246,3654,26937,144837
"2020","CALIFORNIA","SHASTA",30000,2141,60789,92930
"2020","CALIFORNIA","SIERRA",730,59,1142,1931
"2020","CALIFORNIA","SISKIYOU",9593,589,13290,23472
"2020","CALIFORNIA","SOLANO",131639,4932,69306,205877
"2020","CALIFORNIA","SONOMA",199938,6554,61825,268317
"2020","CALIFORNIA","STANISLAUS",105841,4968,104145,214954
"2020","CALIFORNIA","SUTTER",17367,902,24375,42644
"2020","CALIFORNIA","TEHAMA",8911,679,19141,28731
"2020","CALIFORNIA","TRINITY",2851,220,3188,6259
"2020","CALIFORNIA","TULARE",66105,3201,77579,146885
"2020","CALIFORNIA","TUOLUMNE",11978,741,17689,30408
"2020","CALIFORNIA","VENTURA",251388,9230,162207,422825
"2020","CALIFORNIA","YOLO",67598,2404,27292,97294
"2020","CALIFORNIA","YUBA",11230,890,17676,29796
"2020","COLORADO","ADAMS",134202,6881,95657,236740
"2020","COLORADO","ALAMOSA",3759,236,3813,7808
"2020","COLORADO","ARAPAHOE",213607,9253,127323,350183
"2020","COLORADO","ARCHULETA",3738,217,5189,9144
"2020","COLORADO","BACA",317,41,1867,2225
"2020","COLORADO","BENT",732,39,1503,2274
"2020","COLORADO","BOULDER",159089,4521,42501,206111
"2020","COLORADO","BROOMFIELD",29077,1260,16295,46632
"2020","COLORADO","CHAFFEE",7160,336,6222,13718
"2020","COLORADO","CHEYENNE",131,12,993,1136
"2020","COLORADO","CLEAR CREEK",3604,190,2754,6548
"2020","COLORADO","CONEJOS",1959,88,2286,4333
"2020","COLORADO","COSTILLA",1311,42,741,2094
"2020","COLORADO","CROWLEY",437,42,1271,1750
"2020","COLORADO","CUSTER",1112,49,2474,3635
"2020","COLORADO","DELTA",5887,402,13081,19370
"2020","COLORADO","DENVER",313293,8918,71618,393829
"2020","COLORADO","DOLORES",341,19,1089,1449
"2020","COLORADO","DOUGLAS",104653,5682,121270,231605
"2020","COLORADO","EAGLE",18588,660,9892,29140
"2020","COLORADO","EL PASO",161941,14082,202828,378851
"2020","COLORADO","ELBERT",4490,466,14027,18983
"2020","COLORADO","FREMONT",7369,671,17517,25557
"2020","COLORADO","GARFIELD",15427,760,14717,30904
"2020","COLORADO","GILPIN",2223,130,1833,4186
"2020","COLORADO","GRAND",4710,277,4883,9870
"2020","COLORADO","GUNNISON",7132,323,3735,11190
"2020","COLORADO","HINSDALE",255,24,353,632
"2020","COLORADO","HUERFANO",2076,127,2203,4406
"2020","COLORADO","JACKSON",175,20,681,876
"2020","COLORADO","JEFFERSON",218396,10545,148417,377358
"2020","COLORADO","KIOWA",98,10,795,903
"2020","COLORADO","KIT CARSON",662,65,3144,3871
"2020","COLORADO","LA PLATA",20548,886,14233,35667
"2020","COLORADO","LAKE",2303,161,1497,3961
"2020","COLORADO","LARIMER",126120,6729,91489,224338
"2020","COLORADO","LAS ANIMAS",3497,180,4284,7961
"2020","COLORADO","LINCOLN",470,46,2135,2651
"2020","COLORADO","LOGAN",2218,227,8087,10532
"2020","COLORADO","MESA",31536,2193,56894,90623
"2020","COLORADO","MINERAL",317,12,427,756
"2020","COLORADO","MOFFAT",1203,153,5670,7026
"2020","COLORADO","MONTEZUMA",5836,358,9306,15500
"2020","COLORADO","MONTROSE",7687,465,16770,24922
"2020","COLORADO","MORGAN",3876,275,9593,13744
"2020","COLORADO","OTERO",3605,215,5756,9576
"2020","COLORADO","OURAY",2365,78,1577,4020
"2020","COLORADO","PARK",4903,397,6991,12291
"2020","COLORADO","PHILLIPS",486,41,1958,2485
"2020","COLORADO","PITKIN",8989,188,2780,11957
"2020","COLORADO","PROWERS",1458,95,4008,5561
"2020","COLORADO","PUEBLO",43772,2277,42252,88301
"2020","COLORADO","RIO BLANCO",561,69,3061,3691
"2020","COLORADO","RIO GRANDE",2495,150,3660,6305
"2020","COLORADO","ROUTT",10582,369,5925,16876
"2020","COLORADO","SAGUACHE",1884,92,1413,3389
"2020","COLORADO","SAN JUAN",342,18,202,562
"2020","COLORADO","SAN MIGUEL",3924,87,1136,5147
"2020","COLORADO","SEDGWICK",301,24,1121,1446
"2020","COLORADO","SUMMIT",12631,526,5322,18479
"2020","COLORADO","TELLER",5278,420,11241,16939
"2020","COLORADO","WASHINGTON",369,44,2595,3008
"2020","COLORADO","WELD",66060,4769,96145,166974
"2020","COLORADO","YUMA",785,89,4107,4981
"2020","CONNECTICUT","FAIRFIELD",297505,6446,168445,472396
"2020","CONNECTICUT","HARTFORD",283368,6944,159024,449336
"2020","CONNECTICUT","LITCHFIELD",50164,1779,55601,107544
"2020","CONNECTICUT","MIDDLESEX",56848,1685,40665,99198
"2020","CONNECTICUT","NEW HAVEN",242630,5460,169893,417983
"2020","CONNECTICUT","NEW LONDON",79459,3035,57110,139604
"2020","CONNECTICUT","TOLLAND",44151,1725,34838,80714
"2020","CONNECTICUT","WINDHAM",26706,1235,29141,57082
"2020","DELAWARE","KENT",44552,1464,41009,87025
"2020","DELAWARE","NEW CASTLE",195034,4235,88364,287633
"2020","DELAWARE","SUSSEX",56682,1440,71230,129352
"2020","DISTRICT OF COLUMBIA","DISTRICT OF COLUMBIA",317323,8447,18586,344356
"2020","FLORIDA","ALACHUA",89704,1928,50972,142604
"2020","FLORIDA","BAKER",2037,111,11911,14059
"2020","FLORIDA","BAY",25614,1313,66097,93024
"2020","FLORIDA","BRADFORD",3160,138,10334,13632
"2020","FLORIDA","BREVARD",148549,4332,207883,360764
"2020","FLORIDA","BROWARD",618752,5511,333409,957672
"2020","FLORIDA","CALHOUN",1209,43,5274,6526
"2020","FLORIDA","CHARLOTTE",42273,824,73243,116340
"2020","FLORIDA","CITRUS",27092,764,65352,93208
"2020","FLORIDA","CLAY",38317,1608,84480,124405
"2020","FLORIDA","COLLIER",77621,1247,128950,207818
"2020","FLORIDA","COLUMBIA",8914,292,23836,33042
"2020","FLORIDA","DESOTO",4259,87,8313,12659
"2020","FLORIDA","DIXIE",1365,43,6759,8167
"2020","FLORIDA","DUVAL",252556,6502,233762,492820
"2020","FLORIDA","ESCAMBIA",70929,2769,96674,170372
"2020","FLORIDA","FLAGLER",28161,512,43043,71716
"2020","FLORIDA","FRANKLIN",2120,54,4675,6849
"2020","FLORIDA","GADSDEN",16153,144,7465,23762
"2020","FLORIDA","GILCHRIST",1700,90,7895,9685
"2020","FLORIDA","GLADES",1385,26,3782,5193
"2020","FLORIDA","GULF",1985,65,6113,8163
"2020","FLORIDA","HAMILTON",1963,52,3815,5830
"2020","FLORIDA","HARDEE",2298,65,6122,8485
"2020","FLORIDA","HENDRY",4929,105,7906,12940
"2020","FLORIDA","HERNANDO",37519,991,70412,108922
"2020","FLORIDA","HIGHLANDS",16938,359,34873,52170
"2020","FLORIDA","HILLSBOROUGH",376367,8298,327398,712063
"2020","FLORIDA","HOLMES",924,64,8080,9068
"2020","FLORIDA","INDIAN RIVER",37844,768,58872,97484
"2020","FLORIDA","JACKSON",6766,165,15488,22419
"2020","FLORIDA","JEFFERSON",3897,75,4479,8451
"2020","FLORIDA","LAFAYETTE",510,20,3128,3658
"2020","FLORIDA","LAKE",83505,1950,125859,211314
"2020","FLORIDA","LEE",157695,2957,233247,393899
"2020","FLORIDA","LEON",103517,1959,57453,162929
"2020","FLORIDA","LEVY",6205,191,16749,23145
"2020","FLORIDA","LIBERTY",694,21,2846,3561
"2020","FLORIDA","MADISON",3747,57,5576,9380
"2020","FLORIDA","MANATEE",90166,1805,124987,216958
"2020","FLORIDA","MARION",74858,1692,127826,204376
"2020","FLORIDA","MARTIN",36893,665,61168,98726
"2020","FLORIDA","MIAMI-DADE",617864,6119,532833,1156816
"2020","FLORIDA","MONROE",21881,455,25693,48029
"2020","FLORIDA","NASSAU",15564,681,42566,58811
"2020","FLORIDA","OKALOOSA",34248,2327,79798,116373
"2020","FLORIDA","OKEECHOBEE",4390,94,11470,15954
"2020","FLORIDA","ORANGE",395014,6991,245398,647403
"2020","FLORIDA","OSCEOLA",97297,1659,73480,172436
"2020","FLORIDA","PALM BEACH",433572,4875,334711,773158
"2020","FLORIDA","PASCO",119073,3276,179621,301970
"2020","FLORIDA","PINELLAS",277450,6056,276209,559715
"2020","FLORIDA","POLK",145049,3621,194586,343256
"2020","FLORIDA","PUTNAM",10527,332,25514,36373
"2020","FLORIDA","SANTA ROSA",27612,1931,77385,106928
"2020","FLORIDA","SARASOTA",120110,2095,148370,270575
"2020","FLORIDA","SEMINOLE",132528,3046,125241,260815
"2020","FLORIDA","ST. JOHNS",63850,1826,110946,176622
"2020","FLORIDA","ST. LUCIE",84137,1201,86831,172169
"2020","FLORIDA","SUMTER",29341,383,62761,92485
"2020","FLORIDA","SUWANNEE",4485,162,16410,21057
"2020","FLORIDA","TAYLOR",2299,77,7751,10127
"2020","FLORIDA","UNION",1053,59,5133,6245
"2020","FLORIDA","VOLUSIA",130575,3043,173821,307439
"2020","FLORIDA","WAKULLA",5351,179,12874,18404
"2020","FLORIDA","WALTON",10338,426,32947,43711
"2020","FLORIDA","WASHINGTON",2347,104,9876,12327
"2020","GEORGIA","APPLING",1779,36,6526,8341
"2020","GEORGIA","ATKINSON",825,30,2300,3155
"2020","GEORGIA","BACON",625,25,4018,4668
"2020","GEORGIA","BAKER",652,6,897,1555
"2020","GEORGIA","BALDWIN",9140,208,8903,18251
"2020","GEORGIA","BANKS",932,74,7795,8801
"2020","GEORGIA","BARROW",10453,664,26804,37921
"2020","GEORGIA","BARTOW",12092,701,37674,50467
"2020","GEORGIA","BEN HILL",2392,58,4110,6560
"2020","GEORGIA","BERRIEN",1269,55,6419,7743
"2020","GEORGIA","BIBB",43468,749,26585,70802
"2020","GEORGIA","BLECKLEY",1311,67,4328,5706
"2020","GEORGIA","BRANTLEY",699,56,6991,7746
"2020","GEORGIA","BROOKS",2790,50,4260,7100
"2020","GEORGIA","BRYAN",6739,357,14244,21340
"2020","GEORGIA","BULLOCH",11243,455,18386,30084
"2020","GEORGIA","BURKE",5209,75,5400,10684
"2020","GEORGIA","BUTTS",3274,91,8406,11771
"2020","GEORGIA","CALHOUN",1260,11,923,2194
"2020","GEORGIA","CAMDEN",7967,470,15251,23688
"2020","GEORGIA","CANDLER",1269,29,3133,4431
"2020","GEORGIA","CARROLL",16238,760,37476,54474
"2020","GEORGIA","CATOOSA",6932,494,25167,32593
"2020","GEORGIA","CHARLTON",1103,44,3419,4566
"2020","GEORGIA","CHATHAM",78254,1929,53237,133420
"2020","GEORGIA","CHATTAHOOCHEE",667,35,880,1582
"2020","GEORGIA","CHATTOOGA",1854,132,8064,10050
"2020","GEORGIA","CHEROKEE",42794,2449,99587,144830
"2020","GEORGIA","CLARKE",36048,839,14446,51333
"2020","GEORGIA","CLAY",790,7,637,1434
"2020","GEORGIA","CLAYTON",95476,1055,15813,112344
"2020","GEORGIA","CLINCH",747,12,2105,2864
"2020","GEORGIA","COBB",221846,6441,165459,393746
"2020","GEORGIA","COFFEE",4511,125,10578,15214
"2020","GEORGIA","COLQUITT",4187,119,11777,16083
"2020","GEORGIA","COLUMBIA",29236,1330,50013,80579
"2020","GEORGIA","COOK",2059,76,4900,7035
"2020","GEORGIA","COWETA",24210,1088,51501,76799
"2020","GEORGIA","CRAWFORD",1615,59,4428,6102
"2020","GEORGIA","CRISP",2986,66,4987,8039
"2020","GEORGIA","DADE",1261,107,6066,7434
"2020","GEORGIA","DAWSON",2486,197,13398,16081
"2020","GEORGIA","DECATUR",4780,89,6758,11627
"2020","GEORGIA","DEKALB",308227,4204,58373,370804
"2020","GEORGIA","DODGE",2171,56,5843,8070
"2020","GEORGIA","DOOLY",1911,35,2159,4105
"2020","GEORGIA","DOUGHERTY",24577,280,10454,35311
"2020","GEORGIA","DOUGLAS",42809,837,25451,69097
"2020","GEORGIA","EARLY",2437,28,2722,5187
"2020","GEORGIA","ECHOLS",167,18,1256,1441
"2020","GEORGIA","EFFINGHAM",7720,492,23358,31570
"2020","GEORGIA","ELBERT",2879,66,6226,9171
"2020","GEORGIA","EMANUEL",2884,66,6551,9501
"2020","GEORGIA","EVANS",1324,35,2888,4247
"2020","GEORGIA","FANNIN",2571,110,12169,14850
"2020","GEORGIA","FAYETTE",33065,976,37952,71993
"2020","GEORGIA","FLOYD",12008,517,29123,41648
"2020","GEORGIA","FORSYTH",42203,1980,85122,129305
"2020","GEORGIA","FRANKLIN",1593,103,9069,10765
"2020","GEORGIA","FULTON",381144,6275,137240,524659
"2020","GEORGIA","GILMER",2932,164,13429,16525
"2020","GEORGIA","GLASCOCK",155,8,1403,1566
"2020","GEORGIA","GLYNN",15879,489,25616,41984
"2020","GEORGIA","GORDON",4384,244,19405,24033
"2020","GEORGIA","GRADY",3619,54,7034,10707
"2020","GEORGIA","GREENE",4088,91,7068,11247
"2020","GEORGIA","GWINNETT",241827,5625,166413,413865
"2020","GEORGIA","HABERSHAM",3563,232,16637,20432
"2020","GEORGIA","HALL",25031,1322,64170,90523
"2020","GEORGIA","HANCOCK",2985,21,1159,4165
"2020","GEORGIA","HARALSON",1792,125,12331,14248
"2020","GEORGIA","HARRIS",5457,215,14319,19991
"2020","GEORGIA","HART",3157,106,9464,12727
"2020","GEORGIA","HEARD",824,51,4516,5391
"2020","GEORGIA","HENRY",73276,1279,48187,122742
"2020","GEORGIA","HOUSTON",32232,1057,41534,74823
"2020","GEORGIA","IRWIN",1008,26,3134,4168
"2020","GEORGIA","JACKSON",7642,531,29497,37670
"2020","GEORGIA","JASPER",1761,61,5822,7644
"2020","GEORGIA","JEFF DAVIS",1028,48,4695,5771
"2020","GEORGIA","JEFFERSON",4061,44,3537,7642
"2020","GEORGIA","JENKINS",1266,28,2161,3455
"2020","GEORGIA","JOHNSON",1222,28,2850,4100
"2020","GEORGIA","JONES",4888,113,9965,14966
"2020","GEORGIA","LAMAR",2615,94,6330,9039
"2020","GEORGIA","LANIER",1019,48,2509,3576
"2020","GEORGIA","LAURENS",8073,163,14493,22729
"2020","GEORGIA","LEE",4558,149,12007,16714
"2020","GEORGIA","LIBERTY",13099,331,7959,21389
"2020","GEORGIA","LINCOLN",1435,36,3179,4650
"2020","GEORGIA","LONG",2033,95,3528,5656
"2020","GEORGIA","LOWNDES",20117,547,25691,46355
"2020","GEORGIA","LUMPKIN",3126,242,12163,15531
"2020","GEORGIA","MACON",2857,22,1783,4662
"2020","GEORGIA","MADISON",3411,200,11326,14937
"2020","GEORGIA","MARION",1311,38,2275,3624
"2020","GEORGIA","MCDUFFIE",4168,118,6169,10455
"2020","GEORGIA","MCINTOSH",2612,68,4016,6696
"2020","GEORGIA","MERIWETHER",4287,66,6524,10877
"2020","GEORGIA","MILLER",749,20,2066,2835
"2020","GEORGIA","MITCHELL",3995,33,4935,8963
"2020","GEORGIA","MONROE",4384,148,11060,15592
"2020","GEORGIA","MONTGOMERY",979,27,2960,3966
"2020","GEORGIA","MORGAN",3355,122,8230,11707
"2020","GEORGIA","MURRAY",2302,144,12943,15389
"2020","GEORGIA","MUSCOGEE",49529,965,30049,80543
"2020","GEORGIA","NEWTON",29794,576,23869,54239
"2020","GEORGIA","OCONEE",8162,411,16595,25168
"2020","GEORGIA","OGLETHORPE",2436,102,5593,8131
"2020","GEORGIA","PAULDING",29704,1156,54525,85385
"2020","GEORGIA","PEACH",5920,123,6502,12545
"2020","GEORGIA","PICKENS",2808,233,14075,17116
"2020","GEORGIA","PIERCE",1100,49,7899,9048
"2020","GEORGIA","PIKE",1505,88,9127,10720
"2020","GEORGIA","POLK",3658,152,13589,17399
"2020","GEORGIA","PULASKI",1217,37,2805,4059
"2020","GEORGIA","PUTNAM",3448,116,8291,11855
"2020","GEORGIA","QUITMAN",497,5,604,1106
"2020","GEORGIA","RABUN",1984,110,7474,9568
"2020","GEORGIA","RANDOLPH",1671,12,1391,3074
"2020","GEORGIA","RICHMOND",59124,1111,26781,87016
"2020","GEORGIA","ROCKDALE",31244,430,13012,44686
"2020","GEORGIA","SCHLEY",462,13,1800,2275
"2020","GEORGIA","SCREVEN",2661,51,3916,6628
"2020","GEORGIA","SEMINOLE",1254,19,2611,3884
"2020","GEORGIA","SPALDING",11784,275,18057,30116
"2020","GEORGIA","STEPHENS",2385,132,9368,11885
"2020","GEORGIA","STEWART",1182,7,801,1990
"2020","GEORGIA","SUMTER",6318,100,5732,12150
"2020","GEORGIA","TALBOT",2114,16,1392,3522
"2020","GEORGIA","TALIAFERRO",561,7,360,928
"2020","GEORGIA","TATTNALL",2061,69,6053,8183
"2020","GEORGIA","TAYLOR",1387,34,2418,3839
"2020","GEORGIA","TELFAIR",1487,21,2825,4333
"2020","GEORGIA","TERRELL",2376,36,2004,4416
"2020","GEORGIA","THOMAS",8708,191,12954,21853
"2020","GEORGIA","TIFT",5322,177,10784,16283
"2020","GEORGIA","TOOMBS",2939,103,7872,10914
"2020","GEORGIA","TOWNS",1550,45,6384,7979
"2020","GEORGIA","TREUTLEN",952,24,2101,3077
"2020","GEORGIA","TROUP",11578,328,18143,30049
"2020","GEORGIA","TURNER",1410,33,2349,3792
"2020","GEORGIA","TWIGGS",2044,30,2370,4444
"2020","GEORGIA","UNION",2801,108,12651,15560
"2020","GEORGIA","UPSON",4201,96,8608,12905
"2020","GEORGIA","WALKER",5769,411,23174,29354
"2020","GEORGIA","WALTON",12682,571,37842,51095
"2020","GEORGIA","WARE",4211,116,9865,14192
"2020","GEORGIA","WARREN",1469,16,1166,2651
"2020","GEORGIA","WASHINGTON",4730,66,4663,9459
"2020","GEORGIA","WAYNE",2687,104,9987,12778
"2020","GEORGIA","WEBSTER",639,3,748,1390
"2020","GEORGIA","WHEELER",689,13,1583,2285
"2020","GEORGIA","WHITE",2411,183,12222,14816
"2020","GEORGIA","WHITFIELD",10670,440,25636,36746
"2020","GEORGIA","WILCOX",862,16,2403,3281
"2020","GEORGIA","WILKES",2160,46,2823,5029
"2020","GEORGIA","WILKINSON",2075,31,2664,4770
"2020","GEORGIA","WORTH",2395,60,6830,9285
"2020","HAWAII","HAWAII",58731,2186,26897,87814
"2020","HAWAII","HONOLULU",238866,6986,136250,382102
"2020","HAWAII","KAUAI",21225,690,11582,33497
"2020","HAWAII","MAUI",47305,1613,22126,71044
"2020","IDAHO","ADA",120539,8151,130699,259389
"2020","IDAHO","ADAMS",591,54,1941,2586
"2020","IDAHO","BANNOCK",14682,1540,23331,39553
"2020","IDAHO","BEAR LAKE",350,51,2914,3315
"2020","IDAHO","BENEWAH",977,118,3878,4973
"2020","IDAHO","BINGHAM",4124,577,15295,19996
"2020","IDAHO","BLAINE",8919,338,4032,13289
"2020","IDAHO","BOISE",1204,131,3485,4820
"2020","IDAHO","BONNER",8310,656,18369,27335
"2020","IDAHO","BONNEVILLE",14254,1936,37805,53995
"2020","IDAHO","BOUNDARY",1220,156,4937,6313
"2020","IDAHO","BUTTE",188,25,1202,1415
"2020","IDAHO","CAMAS",149,98,507,754
"2020","IDAHO","CANYON",25881,2770,61759,90410
"2020","IDAHO","CARIBOU",431,79,2906,3416
"2020","IDAHO","CASSIA",1464,258,7907,9629
"2020","IDAHO","CLARK",41,6,264,311
"2020","IDAHO","CLEARWATER",877,89,3453,4419
"2020","IDAHO","CUSTER",603,47,2089,2739
"2020","IDAHO","ELMORE",2601,358,7246,10205
"2020","IDAHO","FRANKLIN",657,162,5845,6664
"2020","IDAHO","FREMONT",998,173,5548,6719
"2020","IDAHO","GEM",1803,204,7951,9958
"2020","IDAHO","GOODING",1256,135,4659,6050
"2020","IDAHO","IDAHO",1561,215,7826,9602
"2020","IDAHO","JEFFERSON",1661,413,12099,14173
"2020","IDAHO","JEROME",1893,185,5734,7812
"2020","IDAHO","KOOTENAI",24312,2318,62837,89467
"2020","IDAHO","LATAH",10236,862,9472,20570
"2020","IDAHO","LEMHI",1032,114,3592,4738
"2020","IDAHO","LEWIS",349,32,1489,1870
"2020","IDAHO","LINCOLN",414,57,1469,1940
"2020","IDAHO","MADISON",2666,887,13559,17112
"2020","IDAHO","MINIDOKA",1550,178,6265,7993
"2020","IDAHO","NEZ PERCE",6686,543,13738,20967
"2020","IDAHO","ONEIDA",249,54,2148,2451
"2020","IDAHO","OWYHEE",816,107,3819,4742
"2020","IDAHO","PAYETTE",2161,270,8862,11293
"2020","IDAHO","POWER",865,93,2116,3074
"2020","IDAHO","SHOSHONE",1693,140,4216,6049
"2020","IDAHO","TETON",3318,171,2858,6347
"2020","IDAHO","TWIN FALLS",9391,1213,25897,36501
"2020","IDAHO","VALLEY",2976,140,3947,7063
"2020","IDAHO","WASHINGTON",1073,117,4154,5344
"2020","ILLINOIS","ADAMS",8633,674,24220,33527
"2020","ILLINOIS","ALEXANDER",1114,18,1486,2618
"2020","ILLINOIS","BOND",2288,232,5625,8145
"2020","ILLINOIS","BOONE",10542,554,13883,24979
"2020","ILLINOIS","BROWN",486,104,1931,2521
"2020","ILLINOIS","BUREAU",6669,354,10411,17434
"2020","ILLINOIS","CALHOUN",677,49,2046,2772
"2020","ILLINOIS","CARROLL",2748,171,5105,8024
"2020","ILLINOIS","CASS",1615,77,3625,5317
"2020","ILLINOIS","CHAMPAIGN",57067,2790,35285,95142
"2020","ILLINOIS","CHRISTIAN",4335,306,11563,16204
"2020","ILLINOIS","CLARK",1993,137,6226,8356
"2020","ILLINOIS","CLAY",1129,128,5629,6886
"2020","ILLINOIS","CLINTON",4493,373,14304,19170
"2020","ILLINOIS","COLES",8067,502,14037,22606
"2020","ILLINOIS","COOK",1725973,37244,558269,2321486
"2020","ILLINOIS","CRAWFORD",2202,180,7043,9425
"2020","ILLINOIS","CUMBERLAND",1142,89,4601,5832
"2020","ILLINOIS","DE WITT",2191,201,5632,8024
"2020","ILLINOIS","DEKALB",24643,1277,21905,47825
"2020","ILLINOIS","DOUGLAS",2335,176,6227,8738
"2020","ILLINOIS","DUPAGE",281222,10271,193611,485104
"2020","ILLINOIS","EDGAR",1887,116,6193,8196
"2020","ILLINOIS","EDWARDS",488,45,2833,3366
"2020","ILLINOIS","EFFINGHAM",3716,327,15006,19049
"2020","ILLINOIS","FAYETTE",1826,175,8055,10056
"2020","ILLINOIS","FORD",1754,151,5048,6953
"2020","ILLINOIS","FRANKLIN",4760,244,13622,18626
"2020","ILLINOIS","FULTON",6503,308,9867,16678
"2020","ILLINOIS","GALLATIN",622,33,2019,2674
"2020","ILLINOIS","GREENE",1349,108,4770,6227
"2020","ILLINOIS","GRUNDY",9626,542,16523,26691
"2020","ILLINOIS","HAMILTON",824,59,3432,4315
"2020","ILLINOIS","HANCOCK",2315,162,6906,9383
"2020","ILLINOIS","HARDIN",449,22,1691,2162
"2020","ILLINOIS","HENDERSON",1187,66,2394,3647
"2020","ILLINOIS","HENRY",9797,538,15300,25635
"2020","ILLINOIS","IROQUOIS",2908,240,10877,14025
"2020","ILLINOIS","JACKSON",11181,572,10890,22643
"2020","ILLINOIS","JASPER",1007,75,4494,5576
"2020","ILLINOIS","JEFFERSON",4608,320,12476,17404
"2020","ILLINOIS","JERSEY",2961,264,8712,11937
"2020","ILLINOIS","JO DAVIESS",5109,221,7166,12496
"2020","ILLINOIS","JOHNSON",1281,97,5059,6437
"2020","ILLINOIS","KANE",130166,4935,96775,231876
"2020","ILLINOIS","KANKAKEE",20271,1099,28532,49902
"2020","ILLINOIS","KENDALL",33168,1314,29492,63974
"2020","ILLINOIS","KNOX",10703,431,12009,23143
"2020","ILLINOIS","LAKE",204032,6551,123594,334177
"2020","ILLINOIS","LASALLE",22442,1036,30113,53591
"2020","ILLINOIS","LAWRENCE",1419,106,4886,6411
"2020","ILLINOIS","LEE",6407,360,9630,16397
"2020","ILLINOIS","LIVINGSTON",4615,351,12208,17174
"2020","ILLINOIS","LOGAN",3840,318,9136,13294
"2020","ILLINOIS","MACON",19847,954,28589,49390
"2020","ILLINOIS","MACOUPIN",7365,504,16153,24022
"2020","ILLINOIS","MADISON",57836,3272,76031,137139
"2020","ILLINOIS","MARION",4524,256,12678,17458
"2020","ILLINOIS","MARSHALL",2005,132,4197,6334
"2020","ILLINOIS","MASON",1985,127,4654,6766
"2020","ILLINOIS","MASSAC",1725,91,4997,6813
"2020","ILLINOIS","MCDONOUGH",4992,266,7027,12285
"2020","ILLINOIS","MCHENRY",78154,3465,82260,163879
"2020","ILLINOIS","MCLEAN",43933,2567,40502,87002
"2020","ILLINOIS","MENARD",2022,142,4764,6928
"2020","ILLINOIS","MERCER",3280,195,5418,8893
"2020","ILLINOIS","MONROE",6569,437,14142,21148
"2020","ILLINOIS","MONTGOMERY",3905,278,9544,13727
"2020","ILLINOIS","MORGAN",5076,283,9950,15309
"2020","ILLINOIS","MOULTRIE",1662,118,4964,6744
"2020","ILLINOIS","OGLE",9428,596,16248,26272
"2020","ILLINOIS","PEORIA",43578,2143,38252,83973
"2020","ILLINOIS","PERRY",2612,128,7313,10053
"2020","ILLINOIS","PIATT",3329,245,6248,9822
"2020","ILLINOIS","PIKE",1484,133,6332,7949
"2020","ILLINOIS","POPE",433,20,1722,2175
"2020","ILLINOIS","PULASKI",891,34,1699,2624
"2020","ILLINOIS","PUTNAM",1338,59,1993,3390
"2020","ILLINOIS","RANDOLPH",3592,223,11076,14891
"2020","ILLINOIS","RICHLAND",1830,144,6089,8063
"2020","ILLINOIS","ROCK ISLAND",36691,1464,28603,66758
"2020","ILLINOIS","SALINE",2789,174,8103,11066
"2020","ILLINOIS","SANGAMON",48917,2350,53485,104752
"2020","ILLINOIS","SCHUYLER",1068,65,2773,3906
"2020","ILLINOIS","SCOTT",572,51,2114,2737
"2020","ILLINOIS","SHELBY",2504,167,9426,12097
"2020","ILLINOIS","ST. CLAIR",68325,2616,57150,128091
"2020","ILLINOIS","STARK",815,64,2004,2883
"2020","ILLINOIS","STEPHENSON",9055,472,12521,22048
"2020","ILLINOIS","TAZEWELL",24819,1720,42513,69052
"2020","ILLINOIS","UNION",2579,146,6161,8886
"2020","ILLINOIS","VERMILION",10323,536,20725,31584
"2020","ILLINOIS","WABASH",1253,103,4237,5593
"2020","ILLINOIS","WARREN",3090,143,4676,7909
"2020","ILLINOIS","WASHINGTON",1641,146,6115,7902
"2020","ILLINOIS","WAYNE",1187,123,7176,8486
"2020","ILLINOIS","WHITE",1517,113,5791,7421
"2020","ILLINOIS","WHITESIDE",12253,595,14527,27375
"2020","ILLINOIS","WILL",183915,6074,155116,345105
"2020","ILLINOIS","WILLIAMSON",10206,646,22801,33653
"2020","ILLINOIS","WINNEBAGO",64056,2792,60861,127709
"2020","ILLINOIS","WOODFORD",6160,473,14799,21432
"2020","INDIANA","ADAMS",3236,287,10686,14209
"2020","INDIANA","ALLEN",73189,3810,92083,169082
"2020","INDIANA","BARTHOLOMEW",12934,891,22410,36235
"2020","INDIANA","BENTON",1009,98,3007,4114
"2020","INDIANA","BLACKFORD",1376,134,3841,5351
"2020","INDIANA","BOONE",15244,925,22351,38520
"2020","INDIANA","BROWN",3036,168,5777,8981
"2020","INDIANA","CARROLL",2224,185,7086,9495
"2020","INDIANA","CASS",4304,342,10552,15198
"2020","INDIANA","CLARK",23093,1108,33668,57869
"2020","INDIANA","CLAY",2552,216,9499,12267
"2020","INDIANA","CLINTON",3361,254,9334,12949
"2020","INDIANA","CRAWFORD",1355,106,3483,4944
"2020","INDIANA","DAVIESS",2169,209,9576,11954
"2020","INDIANA","DEARBORN",5446,409,19528,25383
"2020","INDIANA","DECATUR",2439,273,9575,12287
"2020","INDIANA","DEKALB",4966,425,14237,19628
"2020","INDIANA","DELAWARE",20474,890,26827,48191
"2020","INDIANA","DUBOIS",6292,445,15033,21770
"2020","INDIANA","ELKHART",26108,1307,46972,74387
"2020","INDIANA","FAYETTE",2237,144,7755,10136
"2020","INDIANA","FLOYD",17511,891,23400,41802
"2020","INDIANA","FOUNTAIN",1629,203,6154,7986
"2020","INDIANA","FRANKLIN",2137,172,9691,12000
"2020","INDIANA","FULTON",2280,173,6694,9147
"2020","INDIANA","GIBSON",4023,321,11817,16161
"2020","INDIANA","GRANT",8015,601,18543,27159
"2020","INDIANA","GREENE",3389,292,11103,14784
"2020","INDIANA","HAMILTON",88390,4022,101587,193999
"2020","INDIANA","HANCOCK",12895,1020,28996,42911
"2020","INDIANA","HARRISON",5343,328,14565,20236
"2020","INDIANA","HENDRICKS",32604,2099,53802,88505
"2020","INDIANA","HENRY",5544,443,15043,21030
"2020","INDIANA","HOWARD",13303,878,26449,40630
"2020","INDIANA","HUNTINGTON",4255,427,13147,17829
"2020","INDIANA","JACKSON",4302,381,14555,19238
"2020","INDIANA","JASPER",3798,294,11383,15475
"2020","INDIANA","JAY",1926,174,6361,8461
"2020","INDIANA","JEFFERSON",4731,303,9663,14697
"2020","INDIANA","JENNINGS",2523,238,9490,12251
"2020","INDIANA","JOHNSON",24736,1663,51219,77618
"2020","INDIANA","KNOX",4067,289,11655,16011
"2020","INDIANA","KOSCIUSKO",8364,924,26499,35787
"2020","INDIANA","LAGRANGE",2355,168,8110,10633
"2020","INDIANA","LAKE",124870,3326,91760,219956
"2020","INDIANA","LAPORTE",22427,968,25997,49392
"2020","INDIANA","LAWRENCE",4961,463,15601,21025
"2020","INDIANA","MADISON",19524,1054,31215,51793
"2020","INDIANA","MARION",247772,7672,134175,389619
"2020","INDIANA","MARSHALL",5712,371,13844,19927
"2020","INDIANA","MARTIN",1011,104,4029,5144
"2020","INDIANA","MIAMI",3235,313,10925,14473
"2020","INDIANA","MONROE",39861,1219,22071,63151
"2020","INDIANA","MONTGOMERY",4213,326,12659,17198
"2020","INDIANA","MORGAN",7781,866,27512,36159
"2020","INDIANA","NEWTON",1509,140,4942,6591
"2020","INDIANA","NOBLE",4660,335,14195,19190
"2020","INDIANA","OHIO",668,353,2054,3075
"2020","INDIANA","ORANGE",2224,176,6432,8832
"2020","INDIANA","OWEN",2420,198,7286,9904
"2020","INDIANA","PARKE",1503,110,5400,7013
"2020","INDIANA","PERRY",3203,174,5345,8722
"2020","INDIANA","PIKE",1415,113,4692,6220
"2020","INDIANA","PORTER",39746,1755,45008,86509
"2020","INDIANA","POSEY",3811,219,9206,13236
"2020","INDIANA","PULASKI",1463,97,4246,5806
"2020","INDIANA","PUTNAM",3946,373,12278,16597
"2020","INDIANA","RANDOLPH",2513,245,8312,11070
"2020","INDIANA","RIPLEY",2774,236,11261,14271
"2020","INDIANA","RUSH",1754,143,6035,7932
"2020","INDIANA","SCOTT",2701,135,7331,10167
"2020","INDIANA","SHELBY",5023,400,14568,19991
"2020","INDIANA","SPENCER",3213,199,7357,10769
"2020","INDIANA","ST. JOSEPH",59896,2178,53164,115238
"2020","INDIANA","STARKE",2650,174,7466,10290
"2020","INDIANA","STEUBEN",4513,322,11327,16162
"2020","INDIANA","SULLIVAN",2153,150,6691,8994
"2020","INDIANA","SWITZERLAND",964,57,3133,4154
"2020","INDIANA","TIPPECANOE",35017,1850,34581,71448
"2020","INDIANA","TIPTON",1834,172,6110,8116
"2020","INDIANA","UNION",736,59,2688,3483
"2020","INDIANA","VANDERBURGH",34415,1403,41844,77662
"2020","INDIANA","VERMILLION",2145,152,5184,7481
"2020","INDIANA","VIGO",18123,926,24545,43594
"2020","INDIANA","WABASH",3494,320,10762,14576
"2020","INDIANA","WARREN",974,97,3401,4472
"2020","INDIANA","WARRICK",11923,580,21326,33829
"2020","INDIANA","WASHINGTON",2784,241,9114,12139
"2020","INDIANA","WAYNE",9524,588,17567,27679
"2020","INDIANA","WELLS",2928,267,10855,14050
"2020","INDIANA","WHITE",3032,177,7957,11166
"2020","INDIANA","WHITLEY",4234,460,12862,17556
"2020","IOWA","ADAIR",1198,57,2922,4177
"2020","IOWA","ADAMS",590,35,1535,2160
"2020","IOWA","ALLAMAKEE",2576,102,4744,7422
"2020","IOWA","APPANOOSE",1891,103,4522,6516
"2020","IOWA","AUDUBON",1071,50,2299,3420
"2020","IOWA","BENTON",5160,274,9208,14642
"2020","IOWA","BLACK HAWK",35647,1133,29813,66593
"2020","IOWA","BOONE",6303,308,8729,15340
"2020","IOWA","BREMER",5958,264,8324,14546
"2020","IOWA","BUCHANAN",4169,175,6430,10774
"2020","IOWA","BUENA VISTA",2961,132,5074,8167
"2020","IOWA","BUTLER",2424,118,5556,8098
"2020","IOWA","CALHOUN",1470,90,3698,5258
"2020","IOWA","CARROLL",3454,115,7766,11335
"2020","IOWA","CASS",2201,96,4979,7276
"2020","IOWA","CEDAR",4337,182,6184,10703
"2020","IOWA","CERRO GORDO",10941,361,12499,23801
"2020","IOWA","CHEROKEE",1936,72,4510,6518
"2020","IOWA","CHICKASAW",2233,76,4322,6631
"2020","IOWA","CLARKE",1466,51,3153,4670
"2020","IOWA","CLAY",2662,149,6158,8969
"2020","IOWA","CLAYTON",3340,135,6119,9594
"2020","IOWA","CLINTON",10812,465,13410,24687
"2020","IOWA","CRAWFORD",2220,72,4862,7154
"2020","IOWA","DALLAS",26879,981,28162,56022
"2020","IOWA","DAVIS",1013,54,3035,4102
"2020","IOWA","DECATUR",1120,66,2618,3804
"2020","IOWA","DELAWARE",3157,158,6688,10003
"2020","IOWA","DES MOINES",8893,421,10642,19956
"2020","IOWA","DICKINSON",3661,131,7452,11244
"2020","IOWA","DUBUQUE",25657,911,27358,53926
"2020","IOWA","EMMET",1520,65,3268,4853
"2020","IOWA","FAYETTE",3835,177,6174,10186
"2020","IOWA","FLOYD",3172,113,4747,8032
"2020","IOWA","FRANKLIN",1626,71,3433,5130
"2020","IOWA","FREMONT",1080,60,2717,3857
"2020","IOWA","GREENE",1769,59,3229,5057
"2020","IOWA","GRUNDY",2206,125,4945,7276
"2020","IOWA","GUTHRIE",1985,106,4280,6371
"2020","IOWA","HAMILTON",2843,118,4982,7943
"2020","IOWA","HANCOCK",1683,88,4401,6172
"2020","IOWA","HARDIN",2976,149,5864,8989
"2020","IOWA","HARRISON",2440,135,5580,8155
"2020","IOWA","HENRY",3275,182,6525,9982
"2020","IOWA","HOWARD",1772,53,3133,4958
"2020","IOWA","HUMBOLDT",1442,60,3825,5327
"2020","IOWA","IDA",917,47,2885,3849
"2020","IOWA","IOWA",3547,160,6035,9742
"2020","IOWA","JACKSON",4029,149,6957,11135
"2020","IOWA","JASPER",7737,322,12125,20184
"2020","IOWA","JEFFERSON",4319,164,4476,8959
"2020","IOWA","JOHNSON",59177,1468,23206,83851
"2020","IOWA","JONES",4213,180,6596,10989
"2020","IOWA","KEOKUK",1414,80,3809,5303
"2020","IOWA","KOSSUTH",2696,106,6288,9090
"2020","IOWA","LEE",6541,385,9808,16734
"2020","IOWA","LINN",70874,2840,53744,127458
"2020","IOWA","LOUISA",1726,100,3506,5332
"2020","IOWA","LUCAS",1284,51,3295,4630
"2020","IOWA","LYON",1067,78,5718,6863
"2020","IOWA","MADISON",3134,165,6525,9824
"2020","IOWA","MAHASKA",2894,190,8320,11404
"2020","IOWA","MARION",6178,332,12722,19232
"2020","IOWA","MARSHALL",8176,350,9610,18136
"2020","IOWA","MILLS",2508,144,5616,8268
"2020","IOWA","MITCHELL",2053,85,3684,5822
"2020","IOWA","MONONA",1407,59,3262,4728
"2020","IOWA","MONROE",1078,32,2978,4088
"2020","IOWA","MONTGOMERY",1583,78,3666,5327
"2020","IOWA","MUSCATINE",9372,434,10865,20671
"2020","IOWA","O'BRIEN",1569,111,5871,7551
"2020","IOWA","OSCEOLA",601,32,2695,3328
"2020","IOWA","PAGE",2086,114,5328,7528
"2020","IOWA","PALO ALTO",1519,61,3378,4958
"2020","IOWA","PLYMOUTH",3494,179,10515,14188
"2020","IOWA","POCAHONTAS",933,58,2832,3823
"2020","IOWA","POLK",146250,4941,107564,258755
"2020","IOWA","POTTAWATTAMIE",18575,817,26352,45744
"2020","IOWA","POWESHIEK",4306,161,5673,10140
"2020","IOWA","RINGGOLD",709,31,1974,2714
"2020","IOWA","SAC",1389,77,4069,5535
"2020","IOWA","SCOTT",46926,1715,43958,92599
"2020","IOWA","SHELBY",1959,125,4711,6795
"2020","IOWA","SIOUX",3019,257,15775,19051
"2020","IOWA","STORY",29175,1322,20541,51038
"2020","IOWA","TAMA",3577,146,5325,9048
"2020","IOWA","TAYLOR",746,33,2470,3249
"2020","IOWA","UNION",2061,100,4024,6185
"2020","IOWA","VAN BUREN",875,46,2870,3791
"2020","IOWA","WAPELLO",5821,276,9536,15633
"2020","IOWA","WARREN",12574,597,17868,31039
"2020","IOWA","WASHINGTON",4561,213,6991,11765
"2020","IOWA","WAYNE",727,38,2344,3109
"2020","IOWA","WEBSTER",6613,239,10970,17822
"2020","IOWA","WINNEBAGO",2135,109,3726,5970
"2020","IOWA","WINNESHIEK",5617,184,6263,12064
"2020","IOWA","WOODBURY",18704,732,25926,45362
"2020","IOWA","WORTH",1596,80,2742,4418
"2020","IOWA","WRIGHT",1996,110,4148,6254
"2020","KANSAS","ALLEN",1570,104,4218,5892
"2020","KANSAS","ANDERSON",782,81,2929,3792
"2020","KANSAS","ATCHISON",2359,175,4906,7440
"2020","KANSAS","BARBER",291,37,2014,2342
"2020","KANSAS","BARTON",2340,182,8608,11130
"2020","KANSAS","BOURBON",1541,112,5023,6676
"2020","KANSAS","BROWN",1104,105,3262,4471
"2020","KANSAS","BUTLER",9181,705,22634,32520
"2020","KANSAS","CHASE",345,23,1123,1491
"2020","KANSAS","CHAUTAUQUA",212,25,1402,1639
"2020","KANSAS","CHEROKEE",2194,168,6766,9128
"2020","KANSAS","CHEYENNE",224,22,1183,1429
"2020","KANSAS","CLARK",143,20,904,1067
"2020","KANSAS","CLAY",894,111,3177,4182
"2020","KANSAS","CLOUD",920,101,3242,4263
"2020","KANSAS","COFFEY",964,112,3489,4565
"2020","KANSAS","COMANCHE",126,28,762,916
"2020","KANSAS","COWLEY",4273,302,9656,14231
"2020","KANSAS","CRAWFORD",6179,421,10045,16645
"2020","KANSAS","DECATUR",218,20,1260,1498
"2020","KANSAS","DICKINSON",2060,163,7126,9349
"2020","KANSAS","DONIPHAN",686,47,2976,3709
"2020","KANSAS","DOUGLAS",40785,1424,17286,59495
"2020","KANSAS","EDWARDS",271,19,1141,1431
"2020","KANSAS","ELK",195,26,1140,1361
"2020","KANSAS","ELLIS",3737,305,9758,13800
"2020","KANSAS","ELLSWORTH",648,57,2148,2853
"2020","KANSAS","FINNEY",4325,239,7236,11800
"2020","KANSAS","FORD",2947,165,5803,8915
"2020","KANSAS","FRANKLIN",3690,308,8479,12477
"2020","KANSAS","GEARY",3983,297,5323,9603
"2020","KANSAS","GOVE",166,14,1291,1471
"2020","KANSAS","GRAHAM",228,29,1080,1337
"2020","KANSAS","GRANT",518,47,1936,2501
"2020","KANSAS","GRAY",341,36,1911,2288
"2020","KANSAS","GREELEY",78,14,549,641
"2020","KANSAS","GREENWOOD",569,64,2444,3077
"2020","KANSAS","HAMILTON",141,20,698,859
"2020","KANSAS","HARPER",461,49,2168,2678
"2020","KANSAS","HARVEY",6747,380,10182,17309
"2020","KANSAS","HASKELL",268,20,1122,1410
"2020","KANSAS","HODGEMAN",154,16,875,1045
"2020","KANSAS","JACKSON",1881,186,4517,6584
"2020","KANSAS","JEFFERSON",3194,254,6334,9782
"2020","KANSAS","JEWELL",212,29,1387,1628
"2020","KANSAS","JOHNSON",184259,7324,155631,347214
"2020","KANSAS","KEARNY",267,24,1164,1455
"2020","KANSAS","KINGMAN",752,67,3130,3949
"2020","KANSAS","KIOWA",156,29,980,1165
"2020","KANSAS","LABETTE",2655,173,5735,8563
"2020","KANSAS","LANE",115,18,762,895
"2020","KANSAS","LEAVENWORTH",13886,994,21610,36490
"2020","KANSAS","LINCOLN",266,30,1283,1579
"2020","KANSAS","LINN",896,102,4048,5046
"2020","KANSAS","LOGAN",186,23,1249,1458
"2020","KANSAS","LYON",6055,383,7550,13988
"2020","KANSAS","MARION",1516,130,4465,6111
"2020","KANSAS","MARSHALL",1259,126,3729,5114
"2020","KANSAS","MCPHERSON",4134,340,9964,14438
"2020","KANSAS","MEADE",263,39,1523,1825
"2020","KANSAS","MIAMI",5247,382,12308,17937
"2020","KANSAS","MITCHELL",558,39,2504,3101
"2020","KANSAS","MONTGOMERY",3228,267,9931,13426
"2020","KANSAS","MORRIS",729,46,2124,2899
"2020","KANSAS","MORTON",150,14,1034,1198
"2020","KANSAS","NEMAHA",927,93,4664,5684
"2020","KANSAS","NEOSHO",1796,111,4970,6877
"2020","KANSAS","NESS",149,25,1339,1513
"2020","KANSAS","NORTON",364,44,2007,2415
"2020","KANSAS","OSAGE",2136,194,5705,8035
"2020","KANSAS","OSBORNE",281,35,1629,1945
"2020","KANSAS","OTTAWA",506,75,2610,3191
"2020","KANSAS","PAWNEE",643,51,2045,2739
"2020","KANSAS","PHILLIPS",318,45,2418,2781
"2020","KANSAS","POTTAWATOMIE",3313,318,9452,13083
"2020","KANSAS","PRATT",933,96,3108,4137
"2020","KANSAS","RAWLINS",214,29,1261,1504
"2020","KANSAS","RENO",8886,612,18443,27941
"2020","KANSAS","REPUBLIC",424,51,2182,2657
"2020","KANSAS","RICE",965,92,3262,4319
"2020","KANSAS","RILEY",12765,796,11610,25171
"2020","KANSAS","ROOKS",339,35,2325,2699
"2020","KANSAS","RUSH",295,32,1350,1677
"2020","KANSAS","RUSSELL",600,77,2790,3467
"2020","KANSAS","SALINE",8214,595,15722,24531
"2020","KANSAS","SCOTT",299,41,2014,2354
"2020","KANSAS","SEDGWICK",95870,5402,122416,223688
"2020","KANSAS","SEWARD",1833,89,3372,5294
"2020","KANSAS","SHAWNEE",43015,2199,40443,85657
"2020","KANSAS","SHERIDAN",147,16,1282,1445
"2020","KANSAS","SHERMAN",396,62,2269,2727
"2020","KANSAS","SMITH",336,30,1763,2129
"2020","KANSAS","STAFFORD",357,32,1645,2034
"2020","KANSAS","STANTON",148,14,614,776
"2020","KANSAS","STEVENS",237,34,1760,2031
"2020","KANSAS","SUMNER",2591,232,8105,10928
"2020","KANSAS","THOMAS",625,55,3130,3810
"2020","KANSAS","TREGO",242,25,1363,1630
"2020","KANSAS","WABAUNSEE",964,93,2845,3902
"2020","KANSAS","WALLACE",44,11,770,825
"2020","KANSAS","WASHINGTON",475,45,2363,2883
"2020","KANSAS","WICHITA",149,11,808,968
"2020","KANSAS","WILSON",723,78,3153,3954
"2020","KANSAS","WOODSON",294,24,1228,1546
"2020","KANSAS","WYANDOTTE",36788,1063,18934,56785
"2020","KENTUCKY","ADAIR",1392,95,7276,8763
"2020","KENTUCKY","ALLEN",1642,135,7586,9363
"2020","KENTUCKY","ANDERSON",3347,236,9657,13240
"2020","KENTUCKY","BALLARD",825,44,3356,4225
"2020","KENTUCKY","BARREN",5127,274,14654,20055
"2020","KENTUCKY","BATH",1573,68,3986,5627
"2020","KENTUCKY","BELL",1789,115,8140,10044
"2020","KENTUCKY","BOONE",20897,1245,44811,66953
"2020","KENTUCKY","BOURBON",3296,157,6190,9643
"2020","KENTUCKY","BOYD",7083,363,14295,21741
"2020","KENTUCKY","BOYLE",5298,297,8872,14467
"2020","KENTUCKY","BRACKEN",800,46,3398,4244
"2020","KENTUCKY","BREATHITT",1301,95,4265,5661
"2020","KENTUCKY","BRECKINRIDGE",2350,146,7701,10197
"2020","KENTUCKY","BULLITT",10551,705,30708,41964
"2020","KENTUCKY","BUTLER",1079,83,4960,6122
"2020","KENTUCKY","CALDWELL",1433,89,4906,6428
"2020","KENTUCKY","CALLOWAY",5794,298,11351,17443
"2020","KENTUCKY","CAMPBELL",19373,978,28482,48833
"2020","KENTUCKY","CARLISLE",463,16,2159,2638
"2020","KENTUCKY","CARROLL",1116,65,2954,4135
"2020","KENTUCKY","CARTER",2642,168,8775,11585
"2020","KENTUCKY","CASEY",918,74,6179,7171
"2020","KENTUCKY","CHRISTIAN",8296,487,15080,23863
"2020","KENTUCKY","CLARK",6004,313,11811,18128
"2020","KENTUCKY","CLAY",831,82,6677,7590
"2020","KENTUCKY","CLINTON",603,49,4280,4932
"2020","KENTUCKY","CRITTENDEN",731,60,3451,4242
"2020","KENTUCKY","CUMBERLAND",508,32,2769,3309
"2020","KENTUCKY","DAVIESS",17283,934,31023,49240
"2020","KENTUCKY","EDMONSON",1227,76,4828,6131
"2020","KENTUCKY","ELLIOTT",712,37,2246,2995
"2020","KENTUCKY","ESTILL",1355,83,5100,6538
"2020","KENTUCKY","FAYETTE",90566,3253,58845,152664
"2020","KENTUCKY","FLEMING",1474,58,5534,7066
"2020","KENTUCKY","FLOYD",3884,217,12250,16351
"2020","KENTUCKY","FRANKLIN",12650,509,12900,26059
"2020","KENTUCKY","FULTON",791,25,1605,2421
"2020","KENTUCKY","GALLATIN",822,72,2955,3849
"2020","KENTUCKY","GARRARD",1830,119,6754,8703
"2020","KENTUCKY","GRANT",2205,176,8725,11106
"2020","KENTUCKY","GRAVES",3559,253,13206,17018
"2020","KENTUCKY","GRAYSON",2400,130,9453,11983
"2020","KENTUCKY","GREEN",920,54,4838,5812
"2020","KENTUCKY","GREENUP",4873,239,13064,18176
"2020","KENTUCKY","HANCOCK",1351,91,3145,4587
"2020","KENTUCKY","HARDIN",18101,1008,29832,48941
"2020","KENTUCKY","HARLAN",1494,110,9367,10971
"2020","KENTUCKY","HARRISON",2400,119,6334,8853
"2020","KENTUCKY","HART",1908,116,6345,8369
"2020","KENTUCKY","HENDERSON",7639,319,12730,20688
"2020","KENTUCKY","HENRY",2142,122,5843,8107
"2020","KENTUCKY","HICKMAN",458,27,1714,2199
"2020","KENTUCKY","HOPKINS",5439,313,15757,21509
"2020","KENTUCKY","JACKSON",605,55,5453,6113
"2020","KENTUCKY","JEFFERSON",228288,7186,150619,386093
"2020","KENTUCKY","JESSAMINE",8567,588,17096,26251
"2020","KENTUCKY","JOHNSON",1608,134,8450,10192
"2020","KENTUCKY","KENTON",32265,1720,48123,82108
"2020","KENTUCKY","KNOTT",1412,60,4779,6251
"2020","KENTUCKY","KNOX",2114,147,11012,13273
"2020","KENTUCKY","LARUE",1504,112,5685,7301
"2020","KENTUCKY","LAUREL",4474,389,23234,28097
"2020","KENTUCKY","LAWRENCE",1238,84,5633,6955
"2020","KENTUCKY","LEE",459,41,2159,2659
"2020","KENTUCKY","LESLIE",446,44,4321,4811
"2020","KENTUCKY","LETCHER",1799,110,7226,9135
"2020","KENTUCKY","LEWIS",823,74,4986,5883
"2020","KENTUCKY","LINCOLN",2254,170,8489,10913
"2020","KENTUCKY","LIVINGSTON",939,54,4010,5003
"2020","KENTUCKY","LOGAN",3094,185,9067,12346
"2020","KENTUCKY","LYON",1092,36,3100,4228
"2020","KENTUCKY","MADISON",15580,970,27353,43903
"2020","KENTUCKY","MAGOFFIN",1213,59,4174,5446
"2020","KENTUCKY","MARION",2722,93,6113,8928
"2020","KENTUCKY","MARSHALL",4071,233,13297,17601
"2020","KENTUCKY","MARTIN",403,31,3496,3930
"2020","KENTUCKY","MASON",2362,119,5477,7958
"2020","KENTUCKY","MCCRACKEN",11190,511,21820,33521
"2020","KENTUCKY","MCCREARY",725,46,5664,6435
"2020","KENTUCKY","MCLEAN",1074,75,3633,4782
"2020","KENTUCKY","MEADE",3632,294,10184,14110
"2020","KENTUCKY","MENIFEE",750,41,2311,3102
"2020","KENTUCKY","MERCER",3033,196,8506,11735
"2020","KENTUCKY","METCALFE",975,78,3959,5012
"2020","KENTUCKY","MONROE",657,45,4628,5330
"2020","KENTUCKY","MONTGOMERY",3630,214,8993,12837
"2020","KENTUCKY","MORGAN",1172,66,4297,5535
"2020","KENTUCKY","MUHLENBERG",3544,189,10496,14229
"2020","KENTUCKY","NELSON",7188,354,15703,23245
"2020","KENTUCKY","NICHOLAS",955,33,2408,3396
"2020","KENTUCKY","OHIO",2404,141,8582,11127
"2020","KENTUCKY","OLDHAM",14504,781,22651,37936
"2020","KENTUCKY","OWEN",1098,66,4292,5456
"2020","KENTUCKY","OWSLEY",216,9,1670,1895
"2020","KENTUCKY","PENDLETON",1322,88,5515,6925
"2020","KENTUCKY","PERRY",2350,138,8118,10606
"2020","KENTUCKY","PIKE",4862,227,20279,25368
"2020","KENTUCKY","POWELL",1367,97,4041,5505
"2020","KENTUCKY","PULASKI",5664,432,25441,31537
"2020","KENTUCKY","ROBERTSON",253,9,884,1146
"2020","KENTUCKY","ROCKCASTLE",1134,72,6577,7783
"2020","KENTUCKY","ROWAN",3880,184,5994,10058
"2020","KENTUCKY","RUSSELL",1329,104,7506,8939
"2020","KENTUCKY","SCOTT",10564,622,17764,28950
"2020","KENTUCKY","SHELBY",8076,412,15054,23542
"2020","KENTUCKY","SIMPSON",2681,163,5888,8732
"2020","KENTUCKY","SPENCER",2530,162,8737,11429
"2020","KENTUCKY","TAYLOR",2961,173,9376,12510
"2020","KENTUCKY","TODD",1202,89,4060,5351
"2020","KENTUCKY","TRIGG",1791,97,5487,7375
"2020","KENTUCKY","TRIMBLE",1012,80,3227,4319
"2020","KENTUCKY","UNION",1529,82,4965,6576
"2020","KENTUCKY","WARREN",22477,1084,31790,55351
"2020","KENTUCKY","WASHINGTON",1644,97,4482,6223
"2020","KENTUCKY","WAYNE",1700,110,7430,9240
"2020","KENTUCKY","WEBSTER",1412,73,4506,5991
"2020","KENTUCKY","WHITLEY",2552,228,12567,15347
"2020","KENTUCKY","WOLFE",839,43,2097,2979
"2020","KENTUCKY","WOODFORD",6530,319,8362,15211
"2020","LOUISIANA","ACADIA",5443,386,22596,28425
"2020","LOUISIANA","ALLEN",2108,128,7574,9810
"2020","LOUISIANA","ASCENSION",20399,1239,40687,62325
"2020","LOUISIANA","ASSUMPTION",3833,131,7271,11235
"2020","LOUISIANA","AVOYELLES",4979,285,12028,17292
"2020","LOUISIANA","BEAUREGARD",2542,240,13575,16357
"2020","LOUISIANA","BIENVILLE",3067,92,3891,7050
"2020","LOUISIANA","BOSSIER",15662,919,38074,54655
"2020","LOUISIANA","CADDO",55110,1781,48021,104912
"2020","LOUISIANA","CALCASIEU",25982,1615,55066,82663
"2020","LOUISIANA","CALDWELL",745,41,3976,4762
"2020","LOUISIANA","CAMERON",324,44,3671,4039
"2020","LOUISIANA","CATAHOULA",1269,48,3541,4858
"2020","LOUISIANA","CLAIBORNE",2731,79,3770,6580
"2020","LOUISIANA","CONCORDIA",3177,101,5550,8828
"2020","LOUISIANA","DE SOTO",5457,167,9112,14736
"2020","LOUISIANA","EAST BATON ROUGE",115577,4185,88420,208182
"2020","LOUISIANA","EAST CARROLL",1900,56,1080,3036
"2020","LOUISIANA","EAST FELICIANA",4280,165,6064,10509
"2020","LOUISIANA","EVANGELINE",4158,201,11053,15412
"2020","LOUISIANA","FRANKLIN",2658,92,6970,9720
"2020","LOUISIANA","GRANT",1157,118,8117,9392
"2020","LOUISIANA","IBERIA",11027,435,21251,32713
"2020","LOUISIANA","IBERVILLE",8514,312,7893,16719
"2020","LOUISIANA","JACKSON",2143,95,5394,7632
"2020","LOUISIANA","JEFFERSON",84477,3307,105949,193733
"2020","LOUISIANA","JEFFERSON DAVIS",3208,210,11423,14841
"2020","LOUISIANA","LA SALLE",638,61,6378,7077
"2020","LOUISIANA","LAFAYETTE",39685,2317,72519,114521
"2020","LOUISIANA","LAFOURCHE",8672,692,36024,45388
"2020","LOUISIANA","LINCOLN",7559,405,11311,19275
"2020","LOUISIANA","LIVINGSTON",9249,1104,54877,65230
"2020","LOUISIANA","MADISON",2654,86,1930,4670
"2020","LOUISIANA","MOREHOUSE",4946,118,6510,11574
"2020","LOUISIANA","NATCHITOCHES",6896,300,9358,16554
"2020","LOUISIANA","ORLEANS",147854,3301,26664,177819
"2020","LOUISIANA","OUACHITA",25913,998,42255,69166
"2020","LOUISIANA","PLAQUEMINES",3414,188,7412,11014
"2020","LOUISIANA","POINTE COUPEE",4683,185,7503,12371
"2020","LOUISIANA","RAPIDES",19475,1043,38347,58865
"2020","LOUISIANA","RED RIVER",1644,75,2413,4132
"2020","LOUISIANA","RICHLAND",3225,108,6607,9940
"2020","LOUISIANA","SABINE",1731,89,8776,10596
"2020","LOUISIANA","ST. BERNARD",6151,320,11179,17650
"2020","LOUISIANA","ST. CHARLES",9800,484,18233,28517
"2020","LOUISIANA","ST. HELENA",3346,98,2714,6158
"2020","LOUISIANA","ST. JAMES",6510,126,5954,12590
"2020","LOUISIANA","ST. JOHN THE BAPTIST",13582,312,7538,21432
"2020","LOUISIANA","ST. LANDRY",17372,611,23171,41154
"2020","LOUISIANA","ST. MARTIN",8439,396,18203,27038
"2020","LOUISIANA","ST. MARY",8055,320,14811,23186
"2020","LOUISIANA","ST. TAMMANY",37746,2698,99666,140110
"2020","LOUISIANA","TANGIPAHOA",18887,968,37806,57661
"2020","LOUISIANA","TENSAS",1329,28,1197,2554
"2020","LOUISIANA","TERREBONNE",11198,703,34339,46240
"2020","LOUISIANA","UNION",2654,140,8407,11201
"2020","LOUISIANA","VERMILION",5009,385,21930,27324
"2020","LOUISIANA","VERNON",2898,263,14107,17268
"2020","LOUISIANA","WASHINGTON",5970,236,13307,19513
"2020","LOUISIANA","WEBSTER",6172,214,11830,18216
"2020","LOUISIANA","WEST BATON ROUGE",6200,213,7684,14097
"2020","LOUISIANA","WEST CARROLL",710,25,4317,5052
"2020","LOUISIANA","WEST FELICIANA",2298,107,3863,6268
"2020","LOUISIANA","WINN",1543,63,4619,6225
"2020","MAINE","ANDROSCOGGIN",27617,2476,29268,59361
"2020","MAINE","AROOSTOOK",13956,1174,21080,36210
"2020","MAINE","CUMBERLAND",128759,7571,59584,195914
"2020","MAINE","FRANKLIN",8069,776,8754,17599
"2020","MAINE","HANCOCK",19369,1325,14982,35676
"2020","MAINE","KENNEBEC",34902,2992,34721,72615
"2020","MAINE","KNOX",15110,940,9982,26032
"2020","MAINE","LINCOLN",12684,917,10256,23857
"2020","MAINE","OXFORD",14755,1357,17698,33810
"2020","MAINE","PENOBSCOT",37713,3595,44825,86133
"2020","MAINE","PISCATAQUIS",3517,336,6143,9996
"2020","MAINE","SAGADAHOC",13528,997,9755,24280
"2020","MAINE","SOMERSET",10199,1030,16644,27873
"2020","MAINE","WALDO",12345,1025,11196,24566
"2020","MAINE","WASHINGTON",6761,615,10194,17570
"2020","MAINE","YORK",71189,5036,54817,131042
"2020","MARYLAND","ALLEGANY",9158,597,20886,30641
"2020","MARYLAND","ANNE ARUNDEL",172823,8973,127821,309617
"2020","MARYLAND","BALTIMORE",258409,10321,146202,414932
"2020","MARYLAND","BALTIMORE CITY",207260,4827,25374,237461
"2020","MARYLAND","CALVERT",22587,1180,25346,49113
"2020","MARYLAND","CAROLINE",5095,416,10283,15794
"2020","MARYLAND","CARROLL",36456,3653,60218,100327
"2020","MARYLAND","CECIL",16809,1214,29439,47462
"2020","MARYLAND","CHARLES",62171,1748,25579,89498
"2020","MARYLAND","DORCHESTER",6857,356,8764,15977
"2020","MARYLAND","FREDERICK",77675,4258,63682,145615
"2020","MARYLAND","GARRETT",3281,328,12002,15611
"2020","MARYLAND","HARFORD",63095,4161,80930,148186
"2020","MARYLAND","HOWARD",129433,5239,48390,183062
"2020","MARYLAND","KENT",5329,270,5195,10794
"2020","MARYLAND","MONTGOMERY",419569,12952,101222,533743
"2020","MARYLAND","PRINCE GEORGE'S",379208,8557,37090,424855
"2020","MARYLAND","QUEEN ANNE'S",10709,840,18741,30290
"2020","MARYLAND","SOMERSET",4241,167,5739,10147
"2020","MARYLAND","ST MARY'S",23138,1701,30826,55665
"2020","MARYLAND","TALBOT",11062,547,10946,22555
"2020","MARYLAND","WASHINGTON",26044,1511,40224,67779
"2020","MARYLAND","WICOMICO",22054,1218,22944,46216
"2020","MARYLAND","WORCESTER",12560,560,18571,31691
"2020","MASSACHUSETTS","BARNSTABLE",91994,4207,55311,151512
"2020","MASSACHUSETTS","BERKSHIRE",51705,2002,18064,71771
"2020","MASSACHUSETTS","BRISTOL",153377,8115,119872,281364
"2020","MASSACHUSETTS","DUKES",9914,328,2631,12873
"2020","MASSACHUSETTS","ESSEX",267198,12564,144837,424599
"2020","MASSACHUSETTS","FRANKLIN",30030,1772,11201,43003
"2020","MASSACHUSETTS","HAMPDEN",125948,7527,87318,220793
"2020","MASSACHUSETTS","HAMPSHIRE",63362,2689,22281,88332
"2020","MASSACHUSETTS","MIDDLESEX",617196,25195,226956,869347
"2020","MASSACHUSETTS","NANTUCKET",5241,183,1914,7338
"2020","MASSACHUSETTS","NORFOLK",273312,12436,125294,411042
"2020","MASSACHUSETTS","PLYMOUTH",173630,9013,121227,303870
"2020","MASSACHUSETTS","SUFFOLK",270522,8105,58613,337240
"2020","MASSACHUSETTS","WORCESTER",248773,14465,171683,434921
"2020","MICHIGAN","ALCONA",2142,74,4848,7064
"2020","MICHIGAN","ALGER",2053,61,3014,5128
"2020","MICHIGAN","ALLEGAN",24449,1253,41392,67094
"2020","MICHIGAN","ALPENA",6000,283,10686,16969
"2020","MICHIGAN","ANTRIM",5960,241,9748,15949
"2020","MICHIGAN","ARENAC",2774,129,5928,8831
"2020","MICHIGAN","BARAGA",1478,48,2512,4038
"2020","MICHIGAN","BARRY",11797,637,23471,35905
"2020","MICHIGAN","BAY",26151,979,33125,60255
"2020","MICHIGAN","BENZIE",5480,181,6601,12262
"2020","MICHIGAN","BERRIEN",37438,1434,43519,82391
"2020","MICHIGAN","BRANCH",6159,313,14064,20536
"2020","MICHIGAN","CALHOUN",28877,1183,36221,66281
"2020","MICHIGAN","CASS",9130,387,16699,26216
"2020","MICHIGAN","CHARLEVOIX",6939,220,9841,17000
"2020","MICHIGAN","CHEBOYGAN",5437,245,10186,15868
"2020","MICHIGAN","CHIPPEWA",6648,313,10681,17642
"2020","MICHIGAN","CLARE",5199,221,10861,16281
"2020","MICHIGAN","CLINTON",21968,861,25098,47927
"2020","MICHIGAN","CRAWFORD",2672,102,5087,7861
"2020","MICHIGAN","DELTA",7606,338,13207,21151
"2020","MICHIGAN","DICKINSON",4744,228,9617,14589
"2020","MICHIGAN","EATON",31299,1230,31798,64327
"2020","MICHIGAN","EMMET",9662,380,12135,22177
"2020","MICHIGAN","GENESEE",119390,3256,98714,221360
"2020","MICHIGAN","GLADWIN",4524,186,9893,14603
"2020","MICHIGAN","GOGEBIC",3570,96,4600,8266
"2020","MICHIGAN","GRAND TRAVERSE",28683,1051,30502,60236
"2020","MICHIGAN","GRATIOT",6693,332,12102,19127
"2020","MICHIGAN","HILLSDALE",5883,382,17037,23302
"2020","MICHIGAN","HOUGHTON",7750,373,10378,18501
"2020","MICHIGAN","HURON",5490,216,12731,18437
"2020","MICHIGAN","INGHAM",94212,2699,47639,144550
"2020","MICHIGAN","IONIA",10901,651,20657,32209
"2020","MICHIGAN","IOSCO",5373,231,9759,15363
"2020","MICHIGAN","IRON",2493,80,4216,6789
"2020","MICHIGAN","ISABELLA",14072,534,14815,29421
"2020","MICHIGAN","JACKSON",31995,1494,47372,80861
"2020","MICHIGAN","KALAMAZOO",83686,2905,56823,143414
"2020","MICHIGAN","KALKASKA",3002,193,7436,10631
"2020","MICHIGAN","KENT",187915,7392,165741,361048
"2020","MICHIGAN","KEWEENAW",672,23,862,1557
"2020","MICHIGAN","LAKE",2288,89,3946,6323
"2020","MICHIGAN","LAPEER",16367,801,35482,52650
"2020","MICHIGAN","LEELANAU",8795,189,7916,16900
"2020","MICHIGAN","LENAWEE",20918,916,31541,53375
"2020","MICHIGAN","LIVINGSTON",48220,1995,76982,127197
"2020","MICHIGAN","LUCE",842,50,2109,3001
"2020","MICHIGAN","MACKINAC",2632,79,4304,7015
"2020","MICHIGAN","MACOMB",223952,6441,263863,494256
"2020","MICHIGAN","MANISTEE",6107,227,8321,14655
"2020","MICHIGAN","MARQUETTE",20465,711,16286,37462
"2020","MICHIGAN","MASON",6802,245,10207,17254
"2020","MICHIGAN","MECOSTA",7375,407,13267,21049
"2020","MICHIGAN","MENOMINEE",4316,174,8117,12607
"2020","MICHIGAN","MIDLAND",20493,920,27675,49088
"2020","MICHIGAN","MISSAUKEE",1967,140,6648,8755
"2020","MICHIGAN","MONROE",32975,1463,52710,87148
"2020","MICHIGAN","MONTCALM",9703,582,21815,32100
"2020","MICHIGAN","MONTMORENCY",1628,60,4171,5859
"2020","MICHIGAN","MUSKEGON",45643,1668,45133,92444
"2020","MICHIGAN","NEWAYGO",7873,431,18857,27161
"2020","MICHIGAN","OAKLAND",434148,10232,325971,770351
"2020","MICHIGAN","OCEANA",4944,226,8892,14062
"2020","MICHIGAN","OGEMAW",3475,179,8253,11907
"2020","MICHIGAN","ONTONAGON",1391,55,2358,3804
"2020","MICHIGAN","OSCEOLA",3214,187,8928,12329
"2020","MICHIGAN","OSCODA",1342,66,3466,4874
"2020","MICHIGAN","OTSEGO",4743,235,9779,14757
"2020","MICHIGAN","OTTAWA",64705,3095,100913,168713
"2020","MICHIGAN","PRESQUE ISLE",2911,91,5342,8344
"2020","MICHIGAN","ROSCOMMON",5166,182,9670,15018
"2020","MICHIGAN","SAGINAW",51088,1476,50785,103349
"2020","MICHIGAN","SANILAC",5966,286,16194,22446
"2020","MICHIGAN","SCHOOLCRAFT",1589,66,3090,4745
"2020","MICHIGAN","SHIAWASSEE",15347,728,23149,39224
"2020","MICHIGAN","ST. CLAIR",31363,1516,59185,92064
"2020","MICHIGAN","ST. JOSEPH",9262,547,18127,27936
"2020","MICHIGAN","TUSCOLA",8712,436,20297,29445
"2020","MICHIGAN","VAN BUREN",16803,672,21591,39066
"2020","MICHIGAN","WASHTENAW",157136,3041,56241,216418
"2020","MICHIGAN","WAYNE",597170,10746,264553,872469
"2020","MICHIGAN","WEXFORD",5838,325,12102,18265
"2020","MINNESOTA","AITKIN",3607,160,6258,10025
"2020","MINNESOTA","ANOKA",100893,5337,104902,211132
"2020","MINNESOTA","BECKER",6589,374,12438,19401
"2020","MINNESOTA","BELTRAMI",11426,575,12188,24189
"2020","MINNESOTA","BENTON",7280,598,14382,22260
"2020","MINNESOTA","BIG STONE",1053,58,1863,2974
"2020","MINNESOTA","BLUE EARTH",18330,990,16731,36051
"2020","MINNESOTA","BROWN",4753,330,9552,14635
"2020","MINNESOTA","CARLTON",10098,480,9791,20369
"2020","MINNESOTA","CARVER",30774,1578,34009,66361
"2020","MINNESOTA","CASS",6342,327,11620,18289
"2020","MINNESOTA","CHIPPEWA",2226,135,4250,6611
"2020","MINNESOTA","CHISAGO",11806,848,21916,34570
"2020","MINNESOTA","CLAY",16357,839,15043,32239
"2020","MINNESOTA","CLEARWATER",1260,76,3372,4708
"2020","MINNESOTA","COOK",2496,107,1203,3806
"2020","MINNESOTA","COTTONWOOD",1834,108,4165,6107
"2020","MINNESOTA","CROW WING",13726,771,25676,40173
"2020","MINNESOTA","DAKOTA",146155,6466,109638,262259
"2020","MINNESOTA","DODGE",4079,325,7783,12187
"2020","MINNESOTA","DOUGLAS",7868,498,15799,24165
"2020","MINNESOTA","FARIBAULT",2531,192,5191,7914
"2020","MINNESOTA","FILLMORE",4551,289,7301,12141
"2020","MINNESOTA","FREEBORN",6889,351,9578,16818
"2020","MINNESOTA","GOODHUE",11806,778,16052,28636
"2020","MINNESOTA","GRANT",1300,85,2269,3654
"2020","MINNESOTA","HENNEPIN",532623,17373,205973,755969
"2020","MINNESOTA","HOUSTON",4853,253,6334,11440
"2020","MINNESOTA","HUBBARD",4462,301,8202,12965
"2020","MINNESOTA","ISANTI",7138,606,16491,24235
"2020","MINNESOTA","ITASCA",10786,536,15239,26561
"2020","MINNESOTA","JACKSON",1745,126,3948,5819
"2020","MINNESOTA","KANABEC",2774,190,6278,9242
"2020","MINNESOTA","KANDIYOHI",8440,490,14437,23367
"2020","MINNESOTA","KITTSON",1006,87,1546,2639
"2020","MINNESOTA","KOOCHICHING",2659,132,4131,6922
"2020","MINNESOTA","LAC QUI PARLE",1446,66,2528,4040
"2020","MINNESOTA","LAKE",3647,162,3393,7202
"2020","MINNESOTA","LAKE OF THE WOODS",671,33,1704,2408
"2020","MINNESOTA","LE SUEUR",5672,371,10775,16818
"2020","MINNESOTA","LINCOLN",937,57,2121,3115
"2020","MINNESOTA","LYON",4634,280,7979,12893
"2020","MINNESOTA","MAHNOMEN",1112,50,1142,2304
"2020","MINNESOTA","MARSHALL",1295,97,3721,5113
"2020","MINNESOTA","MARTIN",3305,224,7480,11009
"2020","MINNESOTA","MCLEOD",6413,534,13986,20933
"2020","MINNESOTA","MEEKER",3867,303,9359,13529
"2020","MINNESOTA","MILLE LACS",4404,333,9952,14689
"2020","MINNESOTA","MORRISON",4367,370,14821,19558
"2020","MINNESOTA","MOWER",8899,421,10025,19345
"2020","MINNESOTA","MURRAY",1449,84,3363,4896
"2020","MINNESOTA","NICOLLET",9622,485,9018,19125
"2020","MINNESOTA","NOBLES",2933,182,5600,8715
"2020","MINNESOTA","NORMAN",1404,84,1953,3441
"2020","MINNESOTA","OLMSTED",49491,2202,39692,91385
"2020","MINNESOTA","OTTER TAIL",11958,641,23800,36399
"2020","MINNESOTA","PENNINGTON",2568,177,4532,7277
"2020","MINNESOTA","PINE",5419,326,10256,16001
"2020","MINNESOTA","PIPESTONE",1306,81,3553,4940
"2020","MINNESOTA","POLK",5439,290,9865,15594
"2020","MINNESOTA","POPE",2477,128,4417,7022
"2020","MINNESOTA","RAMSEY",211620,6981,77376,295977
"2020","MINNESOTA","RED LAKE",691,51,1454,2196
"2020","MINNESOTA","REDWOOD",2355,158,5771,8284
"2020","MINNESOTA","RENVILLE",2496,165,5467,8128
"2020","MINNESOTA","RICE",17402,820,17464,35686
"2020","MINNESOTA","ROCK",1556,101,3583,5240
"2020","MINNESOTA","ROSEAU",2188,168,6065,8421
"2020","MINNESOTA","SAINT LOUIS",67704,2810,49017,119531
"2020","MINNESOTA","SCOTT",40040,2053,45872,87965
"2020","MINNESOTA","SHERBURNE",18065,1325,36222,55612
"2020","MINNESOTA","SIBLEY",2417,171,5864,8452
"2020","MINNESOTA","STEARNS",31879,1997,50959,84835
"2020","MINNESOTA","STEELE",7917,555,12656,21128
"2020","MINNESOTA","STEVENS",1922,119,3044,5085
"2020","MINNESOTA","SWIFT",1784,93,3316,5193
"2020","MINNESOTA","TODD",3286,218,9753,13257
"2020","MINNESOTA","TRAVERSE",661,31,1172,1864
"2020","MINNESOTA","WABASHA",4696,274,8153,13123
"2020","MINNESOTA","WADENA",2023,134,5520,7677
"2020","MINNESOTA","WASECA",3496,269,6624,10389
"2020","MINNESOTA","WASHINGTON",89165,3857,73764,166786
"2020","MINNESOTA","WATONWAN",1987,111,3103,5201
"2020","MINNESOTA","WILKIN",1026,76,2328,3430
"2020","MINNESOTA","WINONA",13333,613,13227,27173
"2020","MINNESOTA","WRIGHT",28430,2023,51973,82426
"2020","MINNESOTA","YELLOW MEDICINE",1688,106,3734,5528
"2020","MISSISSIPPI","ADAMS",7917,146,5696,13759
"2020","MISSISSIPPI","ALCORN",2782,193,12818,15793
"2020","MISSISSIPPI","AMITE",2620,73,4503,7196
"2020","MISSISSIPPI","ATTALA",3542,103,5178,8823
"2020","MISSISSIPPI","BENTON",1679,40,2570,4289
"2020","MISSISSIPPI","BOLIVAR",8904,169,4671,13744
"2020","MISSISSIPPI","CALHOUN",1902,63,4625,6590
"2020","MISSISSIPPI","CARROLL",1729,48,3924,5701
"2020","MISSISSIPPI","CHICKASAW",3810,156,4175,8141
"2020","MISSISSIPPI","CHOCTAW",1185,37,3001,4223
"2020","MISSISSIPPI","CLAIBORNE",3772,74,603,4449
"2020","MISSISSIPPI","CLARKE",2838,83,5417,8338
"2020","MISSISSIPPI","CLAY",5844,164,4181,10189
"2020","MISSISSIPPI","COAHOMA",6020,106,2375,8501
"2020","MISSISSIPPI","COPIAH",6470,163,6250,12883
"2020","MISSISSIPPI","COVINGTON",3416,90,5854,9360
"2020","MISSISSIPPI","DESOTO",28265,1397,46462,76124
"2020","MISSISSIPPI","FORREST",13755,609,17290,31654
"2020","MISSISSIPPI","FRANKLIN",1480,58,2923,4461
"2020","MISSISSIPPI","GEORGE",1218,118,9713,11049
"2020","MISSISSIPPI","GREENE",966,52,4794,5812
"2020","MISSISSIPPI","GRENADA",4734,96,6081,10911
"2020","MISSISSIPPI","HANCOCK",4504,321,16132,20957
"2020","MISSISSIPPI","HARRISON",27728,1218,46822,75768
"2020","MISSISSIPPI","HINDS",73550,1304,25141,99995
"2020","MISSISSIPPI","HOLMES",6588,158,1369,8115
"2020","MISSISSIPPI","HUMPHREYS",3016,55,1118,4189
"2020","MISSISSIPPI","ISSAQUENA",355,13,308,676
"2020","MISSISSIPPI","ITAWAMBA",1249,132,9438,10819
"2020","MISSISSIPPI","JACKSON",17375,873,36295,54543
"2020","MISSISSIPPI","JASPER",4341,93,4302,8736
"2020","MISSISSIPPI","JEFFERSON",3327,50,531,3908
"2020","MISSISSIPPI","JEFFERSON DAVIS",3599,80,2534,6213
"2020","MISSISSIPPI","JONES",8517,348,21226,30091
"2020","MISSISSIPPI","KEMPER",2887,57,1787,4731
"2020","MISSISSIPPI","LAFAYETTE",10070,404,12949,23423
"2020","MISSISSIPPI","LAMAR",7340,441,20704,28485
"2020","MISSISSIPPI","LAUDERDALE",12960,320,17967,31247
"2020","MISSISSIPPI","LAWRENCE",2260,68,4285,6613
"2020","MISSISSIPPI","LEAKE",3897,75,5228,9200
"2020","MISSISSIPPI","LEE",12189,558,24207,36954
"2020","MISSISSIPPI","LEFLORE",7648,116,3129,10893
"2020","MISSISSIPPI","LINCOLN",5040,165,11596,16801
"2020","MISSISSIPPI","LOWNDES",13087,354,13800,27241
"2020","MISSISSIPPI","MADISON",24440,681,31091,56212
"2020","MISSISSIPPI","MARION",3787,117,8273,12177
"2020","MISSISSIPPI","MARSHALL",8057,194,7566,15817
"2020","MISSISSIPPI","MONROE",5874,208,11177,17259
"2020","MISSISSIPPI","MONTGOMERY",2121,37,2917,5075
"2020","MISSISSIPPI","NESHOBA",3260,123,8320,11703
"2020","MISSISSIPPI","NEWTON",3075,111,6997,10183
"2020","MISSISSIPPI","NOXUBEE",4040,59,1240,5339
"2020","MISSISSIPPI","OKTIBBEHA",10299,454,9004,19757
"2020","MISSISSIPPI","PANOLA",7403,164,8060,15627
"2020","MISSISSIPPI","PEARL RIVER",4148,290,19595,24033
"2020","MISSISSIPPI","PERRY",1362,54,4500,5916
"2020","MISSISSIPPI","PIKE",8646,217,8479,17342
"2020","MISSISSIPPI","PONTOTOC",2614,197,11550,14361
"2020","MISSISSIPPI","PRENTISS",2153,121,8370,10644
"2020","MISSISSIPPI","QUITMAN",2150,50,1026,3226
"2020","MISSISSIPPI","RANKIN",18847,913,50895,70655
"2020","MISSISSIPPI","SCOTT",4330,118,6285,10733
"2020","MISSISSIPPI","SHARKEY",1465,30,688,2183
"2020","MISSISSIPPI","SIMPSON",4037,143,7635,11815
"2020","MISSISSIPPI","SMITH",1791,78,6458,8327
"2020","MISSISSIPPI","STONE",1802,112,5964,7878
"2020","MISSISSIPPI","SUNFLOWER",6781,101,2799,9681
"2020","MISSISSIPPI","TALLAHATCHIE",3105,92,2488,5685
"2020","MISSISSIPPI","TATE",4183,203,8707,13093
"2020","MISSISSIPPI","TIPPAH",1937,111,8054,10102
"2020","MISSISSIPPI","TISHOMINGO",1059,146,7933,9138
"2020","MISSISSIPPI","TUNICA",2580,56,926,3562
"2020","MISSISSIPPI","UNION",2160,150,10373,12683
"2020","MISSISSIPPI","WALTHALL",2835,64,4220,7119
"2020","MISSISSIPPI","WARREN",10442,246,10365,21053
"2020","MISSISSIPPI","WASHINGTON",12503,205,5300,18008
"2020","MISSISSIPPI","WAYNE",3624,125,6307,10056
"2020","MISSISSIPPI","WEBSTER",1043,61,4291,5395
"2020","MISSISSIPPI","WILKINSON",2749,54,1324,4127
"2020","MISSISSIPPI","WINSTON",4040,84,5112,9236
"2020","MISSISSIPPI","YALOBUSHA",2785,79,3671,6535
"2020","MISSISSIPPI","YAZOO",5496,108,4832,10436
"2020","MISSOURI","ADAIR",3710,213,6413,10336
"2020","MISSOURI","ANDREW",2351,146,7255,9752
"2020","MISSOURI","ATCHISON",564,51,2199,2814
"2020","MISSOURI","AUDRAIN",2704,220,7732,10656
"2020","MISSOURI","BARRY",2948,225,12425,15598
"2020","MISSOURI","BARTON",844,65,5168,6077
"2020","MISSOURI","BATES",1672,147,6597,8416
"2020","MISSOURI","BENTON",2180,187,8109,10476
"2020","MISSOURI","BOLLINGER",750,66,5167,5983
"2020","MISSOURI","BOONE",50064,2458,38646,91168
"2020","MISSOURI","BUCHANAN",13445,703,22450,36598
"2020","MISSOURI","BUTLER",3301,238,14602,18141
"2020","MISSOURI","CALDWELL",897,60,3725,4682
"2020","MISSOURI","CALLAWAY",5870,459,14815,21144
"2020","MISSOURI","CAMDEN",5652,310,18850,24812
"2020","MISSOURI","CAPE GIRARDEAU",10760,661,28907,40328
"2020","MISSOURI","CARROLL",786,40,3706,4532
"2020","MISSOURI","CARTER",418,28,2451,2897
"2020","MISSOURI","CASS",19052,1159,37197,57408
"2020","MISSOURI","CEDAR",1145,111,5788,7044
"2020","MISSOURI","CHARITON",916,50,3111,4077
"2020","MISSOURI","CHRISTIAN",11131,788,34920,46839
"2020","MISSOURI","CLARK",678,44,2672,3394
"2020","MISSOURI","CLAY",59400,2564,64605,126569
"2020","MISSOURI","CLINTON",2896,193,7799,10888
"2020","MISSOURI","COLE",12694,749,26086,39529
"2020","MISSOURI","COOPER",2249,172,6272,8693
"2020","MISSOURI","CRAWFORD",2113,135,8725,10973
"2020","MISSOURI","DADE",656,49,3414,4119
"2020","MISSOURI","DALLAS",1380,105,6619,8104
"2020","MISSOURI","DAVIESS",746,63,3102,3911
"2020","MISSOURI","DEKALB",930,85,3828,4843
"2020","MISSOURI","DENT",1056,99,5987,7142
"2020","MISSOURI","DOUGLAS",1016,86,5898,7000
"2020","MISSOURI","DUNKLIN",2200,84,8135,10419
"2020","MISSOURI","FRANKLIN",14569,1058,38058,53685
"2020","MISSOURI","GASCONADE",1601,100,6222,7923
"2020","MISSOURI","GENTRY",613,43,2581,3237
"2020","MISSOURI","GREENE",55068,3102,83630,141800
"2020","MISSOURI","GRUNDY",799,53,3585,4437
"2020","MISSOURI","HARRISON",597,31,3198,3826
"2020","MISSOURI","HENRY",2619,142,8027,10788
"2020","MISSOURI","HICKORY",1056,58,3966,5080
"2020","MISSOURI","HOLT",338,29,1976,2343
"2020","MISSOURI","HOWARD",1413,126,3553,5092
"2020","MISSOURI","HOWELL",3218,251,15181,18650
"2020","MISSOURI","IRON",945,51,3596,4592
"2020","MISSOURI","JACKSON",92182,4094,100142,196418
"2020","MISSOURI","JASPER",13549,1075,37728,52352
"2020","MISSOURI","JEFFERSON",37523,2119,77046,116688
"2020","MISSOURI","JOHNSON",6974,660,15489,23123
"2020","MISSOURI","KANSAS CITY",107660,2592,26393,136645
"2020","MISSOURI","KNOX",340,28,1486,1854
"2020","MISSOURI","LACLEDE",2780,251,13762,16793
"2020","MISSOURI","LAFAYETTE",4472,310,12273,17055
"2020","MISSOURI","LAWRENCE",3214,265,14426,17905
"2020","MISSOURI","LEWIS",984,72,3553,4609
"2020","MISSOURI","LINCOLN",6607,563,21848,29018
"2020","MISSOURI","LINN",1275,88,4363,5726
"2020","MISSOURI","LIVINGSTON",1410,81,5267,6758
"2020","MISSOURI","MACON",1662,98,6076,7836
"2020","MISSOURI","MADISON",1019,73,4584,5676
"2020","MISSOURI","MARIES",814,65,3892,4771
"2020","MISSOURI","MARION",3202,231,9915,13348
"2020","MISSOURI","MCDONALD",1439,149,7465,9053
"2020","MISSOURI","MERCER",222,16,1541,1779
"2020","MISSOURI","MILLER",2038,168,10176,12382
"2020","MISSOURI","MISSISSIPPI",1178,41,3537,4756
"2020","MISSOURI","MONITEAU",1308,105,5744,7157
"2020","MISSOURI","MONROE",936,70,3477,4483
"2020","MISSOURI","MONTGOMERY",1208,99,4465,5772
"2020","MISSOURI","MORGAN",1924,121,7442,9487
"2020","MISSOURI","NEW MADRID",1748,55,5447,7250
"2020","MISSOURI","NEWTON",5818,467,22120,28405
"2020","MISSOURI","NODAWAY",2853,175,6865,9893
"2020","MISSOURI","OREGON",823,69,3847,4739
"2020","MISSOURI","OSAGE",1037,77,6425,7539
"2020","MISSOURI","OZARK",752,48,4064,4864
"2020","MISSOURI","PEMISCOT",1560,55,4120,5735
"2020","MISSOURI","PERRY",1664,126,7657,9447
"2020","MISSOURI","PETTIS",4783,460,13854,19097
"2020","MISSOURI","PHELPS",5637,451,13480,19568
"2020","MISSOURI","PIKE",1717,115,5863,7695
"2020","MISSOURI","PLATTE",27179,1174,28917,57270
"2020","MISSOURI","POLK",2885,329,11850,15064
"2020","MISSOURI","PULASKI",3740,345,10329,14414
"2020","MISSOURI","PUTNAM",361,16,1984,2361
"2020","MISSOURI","RALLS",1205,61,4396,5662
"2020","MISSOURI","RANDOLPH",2485,241,8018,10744
"2020","MISSOURI","RAY",3109,195,8345,11649
"2020","MISSOURI","REYNOLDS",529,36,2733,3298
"2020","MISSOURI","RIPLEY",833,45,4839,5717
"2020","MISSOURI","SALINE",2904,164,6451,9519
"2020","MISSOURI","SCHUYLER",373,24,1606,2003
"2020","MISSOURI","SCOTLAND",388,36,1560,1984
"2020","MISSOURI","SCOTT",3753,197,13769,17719
"2020","MISSOURI","SHANNON",706,35,3165,3906
"2020","MISSOURI","SHELBY",592,58,2700,3350
"2020","MISSOURI","ST. CHARLES",89530,4098,128389,222017
"2020","MISSOURI","ST. CLAIR",988,54,3932,4974
"2020","MISSOURI","ST. FRANCOIS",7044,446,20511,28001
"2020","MISSOURI","ST. LOUIS CITY",110089,2304,21474,133867
"2020","MISSOURI","ST. LOUIS COUNTY",328151,8802,199493,536446
"2020","MISSOURI","STE. GENEVIEVE",2713,141,6630,9484
"2020","MISSOURI","STODDARD",1819,123,11484,13426
"2020","MISSOURI","STONE",3506,177,14800,18483
"2020","MISSOURI","SULLIVAN",478,19,1974,2471
"2020","MISSOURI","TANEY",5339,441,20508,26288
"2020","MISSOURI","TEXAS",1716,121,9478,11315
"2020","MISSOURI","VERNON",1903,127,7155,9185
"2020","MISSOURI","WARREN",4769,384,13222,18375
"2020","MISSOURI","WASHINGTON",1804,125,8047,9976
"2020","MISSOURI","WAYNE",845,46,4987,5878
"2020","MISSOURI","WEBSTER",3573,326,14880,18779
"2020","MISSOURI","WORTH",215,15,877,1107
"2020","MISSOURI","WRIGHT",1168,118,7453,8739
"2020","MONTANA","BEAVERHEAD",1608,130,3923,5661
"2020","MONTANA","BIG HORN",2491,86,2207,4784
"2020","MONTANA","BLAINE",1589,59,1469,3117
"2020","MONTANA","BROADWATER",835,89,3173,4097
"2020","MONTANA","CARBON",2421,163,4468,7052
"2020","MONTANA","CARTER",74,15,775,864
"2020","MONTANA","CASCADE",15456,1114,23315,39885
"2020","MONTANA","CHOUTEAU",991,83,1891,2965
"2020","MONTANA","CUSTER",1514,141,4205,5860
"2020","MONTANA","DANIELS",195,20,799,1014
"2020","MONTANA","DAWSON",962,105,3758,4825
"2020","MONTANA","DEER LODGE",2562,143,2186,4891
"2020","MONTANA","FALLON",172,28,1375,1575
"2020","MONTANA","FERGUS",1496,142,4869,6507
"2020","MONTANA","FLATHEAD",20274,1341,38321,59936
"2020","MONTANA","GALLATIN",37044,2239,31696,70979
"2020","MONTANA","GARFIELD",41,8,764,813
"2020","MONTANA","GLACIER",3610,123,1884,5617
"2020","MONTANA","GOLDEN VALLEY",78,11,414,503
"2020","MONTANA","GRANITE",638,45,1419,2102
"2020","MONTANA","HILL",2981,244,3957,7182
"2020","MONTANA","JEFFERSON",2625,181,5345,8151
"2020","MONTANA","JUDITH BASIN",275,29,1040,1344
"2020","MONTANA","LAKE",6916,388,9322,16626
"2020","MONTANA","LEWIS AND CLARK",19743,1113,21409,42265
"2020","MONTANA","LIBERTY",249,13,821,1083
"2020","MONTANA","LINCOLN",2835,240,8672,11747
"2020","MONTANA","MADISON",1771,125,4191,6087
"2020","MONTANA","MCCONE",155,17,956,1128
"2020","MONTANA","MEAGHER",258,19,833,1110
"2020","MONTANA","MINERAL",686,49,1828,2563
"2020","MONTANA","MISSOULA",43357,1791,26347,71495
"2020","MONTANA","MUSSELSHELL",413,45,2423,2881
"2020","MONTANA","PARK",5280,261,6025,11566
"2020","MONTANA","PETROLEUM",39,11,298,348
"2020","MONTANA","PHILLIPS",416,30,1936,2382
"2020","MONTANA","PONDERA",903,61,2031,2995
"2020","MONTANA","POWDER RIVER",154,12,970,1136
"2020","MONTANA","POWELL",752,72,2355,3179
"2020","MONTANA","PRAIRIE",126,15,603,744
"2020","MONTANA","RAVALLI",8763,630,19114,28507
"2020","MONTANA","RICHLAND",875,123,4800,5798
"2020","MONTANA","ROOSEVELT",1910,111,1996,4017
"2020","MONTANA","ROSEBUD",1199,88,2486,3773
"2020","MONTANA","SANDERS",1820,142,5660,7622
"2020","MONTANA","SHERIDAN",574,53,1403,2030
"2020","MONTANA","SILVER BOW",10392,521,7745,18658
"2020","MONTANA","STILLWATER",1156,106,4462,5724
"2020","MONTANA","SWEET GRASS",549,57,1840,2446
"2020","MONTANA","TETON",1007,64,2608,3679
"2020","MONTANA","TOOLE",467,56,1596,2119
"2020","MONTANA","TREASURE",78,9,373,460
"2020","MONTANA","VALLEY",1030,96,3135,4261
"2020","MONTANA","WHEATLAND",225,20,823,1068
"2020","MONTANA","WIBAUX",77,5,516,598
"2020","MONTANA","YELLOWSTONE",30679,2370,50772,83821
"2020","NEBRASKA","ADAMS",4213,304,10085,14602
"2020","NEBRASKA","ANTELOPE",452,38,3093,3583
"2020","NEBRASKA","ARTHUR",21,3,260,284
"2020","NEBRASKA","BANNER",43,5,362,410
"2020","NEBRASKA","BLAINE",35,2,280,317
"2020","NEBRASKA","BOONE",499,65,2653,3217
"2020","NEBRASKA","BOX BUTTE",1051,128,4002,5181
"2020","NEBRASKA","BOYD",135,8,1010,1153
"2020","NEBRASKA","BROWN",191,18,1470,1679
"2020","NEBRASKA","BUFFALO",6350,599,16640,23589
"2020","NEBRASKA","BURT",1063,88,2580,3731
"2020","NEBRASKA","BUTLER",873,83,3542,4498
"2020","NEBRASKA","CASS",4737,426,10121,15284
"2020","NEBRASKA","CEDAR",725,97,4174,4996
"2020","NEBRASKA","CHASE",226,27,1740,1993
"2020","NEBRASKA","CHERRY",373,48,2844,3265
"2020","NEBRASKA","CHEYENNE",855,97,3813,4765
"2020","NEBRASKA","CLAY",632,78,2848,3558
"2020","NEBRASKA","COLFAX",1025,56,2636,3717
"2020","NEBRASKA","CUMING",870,74,3507,4451
"2020","NEBRASKA","CUSTER",786,117,5090,5993
"2020","NEBRASKA","DAKOTA",2744,124,3926,6794
"2020","NEBRASKA","DAWES",1082,108,2931,4121
"2020","NEBRASKA","DAWSON",2497,157,6524,9178
"2020","NEBRASKA","DEUEL",141,20,871,1032
"2020","NEBRASKA","DIXON",651,97,2335,3083
"2020","NEBRASKA","DODGE",5544,348,10984,16876
"2020","NEBRASKA","DOUGLAS",150350,5442,119159,274951
"2020","NEBRASKA","DUNDY",105,11,883,999
"2020","NEBRASKA","FILLMORE",693,82,2359,3134
"2020","NEBRASKA","FRANKLIN",276,11,1437,1724
"2020","NEBRASKA","FRONTIER",189,22,1229,1440
"2020","NEBRASKA","FURNAS",399,39,2163,2601
"2020","NEBRASKA","GAGE",3385,238,7445,11068
"2020","NEBRASKA","GARDEN",161,18,1016,1195
"2020","NEBRASKA","GARFIELD",133,9,933,1075
"2020","NEBRASKA","GOSPER",215,10,893,1118
"2020","NEBRASKA","GRANT",20,7,375,402
"2020","NEBRASKA","GREELEY",229,13,1016,1258
"2020","NEBRASKA","HALL",7681,504,16189,24374
"2020","NEBRASKA","HAMILTON",1118,106,4309,5533
"2020","NEBRASKA","HARLAN",282,31,1615,1928
"2020","NEBRASKA","HAYES",34,6,494,534
"2020","NEBRASKA","HITCHCOCK",175,30,1264,1469
"2020","NEBRASKA","HOLT",686,82,4769,5537
"2020","NEBRASKA","HOOKER",59,7,376,442
"2020","NEBRASKA","HOWARD",648,67,2786,3501
"2020","NEBRASKA","JEFFERSON",1016,84,2616,3716
"2020","NEBRASKA","JOHNSON",647,64,1518,2229
"2020","NEBRASKA","KEARNEY",701,81,2822,3604
"2020","NEBRASKA","KEITH",763,57,3544,4364
"2020","NEBRASKA","KEYA PAHA",49,4,476,529
"2020","NEBRASKA","KIMBALL",268,43,1563,1874
"2020","NEBRASKA","KNOX",905,71,3721,4697
"2020","NEBRASKA","LANCASTER",82293,3706,70092,156091
"2020","NEBRASKA","LINCOLN",3692,344,13071,17107
"2020","NEBRASKA","LOGAN",38,5,407,450
"2020","NEBRASKA","LOUP",75,9,370,454
"2020","NEBRASKA","MADISON",3478,347,11940,15765
"2020","NEBRASKA","MCPHERSON",17,10,275,302
"2020","NEBRASKA","MERRICK",743,95,3419,4257
"2020","NEBRASKA","MORRILL",386,58,2113,2557
"2020","NEBRASKA","NANCE",359,32,1437,1828
"2020","NEBRASKA","NEMAHA",921,74,2428,3423
"2020","NEBRASKA","NUCKOLLS",409,37,1857,2303
"2020","NEBRASKA","OTOE",2490,176,5649,8315
"2020","NEBRASKA","PAWNEE",322,36,1071,1429
"2020","NEBRASKA","PERKINS",199,24,1321,1544
"2020","NEBRASKA","PHELPS",752,100,4157,5009
"2020","NEBRASKA","PIERCE",480,64,3462,4006
"2020","NEBRASKA","PLATTE",3260,227,12186,15673
"2020","NEBRASKA","POLK",530,58,2291,2879
"2020","NEBRASKA","RED WILLOW",811,116,4525,5452
"2020","NEBRASKA","RICHARDSON",996,57,3073,4126
"2020","NEBRASKA","ROCK",84,13,744,841
"2020","NEBRASKA","SALINE",1986,153,3631,5770
"2020","NEBRASKA","SARPY",41206,2488,51979,95673
"2020","NEBRASKA","SAUNDERS",3331,296,9108,12735
"2020","NEBRASKA","SCOTTS BLUFF",4196,321,10952,15469
"2020","NEBRASKA","SEWARD",2438,214,6490,9142
"2020","NEBRASKA","SHERIDAN",340,40,2292,2672
"2020","NEBRASKA","SHERMAN",343,33,1322,1698
"2020","NEBRASKA","SIOUX",72,15,642,729
"2020","NEBRASKA","STANTON",532,68,2561,3161
"2020","NEBRASKA","THAYER",624,48,2308,2980
"2020","NEBRASKA","THOMAS",45,5,377,427
"2020","NEBRASKA","THURSTON",1122,23,1180,2325
"2020","NEBRASKA","VALLEY",412,27,1901,2340
"2020","NEBRASKA","WASHINGTON",3554,276,8583,12413
"2020","NEBRASKA","WAYNE",1022,123,3055,4200
"2020","NEBRASKA","WEBSTER",335,30,1511,1876
"2020","NEBRASKA","WHEELER",59,5,438,502
"2020","NEBRASKA","YORK",1630,176,5337,7143
"2020","NEVADA","CARSON CITY",12735,891,16113,29739
"2020","NEVADA","CHURCHILL",3048,466,9367,12881
"2020","NEVADA","CLARK",521777,19722,430809,972308
"2020","NEVADA","DOUGLAS",11570,924,21623,34117
"2020","NEVADA","ELKO",4555,668,16734,21957
"2020","NEVADA","ESMERALDA",72,13,395,480
"2020","NEVADA","EUREKA",104,17,887,1008
"2020","NEVADA","HUMBOLDT",1689,205,5877,7771
"2020","NEVADA","LANDER",496,71,2198,2765
"2020","NEVADA","LINCOLN",330,49,2067,2446
"2020","NEVADA","LYON",8472,851,20906,30229
"2020","NEVADA","MINERAL",824,83,1420,2327
"2020","NEVADA","NYE",7287,562,17527,25376
"2020","NEVADA","PERSHING",547,42,1731,2320
"2020","NEVADA","STOREY",900,67,1901,2868
"2020","NEVADA","WASHOE",128052,7251,116653,251956
"2020","NEVADA","WHITE PINE",856,107,3400,4363
"2020","NEW HAMPSHIRE","BELKNAP",16894,598,20899,38391
"2020","NEW HAMPSHIRE","CARROLL",16649,422,16150,33221
"2020","NEW HAMPSHIRE","CHESHIRE",25522,800,17898,44220
"2020","NEW HAMPSHIRE","COOS",7640,258,8617,16515
"2020","NEW HAMPSHIRE","GRAFTON",33180,881,19905,53966
"2020","NEW HAMPSHIRE","HILLSBOROUGH",122344,3972,104625,230941
"2020","NEW HAMPSHIRE","MERRIMACK",48533,1561,39711,89805
"2020","NEW HAMPSHIRE","ROCKINGHAM",100064,2876,95858,198798
"2020","NEW HAMPSHIRE","STRAFFORD",41721,1386,30489,73596
"2020","NEW HAMPSHIRE","SULLIVAN",12390,482,11508,24380
"2020","NEW JERSEY","ATLANTIC",73808,1785,64438,140031
"2020","NEW JERSEY","BERGEN",285967,5465,204417,495849
"2020","NEW JERSEY","BURLINGTON",154595,3557,103345,261497
"2020","NEW JERSEY","CAMDEN",175065,3344,86207,264616
"2020","NEW JERSEY","CAPE MAY",23941,615,33158,57714
"2020","NEW JERSEY","CUMBERLAND",32742,714,28952,62408
"2020","NEW JERSEY","ESSEX",266820,3016,75475,345311
"2020","NEW JERSEY","GLOUCESTER",86702,2612,83340,172654
"2020","NEW JERSEY","HUDSON",181452,2700,65698,249850
"2020","NEW JERSEY","HUNTERDON",39457,1632,43153,84242
"2020","NEW JERSEY","MERCER",122532,2431,51641,176604
"2020","NEW JERSEY","MIDDLESEX",226250,4645,143467,374362
"2020","NEW JERSEY","MONMOUTH",181291,5052,191808,378151
"2020","NEW JERSEY","MORRIS",153881,4307,141134,299322
"2020","NEW JERSEY","OCEAN",119456,4320,217740,341516
"2020","NEW JERSEY","PASSAIC",129097,2601,92009,223707
"2020","NEW JERSEY","SALEM",14479,616,18827,33922
"2020","NEW JERSEY","SOMERSET",111173,2690,71996,185859
"2020","NEW JERSEY","SUSSEX",34481,1781,51698,87960
"2020","NEW JERSEY","UNION",170245,2744,80002,252991
"2020","NEW JERSEY","WARREN",24901,1117,34769,60787
"2020","NEW MEXICO","BERNALILLO",193757,7698,116135,317590
"2020","NEW MEXICO","CATRON",595,33,1698,2326
"2020","NEW MEXICO","CHAVES",6381,406,15656,22443
"2020","NEW MEXICO","CIBOLA",4745,183,3975,8903
"2020","NEW MEXICO","COLFAX",2611,134,3271,6016
"2020","NEW MEXICO","CURRY",4307,350,10444,15101
"2020","NEW MEXICO","DE BACA",231,14,656,901
"2020","NEW MEXICO","DONA ANA",47957,1882,32802,82641
"2020","NEW MEXICO","EDDY",5424,344,17454,23222
"2020","NEW MEXICO","GRANT",7590,292,6553,14435
"2020","NEW MEXICO","GUADALUPE",1234,38,917,2189
"2020","NEW MEXICO","HARDING",179,7,319,505
"2020","NEW MEXICO","HIDALGO",823,31,1120,1974
"2020","NEW MEXICO","LEA",4061,326,16531,20918
"2020","NEW MEXICO","LINCOLN",3194,170,6942,10306
"2020","NEW MEXICO","LOS ALAMOS",7554,461,4278,12293
"2020","NEW MEXICO","LUNA",3563,132,4408,8103
"2020","NEW MEXICO","MCKINLEY",18029,656,7801,26486
"2020","NEW MEXICO","MORA",1745,38,903,2686
"2020","NEW MEXICO","OTERO",8485,565,14521,23571
"2020","NEW MEXICO","QUAY",1170,69,2634,3873
"2020","NEW MEXICO","RIO ARRIBA",10990,230,5408,16628
"2020","NEW MEXICO","ROOSEVELT",1802,172,4634,6608
"2020","NEW MEXICO","SAN JUAN",18083,1337,32874,52294
"2020","NEW MEXICO","SAN MIGUEL",7888,222,3421,11531
"2020","NEW MEXICO","SANDOVAL",40588,1800,34174,76562
"2020","NEW MEXICO","SANTA FE",62530,1368,18329,82227
"2020","NEW MEXICO","SIERRA",2265,138,3542,5945
"2020","NEW MEXICO","SOCORRO",3722,183,3255,7160
"2020","NEW MEXICO","TAOS",13121,345,3715,17181
"2020","NEW MEXICO","TORRANCE",2344,165,4772,7281
"2020","NEW MEXICO","UNION",383,18,1388,1789
"2020","NEW MEXICO","VALENCIA",14263,650,17364,32277
"2020","NEW YORK","ALBANY",99474,4172,51081,154727
"2020","NEW YORK","ALLEGANY",6048,712,14135,20895
"2020","NEW YORK","BRONX",355374,9285,67740,432399
"2020","NEW YORK","BROOME",47010,2684,43800,93494
"2020","NEW YORK","CATTARAUGUS",11879,984,22155,35018
"2020","NEW YORK","CAYUGA",16149,1099,19512,36760
"2020","NEW YORK","CHAUTAUQUA",23087,1830,34853,59770
"2020","NEW YORK","CHEMUNG",16636,1153,21922,39711
"2020","NEW YORK","CHENANGO",8290,645,13482,22417
"2020","NEW YORK","CLINTON",18364,759,16514,35637
"2020","NEW YORK","COLUMBIA",20386,931,14464,35781
"2020","NEW YORK","CORTLAND",10369,734,10789,21892
"2020","NEW YORK","DELAWARE",9143,544,13387,23074
"2020","NEW YORK","DUTCHESS",81443,3574,66872,151889
"2020","NEW YORK","ERIE",267174,12086,197527,476787
"2020","NEW YORK","ESSEX",9947,547,8976,19470
"2020","NEW YORK","FRANKLIN",9253,499,9668,19420
"2020","NEW YORK","FULTON",7931,763,15378,24072
"2020","NEW YORK","GENESEE",9625,930,18876,29431
"2020","NEW YORK","GREENE",10346,703,14271,25320
"2020","NEW YORK","HAMILTON",1178,86,2225,3489
"2020","NEW YORK","HERKIMER",9937,753,18870,29560
"2020","NEW YORK","JEFFERSON",17307,1193,25629,44129
"2020","NEW YORK","KINGS",703310,14298,202772,920380
"2020","NEW YORK","LEWIS",3824,318,8894,13036
"2020","NEW YORK","LIVINGSTON",12477,997,18182,31656
"2020","NEW YORK","MADISON",14807,1051,18408,34266
"2020","NEW YORK","MONROE",225746,12092,145661,383499
"2020","NEW YORK","MONTGOMERY",7977,524,12745,21246
"2020","NEW YORK","NASSAU",396504,15149,326716,738369
"2020","NEW YORK","NEW YORK",603040,13180,85185,701405
"2020","NEW YORK","NIAGARA",46029,2769,56068,104866
"2020","NEW YORK","ONEIDA",41567,2949,57180,101696
"2020","NEW YORK","ONONDAGA",138894,6173,90619,235686
"2020","NEW YORK","ONTARIO",29025,2021,29039,60085
"2020","NEW YORK","ORANGE",84684,3625,84996,173305
"2020","NEW YORK","ORLEANS",5587,601,12126,18314
"2020","NEW YORK","OSWEGO",21143,1571,32138,54852
"2020","NEW YORK","OTSEGO",12975,866,14382,28223
"2020","NEW YORK","PUTNAM",24953,1082,29283,55318
"2020","NEW YORK","QUEENS",569038,12795,212665,794498
"2020","NEW YORK","RENSSELAER",40969,2493,36500,79962
"2020","NEW YORK","RICHMOND",90997,3582,123320,217899
"2020","NEW YORK","ROCKLAND",75802,2393,73186,151381
"2020","NEW YORK","SARATOGA",68471,3780,61305,133556
"2020","NEW YORK","SCHENECTADY",42465,2175,30741,75381
"2020","NEW YORK","SCHOHARIE",5345,562,9903,15810
"2020","NEW YORK","SCHUYLER",3903,275,5621,9799
"2020","NEW YORK","SENECA",6914,475,8329,15718
"2020","NEW YORK","ST. LAWRENCE",19361,1298,24608,45267
"2020","NEW YORK","STEUBEN",15790,1252,29474,46516
"2020","NEW YORK","SUFFOLK",368000,14056,375821,757877
"2020","NEW YORK","SULLIVAN",15489,978,18665,35132
"2020","NEW YORK","TIOGA",9634,745,14791,25170
"2020","NEW YORK","TOMPKINS",33619,1333,11096,46048
"2020","NEW YORK","ULSTER",57970,2600,37590,98160
"2020","NEW YORK","WARREN",17642,1053,17699,36394
"2020","NEW YORK","WASHINGTON",11565,750,15941,28256
"2020","NEW YORK","WAYNE",17456,1371,26204,45031
"2020","NEW YORK","WESTCHESTER",312371,5181,144713,462265
"2020","NEW YORK","WYOMING",5073,512,13898,19483
"2020","NEW YORK","YATES",4219,361,6208,10788
"2020","NORTH CAROLINA","ALAMANCE",38825,1210,46056,86091
"2020","NORTH CAROLINA","ALEXANDER",4145,203,15888,20236
"2020","NORTH CAROLINA","ALLEGHANY",1486,63,4527,6076
"2020","NORTH CAROLINA","ANSON",5789,84,5321,11194
"2020","NORTH CAROLINA","ASHE",4164,199,11451,15814
"2020","NORTH CAROLINA","AVERY",2191,95,7172,9458
"2020","NORTH CAROLINA","BEAUFORT",9633,245,16437,26315
"2020","NORTH CAROLINA","BERTIE",5939,59,3817,9815
"2020","NORTH CAROLINA","BLADEN",7326,123,9676,17125
"2020","NORTH CAROLINA","BRUNSWICK",33310,1015,55850,90175
"2020","NORTH CAROLINA","BUNCOMBE",96515,2642,62412,161569
"2020","NORTH CAROLINA","BURKE",13118,465,31019,44602
"2020","NORTH CAROLINA","CABARRUS",52162,1828,63237,117227
"2020","NORTH CAROLINA","CALDWELL",10245,465,32119,42829
"2020","NORTH CAROLINA","CAMDEN",1537,104,4312,5953
"2020","NORTH CAROLINA","CARTERET",12093,574,30028,42695
"2020","NORTH CAROLINA","CASWELL",4860,102,7089,12051
"2020","NORTH CAROLINA","CATAWBA",25689,1148,56588,83425
"2020","NORTH CAROLINA","CHATHAM",26787,626,21186,48599
"2020","NORTH CAROLINA","CHEROKEE",3583,212,12628,16423
"2020","NORTH CAROLINA","CHOWAN",3247,66,4471,7784
"2020","NORTH CAROLINA","CLAY",1699,82,5112,6893
"2020","NORTH CAROLINA","CLEVELAND",16955,555,33798,51308
"2020","NORTH CAROLINA","COLUMBUS",9446,168,16832,26446
"2020","NORTH CAROLINA","CRAVEN",21148,885,31032,53065
"2020","NORTH CAROLINA","CUMBERLAND",84469,2649,60032,147150
"2020","NORTH CAROLINA","CURRITUCK",4195,295,11657,16147
"2020","NORTH CAROLINA","DARE",9936,358,13938,24232
"2020","NORTH CAROLINA","DAVIDSON",22636,1220,64658,88514
"2020","NORTH CAROLINA","DAVIE",6713,370,18228,25311
"2020","NORTH CAROLINA","DUPLIN",8767,155,13793,22715
"2020","NORTH CAROLINA","DURHAM",144688,2767,32459,179914
"2020","NORTH CAROLINA","EDGECOMBE",16089,182,9206,25477
"2020","NORTH CAROLINA","FORSYTH",113033,3173,85064,201270
"2020","NORTH CAROLINA","FRANKLIN",15879,571,20901,37351
"2020","NORTH CAROLINA","GASTON",40959,1506,73033,115498
"2020","NORTH CAROLINA","GATES",2546,58,3367,5971
"2020","NORTH CAROLINA","GRAHAM",905,50,3710,4665
"2020","NORTH CAROLINA","GRANVILLE",14565,386,16647,31598
"2020","NORTH CAROLINA","GREENE",3832,47,4874,8753
"2020","NORTH CAROLINA","GUILFORD",173086,4106,107294,284486
"2020","NORTH CAROLINA","HALIFAX",15545,134,10080,25759
"2020","NORTH CAROLINA","HARNETT",22093,1023,35177,58293
"2020","NORTH CAROLINA","HAYWOOD",13144,564,22834,36542
"2020","NORTH CAROLINA","HENDERSON",27211,1128,40032,68371
"2020","NORTH CAROLINA","HERTFORD",7097,58,3479,10634
"2020","NORTH CAROLINA","HOKE",11804,382,9453,21639
"2020","NORTH CAROLINA","HYDE",1046,28,1418,2492
"2020","NORTH CAROLINA","IREDELL",33888,1473,67010,102371
"2020","NORTH CAROLINA","JACKSON",9591,481,11356,21428
"2020","NORTH CAROLINA","JOHNSTON",41257,1747,68353,111357
"2020","NORTH CAROLINA","JONES",2197,48,3280,5525
"2020","NORTH CAROLINA","LEE",12143,396,16469,29008
"2020","NORTH CAROLINA","LENOIR",13605,214,14590,28409
"2020","NORTH CAROLINA","LINCOLN",13274,602,36341,50217
"2020","NORTH CAROLINA","MACON",6230,302,14211,20743
"2020","NORTH CAROLINA","MADISON",4901,196,7979,13076
"2020","NORTH CAROLINA","MARTIN",5911,97,6532,12540
"2020","NORTH CAROLINA","MCDOWELL",5832,288,16883,23003
"2020","NORTH CAROLINA","MECKLENBURG",378107,9735,179211,567053
"2020","NORTH CAROLINA","MITCHELL",1867,84,7090,9041
"2020","NORTH CAROLINA","MONTGOMERY",4327,111,8411,12849
"2020","NORTH CAROLINA","MOORE",20779,796,36764,58339
"2020","NORTH CAROLINA","NASH",25947,497,25827,52271
"2020","NORTH CAROLINA","NEW HANOVER",66138,2361,63331,131830
"2020","NORTH CAROLINA","NORTHAMPTON",6069,52,3989,10110
"2020","NORTH CAROLINA","ONSLOW",24266,1891,46078,72235
"2020","NORTH CAROLINA","ORANGE",63594,1227,20176,84997
"2020","NORTH CAROLINA","PAMLICO",2713,69,4849,7631
"2020","NORTH CAROLINA","PASQUOTANK",9832,295,9770,19897
"2020","NORTH CAROLINA","PENDER",11723,490,21956,34169
"2020","NORTH CAROLINA","PERQUIMANS",2492,89,4903,7484
"2020","NORTH CAROLINA","PERSON",8465,245,13184,21894
"2020","NORTH CAROLINA","PITT",47252,1339,38982,87573
"2020","NORTH CAROLINA","POLK",4518,151,7689,12358
"2020","NORTH CAROLINA","RANDOLPH",15618,804,56894,73316
"2020","NORTH CAROLINA","RICHMOND",8754,179,11830,20763
"2020","NORTH CAROLINA","ROBESON",19020,362,27806,47188
"2020","NORTH CAROLINA","ROCKINGHAM",15992,516,31301,47809
"2020","NORTH CAROLINA","ROWAN",23114,997,49297,73408
"2020","NORTH CAROLINA","RUTHERFORD",9135,403,24891,34429
"2020","NORTH CAROLINA","SAMPSON",10966,241,17411,28618
"2020","NORTH CAROLINA","SCOTLAND",7186,116,7473,14775
"2020","NORTH CAROLINA","STANLY",8129,352,25458,33939
"2020","NORTH CAROLINA","STOKES",5286,273,20142,25701
"2020","NORTH CAROLINA","SURRY",8721,379,27538,36638
"2020","NORTH CAROLINA","SWAIN",2780,127,4161,7068
"2020","NORTH CAROLINA","TRANSYLVANIA",8444,324,11636,20404
"2020","NORTH CAROLINA","TYRRELL",758,15,1044,1817
"2020","NORTH CAROLINA","UNION",48725,1904,80382,131011
"2020","NORTH CAROLINA","VANCE",12431,177,8391,20999
"2020","NORTH CAROLINA","WAKE",393336,12297,226197,631830
"2020","NORTH CAROLINA","WARREN",6400,141,3752,10293
"2020","NORTH CAROLINA","WASHINGTON",3396,28,2781,6205
"2020","NORTH CAROLINA","WATAUGA",17122,647,14451,32220
"2020","NORTH CAROLINA","WAYNE",24215,613,30709,55537
"2020","NORTH CAROLINA","WILKES",7511,363,27592,35466
"2020","NORTH CAROLINA","WILSON",20754,400,19581,40735
"2020","NORTH CAROLINA","YADKIN",3763,227,15933,19923
"2020","NORTH CAROLINA","YANCEY",3688,148,7516,11352
"2020","NORTH DAKOTA","ADAMS",258,30,981,1269
"2020","NORTH DAKOTA","BARNES",1820,177,3568,5565
"2020","NORTH DAKOTA","BENSON",822,45,1094,1961
"2020","NORTH DAKOTA","BILLINGS",72,22,541,635
"2020","NORTH DAKOTA","BOTTINEAU",821,75,2575,3471
"2020","NORTH DAKOTA","BOWMAN",228,34,1395,1657
"2020","NORTH DAKOTA","BURKE",137,24,994,1155
"2020","NORTH DAKOTA","BURLEIGH",14348,1661,34744,50753
"2020","NORTH DAKOTA","CASS",40311,3123,42619,86053
"2020","NORTH DAKOTA","CAVALIER",474,47,1499,2020
"2020","NORTH DAKOTA","DICKEY",608,74,1742,2424
"2020","NORTH DAKOTA","DIVIDE",265,33,904,1202
"2020","NORTH DAKOTA","DUNN",342,45,1951,2338
"2020","NORTH DAKOTA","EDDY",383,24,854,1261
"2020","NORTH DAKOTA","EMMONS",237,34,1738,2009
"2020","NORTH DAKOTA","FOSTER",373,43,1362,1778
"2020","NORTH DAKOTA","GOLDEN VALLEY",137,18,871,1026
"2020","NORTH DAKOTA","GRAND FORKS",12880,1103,16987,30970
"2020","NORTH DAKOTA","GRANT",207,29,1145,1381
"2020","NORTH DAKOTA","GRIGGS",308,35,907,1250
"2020","NORTH DAKOTA","HETTINGER",196,25,1091,1312
"2020","NORTH DAKOTA","KIDDER",221,24,1215,1460
"2020","NORTH DAKOTA","LAMOURE",527,47,1645,2219
"2020","NORTH DAKOTA","LOGAN",128,18,930,1076
"2020","NORTH DAKOTA","MCHENRY",564,75,2364,3003
"2020","NORTH DAKOTA","MCINTOSH",261,41,1153,1455
"2020","NORTH DAKOTA","MCKENZIE",814,123,4482,5419
"2020","NORTH DAKOTA","MCLEAN",1230,108,4198,5536
"2020","NORTH DAKOTA","MERCER",704,115,3856,4675
"2020","NORTH DAKOTA","MORTON",3872,504,12243,16619
"2020","NORTH DAKOTA","MOUNTRAIL",1256,85,2824,4165
"2020","NORTH DAKOTA","NELSON",586,50,1141,1777
"2020","NORTH DAKOTA","OLIVER",129,19,918,1066
"2020","NORTH DAKOTA","PEMBINA",786,85,2460,3331
"2020","NORTH DAKOTA","PIERCE",497,46,1585,2128
"2020","NORTH DAKOTA","RAMSEY",1639,156,3577,5372
"2020","NORTH DAKOTA","RANSOM",945,91,1418,2454
"2020","NORTH DAKOTA","RENVILLE",220,34,1065,1319
"2020","NORTH DAKOTA","RICHLAND",2510,230,5072,7812
"2020","NORTH DAKOTA","ROLETTE",2482,65,1257,3804
"2020","NORTH DAKOTA","SARGENT",738,66,1266,2070
"2020","NORTH DAKOTA","SHERIDAN",104,20,688,812
"2020","NORTH DAKOTA","SIOUX",804,124,258,1186
"2020","NORTH DAKOTA","SLOPE",44,3,380,427
"2020","NORTH DAKOTA","STARK",2499,441,12110,15050
"2020","NORTH DAKOTA","STEELE",392,44,652,1088
"2020","NORTH DAKOTA","STUTSMAN",2676,289,6994,9959
"2020","NORTH DAKOTA","TOWNER",317,27,830,1174
"2020","NORTH DAKOTA","TRAILL",1493,121,2522,4136
"2020","NORTH DAKOTA","WALSH",1333,126,3324,4783
"2020","NORTH DAKOTA","WARD",7293,979,19974,28246
"2020","NORTH DAKOTA","WELLS",442,39,1893,2374
"2020","NORTH DAKOTA","WILLIAMS",2169,426,11739,14334
"2020","OHIO","ADAMS",2156,119,9870,12145
"2020","OHIO","ALLEN",14149,741,33116,48006
"2020","OHIO","ASHLAND",6541,457,19407,26405
"2020","OHIO","ASHTABULA",16497,760,26890,44147
"2020","OHIO","ATHENS",14772,425,10862,26059
"2020","OHIO","AUGLAIZE",4651,328,20798,25777
"2020","OHIO","BELMONT",9138,390,23560,33088
"2020","OHIO","BROWN",4380,236,16480,21096
"2020","OHIO","BUTLER",69613,2732,114392,186737
"2020","OHIO","CARROLL",3251,216,10745,14212
"2020","OHIO","CHAMPAIGN",5062,321,14589,19972
"2020","OHIO","CLARK",24076,1104,39032,64212
"2020","OHIO","CLERMONT",34092,1818,74570,110480
"2020","OHIO","CLINTON",4697,342,15488,20527
"2020","OHIO","COLUMBIANA",13359,775,35726,49860
"2020","OHIO","COSHOCTON",4125,289,12325,16739
"2020","OHIO","CRAWFORD",4916,334,15436,20686
"2020","OHIO","CUYAHOGA",416176,6795,202699,625670
"2020","OHIO","DARKE",4731,399,22004,27134
"2020","OHIO","DEFIANCE",5981,362,13038,19381
"2020","OHIO","DELAWARE",57735,1979,66356,126070
"2020","OHIO","ERIE",17493,682,22160,40335
"2020","OHIO","FAIRFIELD",31224,1290,50797,83311
"2020","OHIO","FAYETTE",2975,164,9473,12612
"2020","OHIO","FRANKLIN",409144,10196,211237,630577
"2020","OHIO","FULTON",6664,375,15731,22770
"2020","OHIO","GALLIA",2990,164,10645,13799
"2020","OHIO","GEAUGA",21201,677,34143,56021
"2020","OHIO","GREENE",34798,1773,52072,88643
"2020","OHIO","GUERNSEY",4577,246,13407,18230
"2020","OHIO","HAMILTON",246266,6777,177886,430929
"2020","OHIO","HANCOCK",11757,704,26310,38771
"2020","OHIO","HARDIN",3062,236,9949,13247
"2020","OHIO","HARRISON",1768,95,5792,7655
"2020","OHIO","HENRY",4062,223,10479,14764
"2020","OHIO","HIGHLAND",3799,199,15678,19676
"2020","OHIO","HOCKING",3880,207,9737,13824
"2020","OHIO","HOLMES",1994,157,10796,12947
"2020","OHIO","HURON",7759,475,18956,27190
"2020","OHIO","JACKSON",3311,174,11309,14794
"2020","OHIO","JEFFERSON",10018,516,22828,33362
"2020","OHIO","KNOX",8589,469,22340,31398
"2020","OHIO","LAKE",55514,1717,73278,130509
"2020","OHIO","LAWRENCE",7489,332,20306,28127
"2020","OHIO","LICKING",33055,1641,59514,94210
"2020","OHIO","LOGAN",5055,349,17964,23368
"2020","OHIO","LORAIN",75667,2250,79520,157437
"2020","OHIO","LUCAS",115411,3449,81763,200623
"2020","OHIO","MADISON",5698,322,13835,19855
"2020","OHIO","MAHONING",57641,1422,59903,118966
"2020","OHIO","MARION",8269,526,19023,27818
"2020","OHIO","MEDINA",39800,1427,64598,105825
"2020","OHIO","MEIGS",2492,143,8316,10951
"2020","OHIO","MERCER",4030,279,19452,23761
"2020","OHIO","MIAMI",15663,938,41371,57972
"2020","OHIO","MONROE",1605,80,5463,7148
"2020","OHIO","MONTGOMERY",135064,4407,129034,268505
"2020","OHIO","MORGAN",1725,81,5041,6847
"2020","OHIO","MORROW",4048,332,14077,18457
"2020","OHIO","MUSKINGUM",11971,627,27867,40465
"2020","OHIO","NOBLE",1170,38,5135,6343
"2020","OHIO","OTTAWA",9008,371,14628,24007
"2020","OHIO","PAULDING",2213,168,7086,9467
"2020","OHIO","PERRY",4098,220,12357,16675
"2020","OHIO","PICKAWAY",7304,374,20593,28271
"2020","OHIO","PIKE",3110,145,9157,12412
"2020","OHIO","PORTAGE",35661,1221,45990,82872
"2020","OHIO","PREBLE",4493,294,17022,21809
"2020","OHIO","PUTNAM",3195,314,16412,19921
"2020","OHIO","RICHLAND",17640,863,41472,59975
"2020","OHIO","ROSS",10557,464,22278,33299
"2020","OHIO","SANDUSKY",10596,582,18896,30074
"2020","OHIO","SCIOTO",9080,358,22609,32047
"2020","OHIO","SENECA",8266,458,17086,25810
"2020","OHIO","SHELBY",4465,371,20422,25258
"2020","OHIO","STARK",75904,2878,111097,189879
"2020","OHIO","SUMMIT",151668,3972,124833,280473
"2020","OHIO","TRUMBULL",44519,1288,55194,101001
"2020","OHIO","TUSCARAWAS",12889,668,30458,44015
"2020","OHIO","UNION",11141,635,21669,33445
"2020","OHIO","VAN WERT",3067,248,11650,14965
"2020","OHIO","VINTON",1331,67,4632,6030
"2020","OHIO","WARREN",46069,2043,87988,136100
"2020","OHIO","WASHINGTON",9243,481,22307,32031
"2020","OHIO","WAYNE",16660,864,36759,54283
"2020","OHIO","WILLIAMS",4842,357,13452,18651
"2020","OHIO","WOOD",30617,1223,35757,67597
"2020","OHIO","WYANDOT",2733,195,8462,11390
"2020","OKLAHOMA","ADAIR",1387,136,5585,7108
"2020","OKLAHOMA","ALFALFA",232,52,1978,2262
"2020","OKLAHOMA","ATOKA",765,67,4557,5389
"2020","OKLAHOMA","BEAVER",190,20,1968,2178
"2020","OKLAHOMA","BECKHAM",1048,133,6767,7948
"2020","OKLAHOMA","BLAINE",688,77,3136,3901
"2020","OKLAHOMA","BRYAN",3323,309,12344,15976
"2020","OKLAHOMA","CADDO",2670,176,7013,9859
"2020","OKLAHOMA","CANADIAN",16742,1648,43550,61940
"2020","OKLAHOMA","CARTER",4470,310,14699,19479
"2020","OKLAHOMA","CHEROKEE",6027,464,11223,17714
"2020","OKLAHOMA","CHOCTAW",1082,52,4698,5832
"2020","OKLAHOMA","CIMARRON",70,14,970,1054
"2020","OKLAHOMA","CLEVELAND",49827,3274,66677,119778
"2020","OKLAHOMA","COAL",374,59,2091,2524
"2020","OKLAHOMA","COMANCHE",13747,979,20905,35631
"2020","OKLAHOMA","COTTON",393,62,2117,2572
"2020","OKLAHOMA","CRAIG",1217,129,4686,6032
"2020","OKLAHOMA","CREEK",6577,634,23294,30505
"2020","OKLAHOMA","CUSTER",2369,262,8060,10691
"2020","OKLAHOMA","DELAWARE",3472,216,13557,17245
"2020","OKLAHOMA","DEWEY",214,21,2124,2359
"2020","OKLAHOMA","ELLIS",162,23,1688,1873
"2020","OKLAHOMA","GARFIELD",4919,541,16970,22430
"2020","OKLAHOMA","GARVIN",1865,179,8878,10922
"2020","OKLAHOMA","GRADY",4144,419,18538,23101
"2020","OKLAHOMA","GRANT",280,30,1916,2226
"2020","OKLAHOMA","GREER",328,40,1605,1973
"2020","OKLAHOMA","HARMON",177,9,747,933
"2020","OKLAHOMA","HARPER",136,24,1327,1487
"2020","OKLAHOMA","HASKELL",783,66,4165,5014
"2020","OKLAHOMA","HUGHES",919,63,3875,4857
"2020","OKLAHOMA","JACKSON",1646,183,6392,8221
"2020","OKLAHOMA","JEFFERSON",319,40,2026,2385
"2020","OKLAHOMA","JOHNSTON",738,72,3441,4251
"2020","OKLAHOMA","KAY",4040,375,12834,17249
"2020","OKLAHOMA","KINGFISHER",854,90,5521,6465
"2020","OKLAHOMA","KIOWA",699,55,2673,3427
"2020","OKLAHOMA","LATIMER",762,50,3437,4249
"2020","OKLAHOMA","LE FLORE",3299,293,15213,18805
"2020","OKLAHOMA","LINCOLN",2609,266,12013,14888
"2020","OKLAHOMA","LOGAN",5455,511,15608,21574
"2020","OKLAHOMA","LOVE",711,60,3305,4076
"2020","OKLAHOMA","MAJOR",320,63,3084,3467
"2020","OKLAHOMA","MARSHALL",1100,73,4891,6064
"2020","OKLAHOMA","MAYES",3581,296,12749,16626
"2020","OKLAHOMA","MCCLAIN",3582,359,15295,19236
"2020","OKLAHOMA","MCCURTAIN",1858,124,9485,11467
"2020","OKLAHOMA","MCINTOSH",2031,132,6172,8335
"2020","OKLAHOMA","MURRAY",1156,126,4612,5894
"2020","OKLAHOMA","MUSKOGEE",8027,528,16526,25081
"2020","OKLAHOMA","NOBLE",1003,114,3821,4938
"2020","OKLAHOMA","NOWATA",712,69,3610,4391
"2020","OKLAHOMA","OKFUSKEE",896,84,3058,4038
"2020","OKLAHOMA","OKLAHOMA",141724,7966,145050,294740
"2020","OKLAHOMA","OKMULGEE",4357,288,9668,14313
"2020","OKLAHOMA","OSAGE",6002,415,14121,20538
"2020","OKLAHOMA","OTTAWA",2686,207,8545,11438
"2020","OKLAHOMA","PAWNEE",1363,156,5267,6786
"2020","OKLAHOMA","PAYNE",10904,926,17813,29643
"2020","OKLAHOMA","PITTSBURG",3768,305,13851,17924
"2020","OKLAHOMA","PONTOTOC",4117,398,10805,15320
"2020","OKLAHOMA","POTTAWATOMIE",7275,670,20240,28185
"2020","OKLAHOMA","PUSHMATAHA",668,55,4016,4739
"2020","OKLAHOMA","ROGER MILLS",168,37,1629,1834
"2020","OKLAHOMA","ROGERS",9589,933,34031,44553
"2020","OKLAHOMA","SEMINOLE",2150,176,6011,8337
"2020","OKLAHOMA","SEQUOYAH",3035,238,12113,15386
"2020","OKLAHOMA","STEPHENS",3154,343,15560,19057
"2020","OKLAHOMA","TEXAS",894,122,4505,5521
"2020","OKLAHOMA","TILLMAN",597,35,2076,2708
"2020","OKLAHOMA","TULSA",108996,7108,150574,266678
"2020","OKLAHOMA","WAGONER",8464,709,26165,35338
"2020","OKLAHOMA","WASHINGTON",5790,635,17076,23501
"2020","OKLAHOMA","WASHITA",598,93,4086,4777
"2020","OKLAHOMA","WOODS",591,94,2993,3678
"2020","OKLAHOMA","WOODWARD",1005,169,6611,7785
"2020","OREGON","BAKER",2346,234,7352,9932
"2020","OREGON","BENTON",35827,2094,14878,52799
"2020","OREGON","CLACKAMAS",139043,8127,110509,257679
"2020","OREGON","CLATSOP",12916,776,10218,23910
"2020","OREGON","COLUMBIA",13835,1236,17150,32221
"2020","OREGON","COOS",14243,1003,21829,37075
"2020","OREGON","CROOK",3801,360,11287,15448
"2020","OREGON","CURRY",6058,383,8484,14925
"2020","OREGON","DESCHUTES",65962,3626,55646,125234
"2020","OREGON","DOUGLAS",19160,1891,43298,64349
"2020","OREGON","GILLIAM",324,20,834,1178
"2020","OREGON","GRANT",929,122,3545,4596
"2020","OREGON","HARNEY",894,112,3475,4481
"2020","OREGON","HOOD RIVER",8764,371,3955,13090
"2020","OREGON","JACKSON",59478,3818,63869,127165
"2020","OREGON","JEFFERSON",4393,331,7189,11913
"2020","OREGON","JOSEPHINE",18451,1439,31751,51641
"2020","OREGON","KLAMATH",10388,1030,25308,36726
"2020","OREGON","LAKE",792,101,3470,4363
"2020","OREGON","LANE",134366,7551,80336,222253
"2020","OREGON","LINCOLN",17385,881,12460,30726
"2020","OREGON","LINN",26512,2642,43486,72640
"2020","OREGON","MALHEUR",3260,357,8187,11804
"2020","OREGON","MARION",80872,5660,79002,165534
"2020","OREGON","MORROW",1371,161,3586,5118
"2020","OREGON","MULTNOMAH",367249,13415,82995,463659
"2020","OREGON","POLK",22917,1642,23732,48291
"2020","OREGON","SHERMAN",260,27,921,1208
"2020","OREGON","TILLAMOOK",8066,468,8354,16888
"2020","OREGON","UMATILLA",10707,1061,21270,33038
"2020","OREGON","UNION",4254,392,10298,14944
"2020","OREGON","WALLOWA",1625,120,3404,5149
"2020","OREGON","WASCO",6604,491,7035,14130
"2020","OREGON","WASHINGTON",209940,11313,99073,320326
"2020","OREGON","WHEELER",217,37,711,965
"2020","OREGON","YAMHILL",27174,2198,29551,58923
"2020","PENNSYLVANIA","ADAMS",18207,810,37523,56540
"2020","PENNSYLVANIA","ALLEGHENY",429065,8344,282324,719733
"2020","PENNSYLVANIA","ARMSTRONG",8457,424,27489,36370
"2020","PENNSYLVANIA","BEAVER",38122,1241,54759,94122
"2020","PENNSYLVANIA","BEDFORD",4367,182,23025,27574
"2020","PENNSYLVANIA","BERKS",92895,2909,109736,205540
"2020","PENNSYLVANIA","BLAIR",17636,653,45306,63595
"2020","PENNSYLVANIA","BRADFORD",8046,513,21600,30159
"2020","PENNSYLVANIA","BUCKS",204712,4155,187367,396234
"2020","PENNSYLVANIA","BUTLER",37508,1438,74359,113305
"2020","PENNSYLVANIA","CAMBRIA",21730,759,48085,70574
"2020","PENNSYLVANIA","CAMERON",634,29,1771,2434
"2020","PENNSYLVANIA","CARBON",11212,433,21984,33629
"2020","PENNSYLVANIA","CENTRE",40055,1066,36372,77493
"2020","PENNSYLVANIA","CHESTER",182372,3565,128565,314502
"2020","PENNSYLVANIA","CLARION",4678,237,14578,19493
"2020","PENNSYLVANIA","CLEARFIELD",9673,546,29203,39422
"2020","PENNSYLVANIA","CLINTON",5502,221,11902,17625
"2020","PENNSYLVANIA","COLUMBIA",10532,541,20098,31171
"2020","PENNSYLVANIA","CRAWFORD",12924,521,28559,42004
"2020","PENNSYLVANIA","CUMBERLAND",62245,2138,77212,141595
"2020","PENNSYLVANIA","DAUPHIN",78983,1977,66408,147368
"2020","PENNSYLVANIA","DELAWARE",206423,2976,118532,327931
"2020","PENNSYLVANIA","ELK",4522,244,12140,16906
"2020","PENNSYLVANIA","ERIE",68286,1928,66869,137083
"2020","PENNSYLVANIA","FAYETTE",20444,468,41227,62139
"2020","PENNSYLVANIA","FOREST",728,36,1882,2646
"2020","PENNSYLVANIA","FRANKLIN",22422,1116,57245,80783
"2020","PENNSYLVANIA","FULTON",1085,68,6824,7977
"2020","PENNSYLVANIA","GREENE",4911,179,12579,17669
"2020","PENNSYLVANIA","HUNTINGDON",5445,286,17061,22792
"2020","PENNSYLVANIA","INDIANA",12634,475,28089,41198
"2020","PENNSYLVANIA","JEFFERSON",4527,337,17960,22824
"2020","PENNSYLVANIA","JUNIATA",2253,141,9649,12043
"2020","PENNSYLVANIA","LACKAWANNA",61991,1085,52334,115410
"2020","PENNSYLVANIA","LANCASTER",115847,4183,160209,280239
"2020","PENNSYLVANIA","LAWRENCE",15978,501,29597,46076
"2020","PENNSYLVANIA","LEBANON",23932,989,46731,71652
"2020","PENNSYLVANIA","LEHIGH",98288,2166,84259,184713
"2020","PENNSYLVANIA","LUZERNE",64873,1519,86929,153321
"2020","PENNSYLVANIA","LYCOMING",16971,821,41462,59254
"2020","PENNSYLVANIA","MCKEAN",5098,285,14083,19466
"2020","PENNSYLVANIA","MERCER",21067,744,36143,57954
"2020","PENNSYLVANIA","MIFFLIN",4603,229,16670,21502
"2020","PENNSYLVANIA","MONROE",44060,1043,38726,83829
"2020","PENNSYLVANIA","MONTGOMERY",319511,5186,185460,510157
"2020","PENNSYLVANIA","MONTOUR",3771,156,5844,9771
"2020","PENNSYLVANIA","NORTHAMPTON",85087,2001,83854,170942
"2020","PENNSYLVANIA","NORTHUMBERLAND",12677,654,28952,42283
"2020","PENNSYLVANIA","PERRY",5950,409,18293,24652
"2020","PENNSYLVANIA","PHILADELPHIA",603790,4847,132740,741377
"2020","PENNSYLVANIA","PIKE",13019,322,19213,32554
"2020","PENNSYLVANIA","POTTER",1726,99,7239,9064
"2020","PENNSYLVANIA","SCHUYLKILL",20727,1005,48871,70603
"2020","PENNSYLVANIA","SNYDER",4910,247,13983,19140
"2020","PENNSYLVANIA","SOMERSET",8654,423,31466,40543
"2020","PENNSYLVANIA","SULLIVAN",921,55,2619,3595
"2020","PENNSYLVANIA","SUSQUEHANNA",6236,309,15207,21752
"2020","PENNSYLVANIA","TIOGA",4955,378,15742,21075
"2020","PENNSYLVANIA","UNION",7475,284,12356,20115
"2020","PENNSYLVANIA","VENANGO",7585,374,18569,26528
"2020","PENNSYLVANIA","WARREN",6066,347,14237,20650
"2020","PENNSYLVANIA","WASHINGTON",45088,1310,72080,118478
"2020","PENNSYLVANIA","WAYNE",9191,261,18637,28089
"2020","PENNSYLVANIA","WESTMORELAND",72129,2350,130218,204697
"2020","PENNSYLVANIA","WYOMING",4704,218,9936,14858
"2020","PENNSYLVANIA","YORK",88114,3624,146733,238471
"2020","RHODE ISLAND","BRISTOL",18050,620,9745,28415
"2020","RHODE ISLAND","FEDERAL PRECINCT",1276,13,85,1374
"2020","RHODE ISLAND","KENT",49113,1979,42001,93093
"2020","RHODE ISLAND","NEWPORT",29486,940,15722,46148
"2020","RHODE ISLAND","PROVIDENCE",165012,5104,102551,272667
"2020","RHODE ISLAND","WASHINGTON",44549,1693,29818,76060
"2020","SOUTH CAROLINA","ABBEVILLE",4101,117,8215,12433
"2020","SOUTH CAROLINA","AIKEN",32275,1321,51589,85185
"2020","SOUTH CAROLINA","ALLENDALE",2718,40,835,3593
"2020","SOUTH CAROLINA","ANDERSON",27169,1359,67565,96093
"2020","SOUTH CAROLINA","BAMBERG",4010,55,2417,6482
"2020","SOUTH CAROLINA","BARNWELL",4720,109,5492,10321
"2020","SOUTH CAROLINA","BEAUFORT",43419,1222,53194,97835
"2020","SOUTH CAROLINA","BERKELEY",45223,1838,57397,104458
"2020","SOUTH CAROLINA","CALHOUN",3905,81,4305,8291
"2020","SOUTH CAROLINA","CHARLESTON",121485,4075,93297,218857
"2020","SOUTH CAROLINA","CHEROKEE",6983,244,18043,25270
"2020","SOUTH CAROLINA","CHESTER",6941,156,8660,15757
"2020","SOUTH CAROLINA","CHESTERFIELD",7431,148,11297,18876
"2020","SOUTH CAROLINA","CLARENDON",8250,122,8361,16733
"2020","SOUTH CAROLINA","COLLETON",8602,241,10440,19283
"2020","SOUTH CAROLINA","DARLINGTON",15220,365,16832,32417
"2020","SOUTH CAROLINA","DILLON",6436,83,6582,13101
"2020","SOUTH CAROLINA","DORCHESTER",33824,1541,41913,77278
"2020","SOUTH CAROLINA","EDGEFIELD",4953,167,8184,13304
"2020","SOUTH CAROLINA","FAIRFIELD",7382,129,4625,12136
"2020","SOUTH CAROLINA","FLORENCE",31153,742,32615,64510
"2020","SOUTH CAROLINA","GEORGETOWN",15822,359,20487,36668
"2020","SOUTH CAROLINA","GREENVILLE",103030,5104,150021,258155
"2020","SOUTH CAROLINA","GREENWOOD",12145,430,19431,32006
"2020","SOUTH CAROLINA","HAMPTON",5323,76,3906,9305
"2020","SOUTH CAROLINA","HORRY",59180,1743,118821,179744
"2020","SOUTH CAROLINA","JASPER",7185,131,7078,14394
"2020","SOUTH CAROLINA","KERSHAW",12699,459,20471,33629
"2020","SOUTH CAROLINA","LANCASTER",18937,619,30312,49868
"2020","SOUTH CAROLINA","LAURENS",10159,325,20004,30488
"2020","SOUTH CAROLINA","LEE",5329,94,3008,8431
"2020","SOUTH CAROLINA","LEXINGTON",49301,2450,92817,144568
"2020","SOUTH CAROLINA","MARION",8872,121,5711,14704
"2020","SOUTH CAROLINA","MARLBORO",6290,112,5044,11446
"2020","SOUTH CAROLINA","MCCORMICK",2687,52,2958,5697
"2020","SOUTH CAROLINA","NEWBERRY",6958,230,11443,18631
"2020","SOUTH CAROLINA","OCONEE",10414,556,29698,40668
"2020","SOUTH CAROLINA","ORANGEBURG",27295,307,13603,41205
"2020","SOUTH CAROLINA","PICKENS",13645,994,42907,57546
"2020","SOUTH CAROLINA","RICHLAND",132570,2939,58313,193822
"2020","SOUTH CAROLINA","SALUDA",2963,101,6210,9274
"2020","SOUTH CAROLINA","SPARTANBURG",52926,2169,93560,148655
"2020","SOUTH CAROLINA","SUMTER",27379,541,21000,48920
"2020","SOUTH CAROLINA","UNION",4935,139,8183,13257
"2020","SOUTH CAROLINA","WILLIAMSBURG",10289,164,5532,15985
"2020","SOUTH CAROLINA","YORK",59008,2315,82727,144050
"2020","SOUTH DAKOTA","AURORA",317,36,1052,1405
"2020","SOUTH DAKOTA","BEADLE",2107,166,4808,7081
"2020","SOUTH DAKOTA","BENNETT",466,23,694,1183
"2020","SOUTH DAKOTA","BON HOMME",721,45,2235,3001
"2020","SOUTH DAKOTA","BROOKINGS",6110,457,8000,14567
"2020","SOUTH DAKOTA","BROWN",6538,429,10580,17547
"2020","SOUTH DAKOTA","BRULE",673,67,1750,2490
"2020","SOUTH DAKOTA","BUFFALO",352,14,183,549
"2020","SOUTH DAKOTA","BUTTE",939,132,3731,4802
"2020","SOUTH DAKOTA","CAMPBELL",117,9,747,873
"2020","SOUTH DAKOTA","CHARLES MIX",1177,54,2552,3783
"2020","SOUTH DAKOTA","CLARK",437,40,1373,1850
"2020","SOUTH DAKOTA","CLAY",3083,159,2456,5698
"2020","SOUTH DAKOTA","CODINGTON",3837,366,8958,13161
"2020","SOUTH DAKOTA","CORSON",622,14,647,1283
"2020","SOUTH DAKOTA","CUSTER",1522,120,3852,5494
"2020","SOUTH DAKOTA","DAVISON",2648,193,5613,8454
"2020","SOUTH DAKOTA","DAY",1052,43,1869,2964
"2020","SOUTH DAKOTA","DEUEL",609,42,1699,2350
"2020","SOUTH DAKOTA","DEWEY",1131,45,790,1966
"2020","SOUTH DAKOTA","DOUGLAS",216,23,1468,1707
"2020","SOUTH DAKOTA","EDMUNDS",417,30,1538,1985
"2020","SOUTH DAKOTA","FALL RIVER",1053,111,2878,4042
"2020","SOUTH DAKOTA","FAULK",198,20,964,1182
"2020","SOUTH DAKOTA","GRANT",1056,71,2618,3745
"2020","SOUTH DAKOTA","GREGORY",455,32,1771,2258
"2020","SOUTH DAKOTA","HAAKON",105,6,1026,1137
"2020","SOUTH DAKOTA","HAMLIN",647,64,2372,3083
"2020","SOUTH DAKOTA","HAND",373,30,1433,1836
"2020","SOUTH DAKOTA","HANSON",557,38,1793,2388
"2020","SOUTH DAKOTA","HARDING",49,16,748,813
"2020","SOUTH DAKOTA","HUGHES",2953,248,5522,8723
"2020","SOUTH DAKOTA","HUTCHINSON",762,61,2944,3767
"2020","SOUTH DAKOTA","HYDE",136,10,564,710
"2020","SOUTH DAKOTA","JACKSON",359,18,738,1115
"2020","SOUTH DAKOTA","JERAULD",270,15,721,1006
"2020","SOUTH DAKOTA","JONES",90,11,498,599
"2020","SOUTH DAKOTA","KINGSBURY",819,56,1904,2779
"2020","SOUTH DAKOTA","LAKE",2068,124,3681,5873
"2020","SOUTH DAKOTA","LAWRENCE",4537,538,8753,13828
"2020","SOUTH DAKOTA","LINCOLN",11981,798,19617,32396
"2020","SOUTH DAKOTA","LYMAN",525,30,1042,1597
"2020","SOUTH DAKOTA","MARSHALL",858,33,1287,2178
"2020","SOUTH DAKOTA","MCCOOK",769,63,2068,2900
"2020","SOUTH DAKOTA","MCPHERSON",222,27,1075,1324
"2020","SOUTH DAKOTA","MEADE",3285,510,9875,13670
"2020","SOUTH DAKOTA","MELLETTE",298,22,449,769
"2020","SOUTH DAKOTA","MINER",320,31,787,1138
"2020","SOUTH DAKOTA","MINNEHAHA",40482,2595,49249,92326
"2020","SOUTH DAKOTA","MOODY",1179,76,1951,3206
"2020","SOUTH DAKOTA","OGLALA LAKOTA",2829,74,297,3200
"2020","SOUTH DAKOTA","PENNINGTON",20606,1849,35063,57518
"2020","SOUTH DAKOTA","PERKINS",239,29,1401,1669
"2020","SOUTH DAKOTA","POTTER",227,14,1139,1380
"2020","SOUTH DAKOTA","ROBERTS",1828,75,2404,4307
"2020","SOUTH DAKOTA","SANBORN",257,23,905,1185
"2020","SOUTH DAKOTA","SPINK",998,61,2104,3163
"2020","SOUTH DAKOTA","STANLEY",421,28,1203,1652
"2020","SOUTH DAKOTA","SULLY",185,19,726,930
"2020","SOUTH DAKOTA","TODD",1963,44,532,2539
"2020","SOUTH DAKOTA","TRIPP",495,40,2161,2696
"2020","SOUTH DAKOTA","TURNER",1139,119,3290,4548
"2020","SOUTH DAKOTA","UNION",2725,186,5944,8855
"2020","SOUTH DAKOTA","WALWORTH",565,49,1966,2580
"2020","SOUTH DAKOTA","YANKTON",4016,303,6581,10900
"2020","SOUTH DAKOTA","ZIEBACH",481,21,404,906
"2020","TENNESSEE","ANDERSON",11741,645,23184,35570
"2020","TENNESSEE","BEDFORD",4453,281,14354,19088
"2020","TENNESSEE","BENTON",1529,63,5668,7260
"2020","TENNESSEE","BLEDSOE",971,62,4725,5758
"2020","TENNESSEE","BLOUNT",17932,1308,47369,66609
"2020","TENNESSEE","BRADLEY",9851,810,35204,45865
"2020","TENNESSEE","CAMPBELL",2441,161,12331,14933
"2020","TENNESSEE","CANNON",1261,106,5190,6557
"2020","TENNESSEE","CARROLL",2559,141,9205,11905
"2020","TENNESSEE","CARTER",4529,379,19584,24492
"2020","TENNESSEE","CHEATHAM",5514,308,14438,20260
"2020","TENNESSEE","CHESTER",1412,220,5952,7584
"2020","TENNESSEE","CLAIBORNE",2202,139,10604,12945
"2020","TENNESSEE","CLAY",735,38,2733,3506
"2020","TENNESSEE","COCKE",2533,164,12162,14859
"2020","TENNESSEE","COFFEE",5705,694,17883,24282
"2020","TENNESSEE","CROCKETT",1382,59,4673,6114
"2020","TENNESSEE","CUMBERLAND",6728,383,25168,32279
"2020","TENNESSEE","DAVIDSON",199703,9737,100218,309658
"2020","TENNESSEE","DECATUR",904,108,4229,5241
"2020","TENNESSEE","DEKALB",1750,91,6672,8513
"2020","TENNESSEE","DICKSON",6106,574,17643,24323
"2020","TENNESSEE","DYER",3158,153,11768,15079
"2020","TENNESSEE","FAYETTE",7027,267,15690,22984
"2020","TENNESSEE","FENTRESS",1214,74,7441,8729
"2020","TENNESSEE","FRANKLIN",4864,281,13987,19132
"2020","TENNESSEE","GIBSON",5771,305,16259,22335
"2020","TENNESSEE","GILES",3298,121,9784,13203
"2020","TENNESSEE","GRAINGER",1467,102,8565,10134
"2020","TENNESSEE","GREENE",5199,629,22259,28087
"2020","TENNESSEE","GRUNDY",988,65,4802,5855
"2020","TENNESSEE","HAMBLEN",5500,320,18811,24631
"2020","TENNESSEE","HAMILTON",75522,3483,92108,171113
"2020","TENNESSEE","HANCOCK",362,10,2372,2744
"2020","TENNESSEE","HARDEMAN",4180,123,5760,10063
"2020","TENNESSEE","HARDIN",1775,204,9559,11538
"2020","TENNESSEE","HAWKINS",4083,336,20405,24824
"2020","TENNESSEE","HAYWOOD",4012,84,3343,7439
"2020","TENNESSEE","HENDERSON",2092,131,9797,12020
"2020","TENNESSEE","HENRY",3548,260,11239,15047
"2020","TENNESSEE","HICKMAN",2130,125,7577,9832
"2020","TENNESSEE","HOUSTON",871,97,2718,3686
"2020","TENNESSEE","HUMPHREYS",2017,99,6120,8236
"2020","TENNESSEE","JACKSON",1135,70,4118,5323
"2020","TENNESSEE","JEFFERSON",4654,311,18651,23616
"2020","TENNESSEE","JOHNSON",1246,87,6468,7801
"2020","TENNESSEE","KNOX",91422,4594,124540,220556
"2020","TENNESSEE","LAKE",526,16,1492,2034
"2020","TENNESSEE","LAUDERDALE",3193,98,5674,8965
"2020","TENNESSEE","LAWRENCE",3195,189,15334,18718
"2020","TENNESSEE","LEWIS",1072,63,4474,5609
"2020","TENNESSEE","LINCOLN",2919,408,12281,15608
"2020","TENNESSEE","LOUDON",6948,686,21713,29347
"2020","TENNESSEE","MACON",1307,84,8096,9487
"2020","TENNESSEE","MADISON",18390,617,23943,42950
"2020","TENNESSEE","MARION",3177,168,9911,13256
"2020","TENNESSEE","MARSHALL",3605,230,11043,14878
"2020","TENNESSEE","MAURY",14418,775,31464,46657
"2020","TENNESSEE","MCMINN",4361,285,18198,22844
"2020","TENNESSEE","MCNAIRY",1943,239,9093,11275
"2020","TENNESSEE","MEIGS",1008,57,4467,5532
"2020","TENNESSEE","MONROE",3764,250,16783,20797
"2020","TENNESSEE","MONTGOMERY",32472,2099,42187,76758
"2020","TENNESSEE","MOORE",573,78,2888,3539
"2020","TENNESSEE","MORGAN",1167,131,6930,8228
"2020","TENNESSEE","OBION",2589,142,10790,13521
"2020","TENNESSEE","OVERTON",2033,86,7918,10037
"2020","TENNESSEE","PERRY",615,38,2775,3428
"2020","TENNESSEE","PICKETT",525,25,2381,2931
"2020","TENNESSEE","POLK",1492,76,6792,8360
"2020","TENNESSEE","PUTNAM",9185,649,23759,33593
"2020","TENNESSEE","RHEA",2369,218,11050,13637
"2020","TENNESSEE","ROANE",6043,644,19230,25917
"2020","TENNESSEE","ROBERTSON",8692,489,24536,33717
"2020","TENNESSEE","RUTHERFORD",59341,3057,81480,143878
"2020","TENNESSEE","SCOTT",986,62,8004,9052
"2020","TENNESSEE","SEQUATCHIE",1298,99,5855,7252
"2020","TENNESSEE","SEVIER",8721,1031,33783,43535
"2020","TENNESSEE","SHELBY",246105,6135,129815,382055
"2020","TENNESSEE","SMITH",1802,113,7136,9051
"2020","TENNESSEE","STEWART",1232,114,4950,6296
"2020","TENNESSEE","SULLIVAN",17272,1225,55860,74357
"2020","TENNESSEE","SUMNER",27680,1496,63454,92630
"2020","TENNESSEE","TIPTON",6837,401,20070,27308
"2020","TENNESSEE","TROUSDALE",1012,50,2936,3998
"2020","TENNESSEE","UNICOI",1615,93,6599,8307
"2020","TENNESSEE","UNION",1249,71,6803,8123
"2020","TENNESSEE","VAN BUREN",544,35,2342,2921
"2020","TENNESSEE","WARREN",3924,235,11850,16009
"2020","TENNESSEE","WASHINGTON",18638,1121,40444,60203
"2020","TENNESSEE","WAYNE",820,54,5795,6669
"2020","TENNESSEE","WEAKLEY",3020,319,10396,13735
"2020","TENNESSEE","WHITE",2143,146,9606,11895
"2020","TENNESSEE","WILLIAMSON",50161,2386,86469,139016
"2020","TENNESSEE","WILSON",22254,1780,50296,74330
"2020","TEXAS","ANDERSON",3955,162,15110,19227
"2020","TEXAS","ANDREWS",850,70,4943,5863
"2020","TEXAS","ANGELINA",9143,355,25076,34574
"2020","TEXAS","ARANSAS",2916,135,9239,12290
"2020","TEXAS","ARCHER",446,50,4300,4796
"2020","TEXAS","ARMSTRONG",75,2,1035,1112
"2020","TEXAS","ATASCOSA",5876,203,12039,18118
"2020","TEXAS","AUSTIN",2951,156,11447,14554
"2020","TEXAS","BAILEY",409,17,1434,1860
"2020","TEXAS","BANDERA",2505,153,10057,12715
"2020","TEXAS","BASTROP",15474,675,20516,36665
"2020","TEXAS","BAYLOR",183,25,1494,1702
"2020","TEXAS","BEE",3288,126,6006,9420
"2020","TEXAS","BELL",57014,2468,67893,127375
"2020","TEXAS","BEXAR",448452,13748,308618,770818
"2020","TEXAS","BLANCO",1911,87,5443,7441
"2020","TEXAS","BORDEN",16,3,397,416
"2020","TEXAS","BOSQUE",1561,96,7469,9126
"2020","TEXAS","BOWIE",10747,398,27116,38261
"2020","TEXAS","BRAZORIA",62228,2323,90433,154984
"2020","TEXAS","BRAZOS",35349,2182,47530,85061
"2020","TEXAS","BREWSTER",2258,103,2461,4822
"2020","TEXAS","BRISCOE",78,8,639,725
"2020","TEXAS","BROOKS",1470,16,998,2484
"2020","TEXAS","BROWN",2107,164,13698,15969
"2020","TEXAS","BURLESON",1788,78,6743,8609
"2020","TEXAS","BURNET",5639,311,18767,24717
"2020","TEXAS","CALDWELL",6672,270,8031,14973
"2020","TEXAS","CALHOUN",2148,67,5641,7856
"2020","TEXAS","CALLAHAN",734,86,6012,6832
"2020","TEXAS","CAMERON",64063,1079,49032,114174
"2020","TEXAS","CAMP",1394,40,3626,5060
"2020","TEXAS","CARSON",297,46,2779,3122
"2020","TEXAS","CASS",2795,99,11033,13927
"2020","TEXAS","CASTRO",466,15,1602,2083
"2020","TEXAS","CHAMBERS",3997,302,17353,21652
"2020","TEXAS","CHEROKEE",4210,197,15101,19508
"2020","TEXAS","CHILDRESS",310,26,1943,2279
"2020","TEXAS","CLAY",614,61,5069,5744
"2020","TEXAS","COCHRAN",177,14,809,1000
"2020","TEXAS","COKE",178,15,1586,1779
"2020","TEXAS","COLEMAN",451,32,3641,4124
"2020","TEXAS","COLLIN",230945,7593,252318,490856
"2020","TEXAS","COLLINGSWORTH",155,15,1048,1218
"2020","TEXAS","COLORADO",2420,83,7472,9975
"2020","TEXAS","COMAL",24826,1326,62740,88892
"2020","TEXAS","COMANCHE",853,56,5177,6086
"2020","TEXAS","CONCHO",197,13,1058,1268
"2020","TEXAS","COOKE",3210,190,15596,18996
"2020","TEXAS","CORYELL",7565,490,15438,23493
"2020","TEXAS","COTTLE",113,9,540,662
"2020","TEXAS","CRANE",241,15,1247,1503
"2020","TEXAS","CROCKETT",344,10,1220,1574
"2020","TEXAS","CROSBY",527,30,1396,1953
"2020","TEXAS","CULBERSON",438,11,415,864
"2020","TEXAS","DALLAM",197,23,1389,1609
"2020","TEXAS","DALLAS",598576,13852,307076,919504
"2020","TEXAS","DAWSON",808,30,2951,3789
"2020","TEXAS","DEAF SMITH",1264,52,3294,4610
"2020","TEXAS","DELTA",403,27,2162,2592
"2020","TEXAS","DENTON",188695,6789,222480,417964
"2020","TEXAS","DEWITT",1494,57,6567,8118
"2020","TEXAS","DICKENS",130,5,853,988
"2020","TEXAS","DIMMIT",2264,18,1384,3666
"2020","TEXAS","DONLEY",198,12,1438,1648
"2020","TEXAS","DUVAL",2575,35,2443,5053
"2020","TEXAS","EASTLAND",983,73,7237,8293
"2020","TEXAS","ECTOR",11367,527,32697,44591
"2020","TEXAS","EDWARDS",168,5,893,1066
"2020","TEXAS","EL PASO",178126,4272,84331,266729
"2020","TEXAS","ELLIS",27565,1211,56717,85493
"2020","TEXAS","ERATH",2916,256,13684,16856
"2020","TEXAS","FALLS",1899,57,4177,6133
"2020","TEXAS","FANNIN",2655,181,12171,15007
"2020","TEXAS","FAYETTE",2661,109,10171,12941
"2020","TEXAS","FISHER",352,26,1448,1826
"2020","TEXAS","FLOYD",438,17,1584,2039
"2020","TEXAS","FOARD",99,7,445,551
"2020","TEXAS","FORT BEND",195552,4244,157718,357514
"2020","TEXAS","FRANKLIN",804,44,4161,5009
"2020","TEXAS","FREESTONE",1635,85,6991,8711
"2020","TEXAS","FRIO",2422,34,2823,5279
"2020","TEXAS","GAINES",576,65,5355,5996
"2020","TEXAS","GALVESTON",58842,2307,93911,155060
"2020","TEXAS","GARZA",231,9,1413,1653
"2020","TEXAS","GILLESPIE",3176,160,12514,15850
"2020","TEXAS","GLASSCOCK",39,3,611,653
"2020","TEXAS","GOLIAD",877,33,3085,3995
"2020","TEXAS","GONZALES",1948,73,5627,7648
"2020","TEXAS","GRAY",829,113,6840,7782
"2020","TEXAS","GRAYSON",14506,805,44163,59474
"2020","TEXAS","GREGG",14796,693,32493,47982
"2020","TEXAS","GRIMES",2833,149,9432,12414
"2020","TEXAS","GUADALUPE",28805,1261,47553,77619
"2020","TEXAS","HALE",2279,130,7177,9586
"2020","TEXAS","HALL",168,6,995,1169
"2020","TEXAS","HAMILTON",641,94,3616,4351
"2020","TEXAS","HANSFORD",166,32,1849,2047
"2020","TEXAS","HARDEMAN",241,9,1330,1580
"2020","TEXAS","HARDIN",3474,303,23858,27635
"2020","TEXAS","HARRIS",918193,21995,700630,1640818
"2020","TEXAS","HARRISON",7908,343,21466,29717
"2020","TEXAS","HARTLEY",195,15,1868,2078
"2020","TEXAS","HASKELL",353,21,1840,2214
"2020","TEXAS","HAYS",59524,2191,47680,109395
"2020","TEXAS","HEMPHILL",206,28,1486,1720
"2020","TEXAS","HENDERSON",7060,346,28911,36317
"2020","TEXAS","HIDALGO",128199,2158,90527,220884
"2020","TEXAS","HILL",2860,145,11926,14931
"2020","TEXAS","HOCKLEY",1482,82,6536,8100
"2020","TEXAS","HOOD",5648,397,26496,32541
"2020","TEXAS","HOPKINS",3046,176,12719,15941
"2020","TEXAS","HOUSTON",2314,64,7060,9438
"2020","TEXAS","HOWARD",2069,118,8054,10241
"2020","TEXAS","HUDSPETH",371,15,779,1165
"2020","TEXAS","HUNT",8906,528,29163,38597
"2020","TEXAS","HUTCHINSON",965,127,7681,8773
"2020","TEXAS","IRION",120,10,759,889
"2020","TEXAS","JACK",331,33,3418,3782
"2020","TEXAS","JACKSON",1033,89,5231,6353
"2020","TEXAS","JASPER",2954,115,12542,15611
"2020","TEXAS","JEFF DAVIS",501,20,784,1305
"2020","TEXAS","JEFFERSON",46073,1116,47570,94759
"2020","TEXAS","JIM HOGG",1197,6,833,2036
"2020","TEXAS","JIM WELLS",6119,97,7453,13669
"2020","TEXAS","JOHNSON",16464,928,54628,72020
"2020","TEXAS","JONES",999,82,5660,6741
"2020","TEXAS","KARNES",1234,50,3968,5252
"2020","TEXAS","KAUFMAN",18405,689,37624,56718
"2020","TEXAS","KENDALL",6020,349,20083,26452
"2020","TEXAS","KENEDY",65,2,127,194
"2020","TEXAS","KENT",47,4,411,462
"2020","TEXAS","KERR",6524,342,20879,27745
"2020","TEXAS","KIMBLE",284,21,1987,2292
"2020","TEXAS","KING",8,0,151,159
"2020","TEXAS","KINNEY",446,13,1144,1603
"2020","TEXAS","KLEBERG",5314,126,5504,10944
"2020","TEXAS","KNOX",265,11,1180,1456
"2020","TEXAS","LA SALLE",1052,19,1335,2406
"2020","TEXAS","LAMAR",4458,224,16760,21442
"2020","TEXAS","LAMB",840,49,3521,4410
"2020","TEXAS","LAMPASAS",2144,169,8086,10399
"2020","TEXAS","LAVACA",1333,60,8804,10197
"2020","TEXAS","LEE",1750,82,6255,8087
"2020","TEXAS","LEON",1072,79,7523,8674
"2020","TEXAS","LIBERTY",5785,247,23302,29334
"2020","TEXAS","LIMESTONE",2213,93,6789,9095
"2020","TEXAS","LIPSCOMB",131,17,1205,1353
"2020","TEXAS","LIVE OAK",819,36,4199,5054
"2020","TEXAS","LLANO",2465,116,10079,12660
"2020","TEXAS","LOVING",4,2,60,66
"2020","TEXAS","LUBBOCK",40017,1939,78861,120817
"2020","TEXAS","LYNN",428,12,1853,2293
"2020","TEXAS","MADISON",1088,41,4169,5298
"2020","TEXAS","MARION",1339,55,3470,4864
"2020","TEXAS","MARTIN",288,15,1857,2160
"2020","TEXAS","MASON",457,26,1991,2474
"2020","TEXAS","MATAGORDA",3733,149,9845,13727
"2020","TEXAS","MAVERICK",8332,133,6881,15346
"2020","TEXAS","MCCULLOCH",490,42,2904,3436
"2020","TEXAS","MCLENNAN",36688,1641,59543,97872
"2020","TEXAS","MCMULLEN",53,3,460,516
"2020","TEXAS","MEDINA",6773,242,15642,22657
"2020","TEXAS","MENARD",197,8,823,1028
"2020","TEXAS","MIDLAND",12329,906,45624,58859
"2020","TEXAS","MILAM",2496,98,7984,10578
"2020","TEXAS","MILLS",271,17,2217,2505
"2020","TEXAS","MITCHELL",397,12,2170,2579
"2020","TEXAS","MONTAGUE",1097,107,8615,9819
"2020","TEXAS","MONTGOMERY",74377,3784,193382,271543
"2020","TEXAS","MOORE",1062,87,4359,5508
"2020","TEXAS","MORRIS",1669,46,3872,5587
"2020","TEXAS","MOTLEY",46,2,604,652
"2020","TEXAS","NACOGDOCHES",9000,407,17378,26785
"2020","TEXAS","NAVARRO",5101,222,13800,19123
"2020","TEXAS","NEWTON",1173,39,4882,6094
"2020","TEXAS","NOLAN",1162,64,4131,5357
"2020","TEXAS","NUECES",60925,1780,64617,127322
"2020","TEXAS","OCHILTREE",302,42,2812,3156
"2020","TEXAS","OLDHAM",81,11,917,1009
"2020","TEXAS","ORANGE",6357,451,29186,35994
"2020","TEXAS","PALO PINTO",2178,132,10179,12489
"2020","TEXAS","PANOLA",2057,68,9326,11451
"2020","TEXAS","PARKER",13017,1066,62045,76128
"2020","TEXAS","PARMER",488,27,2135,2650
"2020","TEXAS","PECOS",1382,71,3215,4668
"2020","TEXAS","POLK",5387,226,18573,24186
"2020","TEXAS","POTTER",9921,596,22820,33337
"2020","TEXAS","PRESIDIO",1463,33,721,2217
"2020","TEXAS","RAINS",842,56,5155,6053
"2020","TEXAS","RANDALL",12802,1076,50796,64674
"2020","TEXAS","REAGAN",172,10,942,1124
"2020","TEXAS","REAL",320,19,1643,1982
"2020","TEXAS","RED RIVER",1246,43,4517,5806
"2020","TEXAS","REEVES",1395,40,2254,3689
"2020","TEXAS","REFUGIO",1108,48,2210,3366
"2020","TEXAS","ROBERTS",17,4,529,550
"2020","TEXAS","ROBERTSON",2374,79,5646,8099
"2020","TEXAS","ROCKWALL",16412,753,36726,53891
"2020","TEXAS","RUNNELS",552,50,3807,4409
"2020","TEXAS","RUSK",4629,214,16534,21377
"2020","TEXAS","SABINE",669,38,4784,5491
"2020","TEXAS","SAN AUGUSTINE",980,15,3007,4002
"2020","TEXAS","SAN JACINTO",2337,142,10161,12640
"2020","TEXAS","SAN PATRICIO",8988,387,16516,25891
"2020","TEXAS","SAN SABA",287,7,2308,2602
"2020","TEXAS","SCHLEICHER",211,8,940,1159
"2020","TEXAS","SCURRY",818,69,4983,5870
"2020","TEXAS","SHACKELFORD",130,14,1484,1628
"2020","TEXAS","SHELBY",2068,44,7975,10087
"2020","TEXAS","SHERMAN",91,15,886,992
"2020","TEXAS","SMITH",29615,1394,69080,100089
"2020","TEXAS","SOMERVELL",768,74,4105,4947
"2020","TEXAS","STARR",9123,155,8247,17525
"2020","TEXAS","STEPHENS",397,18,3385,3800
"2020","TEXAS","STERLING",51,4,584,639
"2020","TEXAS","STONEWALL",116,5,615,736
"2020","TEXAS","SUTTON",322,13,1222,1557
"2020","TEXAS","SWISHER",478,32,1845,2355
"2020","TEXAS","TARRANT",411567,13389,409741,834697
"2020","TEXAS","TAYLOR",14588,1000,39547,55135
"2020","TEXAS","TERRELL",119,5,334,458
"2020","TEXAS","TERRY",757,43,2812,3612
"2020","TEXAS","THROCKMORTON",82,6,806,894
"2020","TEXAS","TITUS",2856,115,7570,10541
"2020","TEXAS","TOM GREEN",12239,658,32313,45210
"2020","TEXAS","TRAVIS",435860,11378,161337,608575
"2020","TEXAS","TRINITY",1323,36,5579,6938
"2020","TEXAS","TYLER",1403,63,8194,9660
"2020","TEXAS","UPSHUR",2877,206,15809,18892
"2020","TEXAS","UPTON",170,20,1178,1368
"2020","TEXAS","UVALDE",4073,97,6174,10344
"2020","TEXAS","VAL VERDE",6771,225,8284,15280
"2020","TEXAS","VAN ZANDT",3516,243,22270,26029
"2020","TEXAS","VICTORIA",10380,450,23358,34188
"2020","TEXAS","WALKER",7884,353,15375,23612
"2020","TEXAS","WALLER",8191,283,14260,22734
"2020","TEXAS","WARD",764,55,3241,4060
"2020","TEXAS","WASHINGTON",4261,207,12959,17427
"2020","TEXAS","WEBB",41820,679,25898,68397
"2020","TEXAS","WHARTON",4694,141,11926,16761
"2020","TEXAS","WHEELER",168,10,2159,2337
"2020","TEXAS","WICHITA",13161,810,32069,46040
"2020","TEXAS","WILBARGER",956,44,3524,4524
"2020","TEXAS","WILLACY",3108,0,2441,5549
"2020","TEXAS","WILLIAMSON",143795,6031,139729,289555
"2020","TEXAS","WILSON",6350,200,18463,25013
"2020","TEXAS","WINKLER",358,15,1753,2126
"2020","TEXAS","WISE",4973,360,27032,32365
"2020","TEXAS","WOOD",3509,221,19049,22779
"2020","TEXAS","YOAKUM",420,37,2174,2631
"2020","TEXAS","YOUNG",1034,95,7110,8239
"2020","TEXAS","ZAPATA",1826,15,2033,3874
"2020","TEXAS","ZAVALA",2864,25,1490,4379
"2020","UTAH","BEAVER",357,48,2695,3100
"2020","UTAH","BOX ELDER",4473,1002,21548,27023
"2020","UTAH","CACHE",16650,3676,38032,58358
"2020","UTAH","CARBON",2392,284,6693,9369
"2020","UTAH","DAGGETT",111,12,496,619
"2020","UTAH","DAVIS",57411,8268,104135,169814
"2020","UTAH","DUCHESNE",843,206,7512,8561
"2020","UTAH","EMERY",572,119,4207,4898
"2020","UTAH","GARFIELD",514,60,2158,2732
"2020","UTAH","GRAND",2806,131,2248,5185
"2020","UTAH","IRON",4892,1223,18989,25104
"2020","UTAH","JUAB",645,133,5087,5865
"2020","UTAH","KANE",1083,99,2998,4180
"2020","UTAH","MILLARD",624,162,5404,6190
"2020","UTAH","MORGAN",1086,339,5181,6606
"2020","UTAH","PIUTE",86,12,773,871
"2020","UTAH","RICH",180,32,1157,1369
"2020","UTAH","SALT LAKE",289906,26501,230174,546581
"2020","UTAH","SAN JUAN",3113,229,3535,6877
"2020","UTAH","SANPETE",1794,372,10459,12625
"2020","UTAH","SEVIER",1084,226,9052,10362
"2020","UTAH","SUMMIT",15244,590,10252,26086
"2020","UTAH","TOOELE",8943,1549,21014,31506
"2020","UTAH","UINTAH",1663,379,13261,15303
"2020","UTAH","UTAH",76033,15441,192812,284286
"2020","UTAH","WASATCH",6187,808,10795,17790
"2020","UTAH","WASHINGTON",20530,3246,67294,91070
"2020","UTAH","WAYNE",365,27,1229,1621
"2020","UTAH","WEBER",40695,4759,65949,111403
"2020","VERMONT","ADDISON",15089,955,6567,22611
"2020","VERMONT","BENNINGTON",11858,775,6724,19357
"2020","VERMONT","CALEDONIA",8529,705,5924,15158
"2020","VERMONT","CHITTENDEN",72938,3713,20104,96755
"2020","VERMONT","ESSEX",1890,183,2164,4237
"2020","VERMONT","FRANKLIN",13612,1186,11274,26072
"2020","VERMONT","GRAND ISLE",3346,242,2194,5782
"2020","VERMONT","LAMOILLE",10773,735,4171,15679
"2020","VERMONT","ORANGE",8351,743,5782,14876
"2020","VERMONT","ORLEANS",7757,599,7086,15442
"2020","VERMONT","RUTLAND",18746,1401,14625,34772
"2020","VERMONT","WASHINGTON",25101,1517,8707,35325
"2020","VERMONT","WINDHAM",20057,1144,7251,28452
"2020","VERMONT","WINDSOR",24779,1394,10135,36308
"2020","VIRGINIA","ACCOMACK",7578,212,9172,16962
"2020","VIRGINIA","ALBEMARLE",42466,1387,20804,64657
"2020","VIRGINIA","ALEXANDRIA CITY",66240,1737,14544,82521
"2020","VIRGINIA","ALLEGHANY",2243,101,5859,8203
"2020","VIRGINIA","AMELIA",2411,93,5390,7894
"2020","VIRGINIA","AMHERST",5672,292,11041,17005
"2020","VIRGINIA","APPOMATTOX",2418,148,6702,9268
"2020","VIRGINIA","ARLINGTON",105344,3077,22318,130739
"2020","VIRGINIA","AUGUSTA",10840,724,30714,42278
"2020","VIRGINIA","BATH",646,21,1834,2501
"2020","VIRGINIA","BEDFORD",12176,893,35600,48669
"2020","VIRGINIA","BLAND",532,44,2903,3479
"2020","VIRGINIA","BOTETOURT",5700,324,15099,21123
"2020","VIRGINIA","BRISTOL CITY",2313,154,5347,7814
"2020","VIRGINIA","BRUNSWICK",4552,39,3357,7948
"2020","VIRGINIA","BUCHANAN",1587,59,8311,9957
"2020","VIRGINIA","BUCKINGHAM",3471,114,4544,8129
"2020","VIRGINIA","BUENA VISTA CITY",825,88,1863,2776
"2020","VIRGINIA","CAMPBELL",8070,586,21245,29901
"2020","VIRGINIA","CAROLINE",7657,295,8336,16288
"2020","VIRGINIA","CARROLL",2842,156,12659,15657
"2020","VIRGINIA","CHARLES CITY",2624,56,1761,4441
"2020","VIRGINIA","CHARLOTTE",2317,59,3815,6191
"2020","VIRGINIA","CHARLOTTESVILLE CITY",20696,423,3094,24213
"2020","VIRGINIA","CHESAPEAKE CITY",66377,2689,58180,127246
"2020","VIRGINIA","CHESTERFIELD",106935,3694,93326,203955
"2020","VIRGINIA","CLARKE",3920,225,5192,9337
"2020","VIRGINIA","COLONIAL HEIGHTS CITY",2972,181,6007,9160
"2020","VIRGINIA","COVINGTON CITY",964,59,1580,2603
"2020","VIRGINIA","CRAIG",587,47,2536,3170
"2020","VIRGINIA","CULPEPER",10617,487,16012,27116
"2020","VIRGINIA","CUMBERLAND",2227,67,3019,5313
"2020","VIRGINIA","DANVILLE CITY",11710,318,7428,19456
"2020","VIRGINIA","DICKENSON",1503,56,5748,7307
"2020","VIRGINIA","DINWIDDIE",6224,173,8695,15092
"2020","VIRGINIA","EMPORIA CITY",1612,18,754,2384
"2020","VIRGINIA","ESSEX",3038,65,3075,6178
"2020","VIRGINIA","FAIRFAX",419943,12899,168401,601243
"2020","VIRGINIA","FAIRFAX CITY",9174,306,4007,13487
"2020","VIRGINIA","FALLS CHURCH CITY",7146,183,1490,8819
"2020","VIRGINIA","FAUQUIER",17565,1000,25106,43671
"2020","VIRGINIA","FLOYD",3004,183,6225,9412
"2020","VIRGINIA","FLUVANNA",7414,277,8155,15846
"2020","VIRGINIA","FRANKLIN",8381,428,20895,29704
"2020","VIRGINIA","FRANKLIN CITY",2525,52,1487,4064
"2020","VIRGINIA","FREDERICK",17207,953,30558,48718
"2020","VIRGINIA","FREDERICKSBURG CITY",8517,323,4037,12877
"2020","VIRGINIA","GALAX CITY",777,24,1838,2639
"2020","VIRGINIA","GILES",2156,146,6876,9178
"2020","VIRGINIA","GLOUCESTER",6964,445,14875,22284
"2020","VIRGINIA","GOOCHLAND",6685,301,9966,16952
"2020","VIRGINIA","GRAYSON",1535,67,6529,8131
"2020","VIRGINIA","GREENE",4163,284,6866,11313
"2020","VIRGINIA","GREENSVILLE",2627,33,1914,4574
"2020","VIRGINIA","HALIFAX",7666,164,10418,18248
"2020","VIRGINIA","HAMPTON CITY",46220,1307,18430,65957
"2020","VIRGINIA","HANOVER",25307,1363,44318,70988
"2020","VIRGINIA","HARRISONBURG CITY",11022,480,5591,17093
"2020","VIRGINIA","HENRICO",116572,3287,63440,183299
"2020","VIRGINIA","HENRY",9127,253,16725,26105
"2020","VIRGINIA","HIGHLAND",417,24,1092,1533
"2020","VIRGINIA","HOPEWELL CITY",5430,178,4020,9628
"2020","VIRGINIA","ISLE OF WIGHT",9399,350,13707,23456
"2020","VIRGINIA","JAMES CITY",25553,933,23153,49639
"2020","VIRGINIA","KING AND QUEEN",1590,75,2450,4115
"2020","VIRGINIA","KING GEORGE",5404,377,8446,14227
"2020","VIRGINIA","KING WILLIAM",3260,157,7320,10737
"2020","VIRGINIA","LANCASTER",3368,87,3697,7152
"2020","VIRGINIA","LEE",1489,93,8365,9947
"2020","VIRGINIA","LEXINGTON CITY",1791,67,906,2764
"2020","VIRGINIA","LOUDOUN",138372,4516,82088,224976
"2020","VIRGINIA","LOUISA",8269,353,13294,21916
"2020","VIRGINIA","LUNENBURG",2418,47,3537,6002
"2020","VIRGINIA","LYNCHBURG CITY",18048,1219,17097,36364
"2020","VIRGINIA","MADISON",2698,135,5300,8133
"2020","VIRGINIA","MANASSAS CITY",10356,366,6256,16978
"2020","VIRGINIA","MANASSAS PARK CITY",3992,117,1979,6088
"2020","VIRGINIA","MARTINSVILLE CITY",3766,93,2165,6024
"2020","VIRGINIA","MATHEWS",1825,103,3901,5829
"2020","VIRGINIA","MECKLENBURG",6803,138,9266,16207
"2020","VIRGINIA","MIDDLESEX",2491,98,4196,6785
"2020","VIRGINIA","MONTGOMERY",23218,1190,20629,45037
"2020","VIRGINIA","NELSON",4327,179,4812,9318
"2020","VIRGINIA","NEW KENT",4621,219,9631,14471
"2020","VIRGINIA","NEWPORT NEWS CITY",53099,1794,26377,81270
"2020","VIRGINIA","NORFOLK CITY",64440,2105,23443,89988
"2020","VIRGINIA","NORTHAMPTON",3667,110,2955,6732
"2020","VIRGINIA","NORTHUMBERLAND",3252,78,4485,7815
"2020","VIRGINIA","NORTON CITY",464,28,1109,1601
"2020","VIRGINIA","NOTTOWAY",2971,80,4027,7078
"2020","VIRGINIA","ORANGE",7995,333,12426,20754
"2020","VIRGINIA","PAGE",3007,162,9345,12514
"2020","VIRGINIA","PATRICK",1954,96,7485,9535
"2020","VIRGINIA","PETERSBURG CITY",12389,160,1584,14133
"2020","VIRGINIA","PITTSYLVANIA",10115,361,23751,34227
"2020","VIRGINIA","POQUOSON CITY",2054,198,5605,7857
"2020","VIRGINIA","PORTSMOUTH CITY",30948,898,12755,44601
"2020","VIRGINIA","POWHATAN",5320,358,14055,19733
"2020","VIRGINIA","PRINCE EDWARD",4973,168,4434,9575
"2020","VIRGINIA","PRINCE GEORGE",7103,233,10103,17439
"2020","VIRGINIA","PRINCE WILLIAM",142863,4182,81222,228267
"2020","VIRGINIA","PULASKI",4925,334,12127,17386
"2020","VIRGINIA","RADFORD CITY",3358,176,2786,6320
"2020","VIRGINIA","RAPPAHANNOCK",2096,71,2812,4979
"2020","VIRGINIA","RICHMOND",1513,42,2547,4102
"2020","VIRGINIA","RICHMOND CITY",92175,2403,16603,111181
"2020","VIRGINIA","ROANOKE",21801,1157,34268,57226
"2020","VIRGINIA","ROANOKE CITY",26773,943,15607,43323
"2020","VIRGINIA","ROCKBRIDGE",4086,203,8088,12377
"2020","VIRGINIA","ROCKINGHAM",12644,828,30349,43821
"2020","VIRGINIA","RUSSELL",2373,134,10879,13386
"2020","VIRGINIA","SALEM CITY",5148,220,7683,13051
"2020","VIRGINIA","SCOTT",1692,114,9063,10869
"2020","VIRGINIA","SHENANDOAH",6836,385,16463,23684
"2020","VIRGINIA","SMYTH",3008,165,10963,14136
"2020","VIRGINIA","SOUTHAMPTON",3969,87,5730,9786
"2020","VIRGINIA","SPOTSYLVANIA",34307,1599,39411,75317
"2020","VIRGINIA","STAFFORD",40245,1748,37636,79629
"2020","VIRGINIA","STAUNTON CITY",6981,316,5695,12992
"2020","VIRGINIA","SUFFOLK CITY",28676,884,20082,49642
"2020","VIRGINIA","SURRY",2397,49,2025,4471
"2020","VIRGINIA","SUSSEX",2827,42,2219,5088
"2020","VIRGINIA","TAZEWELL",3205,216,16731,20152
"2020","VIRGINIA","VIRGINIA BEACH CITY",117393,5237,105087,227717
"2020","VIRGINIA","WARREN",6603,475,14069,21147
"2020","VIRGINIA","WASHINGTON",6617,397,21679,28693
"2020","VIRGINIA","WAYNESBORO CITY",4961,249,5507,10717
"2020","VIRGINIA","WESTMORELAND",4501,129,5318,9948
"2020","VIRGINIA","WILLIAMSBURG CITY",4790,137,1963,6890
"2020","VIRGINIA","WINCHESTER CITY",6610,282,5221,12113
"2020","VIRGINIA","WISE",3110,139,13366,16615
"2020","VIRGINIA","WYTHE",3143,197,11733,15073
"2020","VIRGINIA","YORK",17683,867,20241,38791
"2020","WASHINGTON","ADAMS",1814,141,3907,5862
"2020","WASHINGTON","ASOTIN",4250,382,7319,11951
"2020","WASHINGTON","BENTON",38706,3962,60365,103033
"2020","WASHINGTON","CHELAN",19349,1211,22746,43306
"2020","WASHINGTON","CLALLAM",24721,1481,23062,49264
"2020","WASHINGTON","CLARK",140324,8776,126303,275403
"2020","WASHINGTON","COLUMBIA",668,73,1754,2495
"2020","WASHINGTON","COWLITZ",23938,1918,34424,60280
"2020","WASHINGTON","DOUGLAS",7811,542,12955,21308
"2020","WASHINGTON","FERRY",1486,110,2771,4367
"2020","WASHINGTON","FRANKLIN",13340,1025,18039,32404
"2020","WASHINGTON","GARFIELD",366,54,1069,1489
"2020","WASHINGTON","GRANT",11819,1097,24764,37680
"2020","WASHINGTON","GRAYS HARBOR",17354,1210,19877,38441
"2020","WASHINGTON","ISLAND",29213,1966,22746,53925
"2020","WASHINGTON","JEFFERSON",17204,657,6931,24792
"2020","WASHINGTON","KING",907310,34030,269167,1210507
"2020","WASHINGTON","KITSAP",90277,6832,61563,158672
"2020","WASHINGTON","KITTITAS",11421,838,14105,26364
"2020","WASHINGTON","KLICKITAT",5959,364,7237,13560
"2020","WASHINGTON","LEWIS",14520,1398,29391,45309
"2020","WASHINGTON","LINCOLN",1713,170,5150,7033
"2020","WASHINGTON","MASON",17269,1324,18710,37303
"2020","WASHINGTON","OKANOGAN",8900,542,11840,21282
"2020","WASHINGTON","PACIFIC",6794,317,6953,14064
"2020","WASHINGTON","PEND OREILLE",2593,232,5728,8553
"2020","WASHINGTON","PIERCE",249506,16845,197730,464081
"2020","WASHINGTON","SAN JUAN",9725,415,3057,13197
"2020","WASHINGTON","SKAGIT",38252,2409,32762,73423
"2020","WASHINGTON","SKAMANIA",3192,235,3885,7312
"2020","WASHINGTON","SNOHOMISH",256728,15640,166428,438796
"2020","WASHINGTON","SPOKANE",135765,11089,148576,295430
"2020","WASHINGTON","STEVENS",7839,783,19808,28430
"2020","WASHINGTON","THURSTON",96608,6249,65277,168134
"2020","WASHINGTON","WAHKIAKUM",1165,75,1741,2981
"2020","WASHINGTON","WALLA WALLA",13690,1171,16400,31261
"2020","WASHINGTON","WHATCOM",83660,4471,50489,138620
"2020","WASHINGTON","WHITMAN",11184,875,9067,21126
"2020","WASHINGTON","YAKIMA",43179,2459,50555,96193
"2020","WEST VIRGINIA","BARBOUR",1457,104,5116,6677
"2020","WEST VIRGINIA","BERKELEY",17186,1070,33279,51535
"2020","WEST VIRGINIA","BOONE",2041,155,6816,9012
"2020","WEST VIRGINIA","BRAXTON",1457,87,4120,5664
"2020","WEST VIRGINIA","BROOKE",2947,164,7545,10656
"2020","WEST VIRGINIA","CABELL",14994,645,21721,37360
"2020","WEST VIRGINIA","CALHOUN",568,39,2364,2971
"2020","WEST VIRGINIA","CLAY",641,45,2679,3365
"2020","WEST VIRGINIA","DODDRIDGE",435,47,2619,3101
"2020","WEST VIRGINIA","FAYETTE",5063,219,11580,16862
"2020","WEST VIRGINIA","GILMER",599,51,2012,2662
"2020","WEST VIRGINIA","GRANT",607,31,4871,5509
"2020","WEST VIRGINIA","GREENBRIER",4655,270,10925,15850
"2020","WEST VIRGINIA","HAMPSHIRE",1939,114,8033,10086
"2020","WEST VIRGINIA","HANCOCK",3790,204,9806,13800
"2020","WEST VIRGINIA","HARDY",1381,91,4859,6331
"2020","WEST VIRGINIA","HARRISON",9215,567,20683,30465
"2020","WEST VIRGINIA","JACKSON",3207,208,10093,13508
"2020","WEST VIRGINIA","JEFFERSON",12127,543,15033,27703
"2020","WEST VIRGINIA","KANAWHA",34344,1502,46398,82244
"2020","WEST VIRGINIA","LEWIS",1538,137,5782,7457
"2020","WEST VIRGINIA","LINCOLN",1711,107,6012,7830
"2020","WEST VIRGINIA","LOGAN",2333,159,10534,13026
"2020","WEST VIRGINIA","MARION",8901,593,16300,25794
"2020","WEST VIRGINIA","MARSHALL",3455,190,10435,14080
"2020","WEST VIRGINIA","MASON",2526,186,8491,11203
"2020","WEST VIRGINIA","MCDOWELL",1333,46,5148,6527
"2020","WEST VIRGINIA","MERCER",5556,341,19237,25134
"2020","WEST VIRGINIA","MINERAL",2660,172,10040,12872
"2020","WEST VIRGINIA","MINGO",1397,81,8544,10022
"2020","WEST VIRGINIA","MONONGALIA",20282,987,20803,42072
"2020","WEST VIRGINIA","MONROE",1345,77,5068,6490
"2020","WEST VIRGINIA","MORGAN",1998,160,6537,8695
"2020","WEST VIRGINIA","NICHOLAS",2226,125,8279,10630
"2020","WEST VIRGINIA","OHIO",7223,321,12354,19898
"2020","WEST VIRGINIA","PENDLETON",820,57,2782,3659
"2020","WEST VIRGINIA","PLEASANTS",699,50,2742,3491
"2020","WEST VIRGINIA","POCAHONTAS",1047,66,2895,4008
"2020","WEST VIRGINIA","PRESTON",3163,219,11190,14572
"2020","WEST VIRGINIA","PUTNAM",7878,589,20034,28501
"2020","WEST VIRGINIA","RALEIGH",7982,451,24673,33106
"2020","WEST VIRGINIA","RANDOLPH",3362,165,8673,12200
"2020","WEST VIRGINIA","RITCHIE",586,48,3649,4283
"2020","WEST VIRGINIA","ROANE",1455,95,4213,5763
"2020","WEST VIRGINIA","SUMMERS",1448,63,4074,5585
"2020","WEST VIRGINIA","TAYLOR",1796,110,5477,7383
"2020","WEST VIRGINIA","TUCKER",938,65,2841,3844
"2020","WEST VIRGINIA","TYLER",631,65,3226,3922
"2020","WEST VIRGINIA","UPSHUR",2256,194,7771,10221
"2020","WEST VIRGINIA","WAYNE",4088,274,12585,16947
"2020","WEST VIRGINIA","WEBSTER",610,33,2759,3402
"2020","WEST VIRGINIA","WETZEL",1539,135,4993,6667
"2020","WEST VIRGINIA","WIRT",466,53,2134,2653
"2020","WEST VIRGINIA","WOOD",10926,634,27202,38762
"2020","WEST VIRGINIA","WYOMING",1157,82,7353,8592
"2020","WISCONSIN","ADAMS",4329,127,7362,11818
"2020","WISCONSIN","ASHLAND",4801,115,3841,8757
"2020","WISCONSIN","BARRON",9194,349,15803,25346
"2020","WISCONSIN","BAYFIELD",6147,116,4617,10880
"2020","WISCONSIN","BROWN",65511,2635,75871,144017
"2020","WISCONSIN","BUFFALO",2860,122,4834,7816
"2020","WISCONSIN","BURNETT",3569,110,6462,10141
"2020","WISCONSIN","CALUMET",12116,502,18156,30774
"2020","WISCONSIN","CHIPPEWA",13983,638,21317,35938
"2020","WISCONSIN","CLARK",4524,372,10002,14898
"2020","WISCONSIN","COLUMBIA",16410,532,16927,33869
"2020","WISCONSIN","CRAWFORD",3953,122,4620,8695
"2020","WISCONSIN","DANE",260185,5806,78800,344791
"2020","WISCONSIN","DODGE",16356,725,31355,48436
"2020","WISCONSIN","DOOR",10044,321,9752,20117
"2020","WISCONSIN","DOUGLAS",13218,536,10923,24677
"2020","WISCONSIN","DUNN",9897,454,13173,23524
"2020","WISCONSIN","EAU CLAIRE",31620,1314,25341,58275
"2020","WISCONSIN","FLORENCE",781,26,2133,2940
"2020","WISCONSIN","FOND DU LAC",20588,909,35754,57251
"2020","WISCONSIN","FOREST",1721,47,3285,5053
"2020","WISCONSIN","GRANT",10998,468,14142,25608
"2020","WISCONSIN","GREEN",10851,386,10169,21406
"2020","WISCONSIN","GREEN LAKE",3344,159,7168,10671
"2020","WISCONSIN","IOWA",7828,255,5909,13992
"2020","WISCONSIN","IRON",1533,39,2438,4010
"2020","WISCONSIN","JACKSON",4256,137,5791,10184
"2020","WISCONSIN","JEFFERSON",19904,867,27208,47979
"2020","WISCONSIN","JUNEAU",4746,214,8749,13709
"2020","WISCONSIN","KENOSHA",42193,1573,44972,88738
"2020","WISCONSIN","KEWAUNEE",3976,192,7927,12095
"2020","WISCONSIN","LA CROSSE",37846,1354,28684,67884
"2020","WISCONSIN","LAFAYETTE",3647,87,4821,8555
"2020","WISCONSIN","LANGLADE",3704,131,7330,11165
"2020","WISCONSIN","LINCOLN",6261,219,10017,16497
"2020","WISCONSIN","MANITOWOC",16818,793,27218,44829
"2020","WISCONSIN","MARATHON",30808,1319,44624,76751
"2020","WISCONSIN","MARINETTE",7366,309,15304,22979
"2020","WISCONSIN","MARQUETTE",3239,107,5719,9065
"2020","WISCONSIN","MENOMINEE",1303,9,278,1590
"2020","WISCONSIN","MILWAUKEE",317270,7344,134357,458971
"2020","WISCONSIN","MONROE",8433,403,13775,22611
"2020","WISCONSIN","OCONTO",6715,274,16226,23215
"2020","WISCONSIN","ONEIDA",10105,383,13671,24159
"2020","WISCONSIN","OUTAGAMIE",47667,1970,58385,108022
"2020","WISCONSIN","OZAUKEE",26517,1057,33912,61486
"2020","WISCONSIN","PEPIN",1489,71,2584,4144
"2020","WISCONSIN","PIERCE",9796,706,12815,23317
"2020","WISCONSIN","POLK",9370,390,16611,26371
"2020","WISCONSIN","PORTAGE",20428,876,19299,40603
"2020","WISCONSIN","PRICE",3032,120,5394,8546
"2020","WISCONSIN","RACINE",50159,1813,54479,106451
"2020","WISCONSIN","RICHLAND",3995,148,4871,9014
"2020","WISCONSIN","ROCK",46658,1564,37138,85360
"2020","WISCONSIN","RUSK",2517,112,5257,7886
"2020","WISCONSIN","SAUK",18108,602,17493,36203
"2020","WISCONSIN","SAWYER",4498,103,5909,10510
"2020","WISCONSIN","SHAWANO",7131,311,15173,22615
"2020","WISCONSIN","SHEBOYGAN",27101,1301,37609,66011
"2020","WISCONSIN","ST. CROIX",23190,1318,32199,56707
"2020","WISCONSIN","TAYLOR",2693,336,7657,10686
"2020","WISCONSIN","TREMPEALEAU",6285,262,8833,15380
"2020","WISCONSIN","VERNON",7457,248,8218,15923
"2020","WISCONSIN","VILAS",5903,205,9261,15369
"2020","WISCONSIN","WALWORTH",22789,960,33851,57600
"2020","WISCONSIN","WASHBURN",3867,177,6334,10378
"2020","WISCONSIN","WASHINGTON",26650,1183,60237,88070
"2020","WISCONSIN","WAUKESHA",103906,4441,159649,267996
"2020","WISCONSIN","WAUPACA",9703,475,18952,29130
"2020","WISCONSIN","WAUSHARA",4388,164,9016,13568
"2020","WISCONSIN","WINNEBAGO",44060,2176,47796,94032
"2020","WISCONSIN","WOOD",16365,625,24308,41298
"2020","WYOMING","ALBANY",9092,1073,8579,18744
"2020","WYOMING","BIG HORN",788,190,4806,5784
"2020","WYOMING","CAMPBELL",1935,825,16975,19735
"2020","WYOMING","CARBON",1427,265,5014,6706
"2020","WYOMING","CONVERSE",861,232,5917,7010
"2020","WYOMING","CROOK",378,114,3651,4143
"2020","WYOMING","FREMONT",5519,708,12007,18234
"2020","WYOMING","GOSHEN",1203,191,4878,6272
"2020","WYOMING","HOT SPRINGS",482,107,1999,2588
"2020","WYOMING","JOHNSON",897,174,3881,4952
"2020","WYOMING","LARAMIE",15217,2129,27891,45237
"2020","WYOMING","LINCOLN",1509,373,8643,10525
"2020","WYOMING","NATRONA",8530,1590,25271,35391
"2020","WYOMING","NIOBRARA",155,49,1118,1322
"2020","WYOMING","PARK",3410,592,12813,16815
"2020","WYOMING","PLATTE",890,175,3898,4963
"2020","WYOMING","SHERIDAN",4043,660,11843,16546
"2020","WYOMING","SUBLETTE",882,161,3957,5000
"2020","WYOMING","SWEETWATER",3823,646,12229,16698
"2020","WYOMING","TETON",9848,598,4341,14787
"2020","WYOMING","UINTA",1591,372,7496,9459
"2020","WYOMING","WASHAKIE",651,136,3245,4032
"2020","WYOMING","WESTON",360,93,3107,3560
